Equipe,GP,W,D,L,GF,GA,GD,Pts,albania2
Bylis,6,4,2,0,7,2,5,14,albania2
Vora,6,4,1,1,17,9,8,13,albania2
AF Elbasani,4,4,0,0,12,4,8,12,albania2
Apolonia Fier,5,3,1,1,10,4,6,10,albania2
Flamurtari,5,3,1,1,5,3,2,10,albania2
Korabi Peshkopi,5,3,0,2,5,3,2,9,albania2
Kastrioti Kruje,6,2,3,1,6,5,1,9,albania2
Tomori Berat,6,2,3,1,4,3,1,9,albania2
Besa Kavaje,5,2,1,2,8,7,1,7,albania2
Burreli,5,2,1,2,6,8,-2,7,albania2
Lushnja,6,2,1,3,5,10,-5,7,albania2
Luzi 2008,6,0,2,4,4,11,-7,2,albania2
MC Alger,3,3,0,0,11,3,8,9,algeria
CS Constantine,2,2,0,0,5,1,4,6,algeria
USM Alger,2,2,0,0,5,1,4,6,algeria
ASO Chlef,2,2,0,0,3,0,3,6,algeria
NC Magra,3,2,0,1,5,3,2,6,algeria
ES Setif,2,2,0,0,3,1,2,6,algeria
El Bayadh,2,2,0,0,2,0,2,6,algeria
JS Saoura,2,2,0,0,2,0,2,6,algeria
Paradou AC,2,2,0,0,2,0,2,6,algeria
Khenchela,3,2,0,1,3,2,1,6,algeria
JS Kabylie,2,1,1,0,1,0,1,4,algeria
CR Belouizdad,2,1,0,1,3,3,0,3,algeria
US Biskra,2,1,0,1,3,6,-3,3,algeria
MC Oran,2,0,2,0,1,1,0,2,algeria
Ben Aknoun,2,0,1,1,2,3,-1,1,algeria
US Souf,3,0,1,2,3,7,-4,1,algeria
CA Batna,3,2,1,0,5,1,4,7,algeria2
Chelghoum,2,2,0,0,7,1,6,6,algeria2
WA Boufarik,2,2,0,0,5,1,4,6,algeria2
Khemis El K.,2,2,0,0,4,0,4,6,algeria2
Oued Akbou,2,1,1,0,6,1,5,4,algeria2
Bordj Menaïel,2,1,1,0,2,0,2,4,algeria2
El Eulma,2,1,1,0,2,0,2,4,algeria2
Teleghma,2,1,1,0,3,2,1,4,algeria2
GC Mascara,2,1,1,0,2,1,1,4,algeria2
Olympique Medea,2,1,1,0,2,1,1,4,algeria2
RC Kouba,2,1,1,0,2,1,1,4,algeria2
RB Ouargla,2,1,1,0,1,0,1,4,algeria2
Khemis Melina,1,1,0,0,4,0,4,3,algeria2
Koléa,1,1,0,0,4,0,4,3,algeria2
ASM Oran,2,1,0,1,4,1,3,3,algeria2
Mostaganem,1,1,0,0,2,0,2,3,algeria2
MSP Batna,1,1,0,0,1,0,1,3,algeria2
WA Mostaganem,2,1,0,1,5,5,0,3,algeria2
MO Constantine,2,1,0,1,2,2,0,3,algeria2
Annaba,3,0,3,0,1,1,0,3,algeria2
Temouchent,2,1,0,1,1,1,0,3,algeria2
Oued Sly,2,1,0,1,2,4,-2,3,algeria2
El Ghozlane,2,0,2,0,2,2,0,2,algeria2
Mlila,1,0,1,0,1,1,0,1,algeria2
Tiaret,1,0,1,0,0,0,0,1,algeria2
Ghir Abadla,2,0,1,1,1,2,-1,1,algeria2
Khroub,2,0,1,1,1,2,-1,1,algeria2
Oued Magrane,2,0,1,1,2,5,-3,1,algeria2
El Harrach,1,0,0,1,1,2,-1,0,algeria2
UE Santa Coloma,4,4,0,0,9,2,7,12,andorra
Penya Encarnada,4,3,1,0,6,2,4,10,andorra
Inter Escaldes,3,3,0,0,7,2,5,9,andorra
A. Escaldes,3,2,1,0,10,2,8,7,andorra
Ordino,3,2,1,0,10,2,8,7,andorra
FC Santa Coloma,3,2,0,1,5,1,4,6,andorra
Esperanca,4,1,0,3,2,9,-7,3,andorra
Pas de la Casa,4,1,0,3,4,13,-9,3,andorra
A. America,4,0,1,3,3,7,-4,1,andorra
Carroi,3,0,1,2,3,10,-7,1,andorra
River Plate,8,8,0,0,16,4,12,24,argentina
Boca Juniors,8,6,1,1,12,4,8,19,argentina
Lanus,8,6,1,1,12,6,6,19,argentina
Estudiantes,8,5,3,0,15,4,11,18,argentina
Godoy Cruz,8,5,3,0,20,10,10,18,argentina
Defensa y J.,8,5,3,0,13,4,9,18,argentina
A. Tucuman,8,5,2,1,11,6,5,17,argentina
Rosario Central,8,4,4,0,18,8,10,16,argentina
T. de Cordoba,8,4,4,0,10,5,5,16,argentina
Belgrano,8,4,2,2,8,5,3,14,argentina
Independiente,8,4,2,2,9,7,2,14,argentina
Banfield,8,4,2,2,8,6,2,14,argentina
Union Santa Fe,8,3,4,1,8,3,5,13,argentina
Barracas C.,8,3,4,1,8,5,3,13,argentina
Platense,8,4,1,3,7,4,3,13,argentina
San Lorenzo,8,3,4,1,4,2,2,13,argentina
Racing Club,8,3,3,2,13,12,1,12,argentina
Instituto,8,3,3,2,6,6,0,12,argentina
Arsenal Sarandi,8,4,0,4,8,9,-1,12,argentina
Colon Santa Fe,8,3,3,2,9,11,-2,12,argentina
Newells,8,2,5,1,8,5,3,11,argentina
Sarmiento,8,2,5,1,7,4,3,11,argentina
Argentinos Jrs,8,3,2,3,11,11,0,11,argentina
Tigre,8,3,2,3,9,9,0,11,argentina
Gimnasia,8,2,4,2,6,8,-2,10,argentina
Velez Sarsfield,8,1,6,1,4,4,0,9,argentina
Huracan,8,2,3,3,4,5,-1,9,argentina
Central Cordoba,8,2,1,5,4,7,-3,7,argentina
G. Mendoza,8,6,1,1,20,8,12,19,argentina3
CA Guemes,8,6,1,1,10,2,8,19,argentina3
Deportivo Maipu,8,6,1,1,11,5,6,19,argentina3
E. Rio Cuarto,8,6,1,1,12,7,5,19,argentina3
I. Rivadavia,8,6,1,1,9,5,4,19,argentina3
Racing Cordoba,8,5,3,0,15,6,9,18,argentina3
D. de Belgrano,8,6,0,2,14,7,7,18,argentina3
Chacarita J.,8,5,3,0,13,6,7,18,argentina3
All Boys,8,6,0,2,11,6,5,18,argentina3
Ferro Carril,8,5,2,1,13,4,9,17,argentina3
Chaco For Ever,8,5,2,1,13,9,4,17,argentina3
SM Tucuman,8,4,4,0,11,3,8,16,argentina3
Guillermo Brown,8,5,1,2,10,5,5,16,argentina3
Almirante Brown,8,5,1,2,8,4,4,16,argentina3
Patronato,8,5,1,2,14,11,3,16,argentina3
Agropecuario,8,4,3,1,13,5,8,15,argentina3
Temperley,8,4,3,1,11,6,5,15,argentina3
D. Madryn,8,4,3,1,9,4,5,15,argentina3
Gimnasia Jujuy,8,5,0,3,9,4,5,15,argentina3
D. Riestra,8,4,3,1,8,3,5,15,argentina3
Almagro,8,4,3,1,9,6,3,15,argentina3
SM San Juan,8,4,2,2,14,9,5,14,argentina3
Atletico Mitre,8,4,2,2,12,8,4,14,argentina3
Deportivo Moron,8,3,4,1,10,8,2,13,argentina3
Flandria,8,4,1,3,10,9,1,13,argentina3
Nueva Chicago,8,3,4,1,9,8,1,13,argentina3
Brown de A.,8,3,3,2,11,9,2,12,argentina3
Alvarado,8,3,3,2,9,7,2,12,argentina3
Tristan Suarez,8,3,3,2,8,6,2,12,argentina3
Pyunik,8,7,1,0,23,4,19,22,armenia
Ararat-Armenia,8,7,0,1,23,8,15,21,armenia
Noah,8,7,0,1,18,3,15,21,armenia
Alashkert,8,5,2,1,12,6,6,17,armenia
Urartu,8,5,2,1,13,8,5,17,armenia
Ararat Yerevan,8,3,1,4,7,15,-8,10,armenia
Van,8,3,0,5,9,15,-6,9,armenia
BKMA,8,2,1,5,7,18,-11,7,armenia
West Armenia,8,2,0,6,11,22,-11,6,armenia
Shirak,8,1,1,6,6,13,-7,4,armenia
Western Sydney,3,2,1,0,7,0,7,7,australia
Adelaide Utd,3,2,0,1,10,5,5,6,australia
Wellington,2,2,0,0,7,3,4,6,australia
Melbourne V.,3,1,2,0,7,5,2,5,australia
Perth Glory,2,1,1,0,4,2,2,4,australia
Macarthur FC,2,1,1,0,2,1,1,4,australia
Brisbane Roar,1,1,0,0,3,0,3,3,australia
Melbourne City,2,1,0,1,3,2,1,3,australia
Newcastle Jets,1,0,1,0,2,2,0,1,australia
Central Coast,1,0,0,1,1,2,-1,0,australia
Western United,1,0,0,1,0,1,-1,0,australia
Sydney FC,1,0,0,1,0,2,-2,0,australia
LASK Linz,7,5,2,0,11,2,9,17,austria
Sturm Graz,7,4,2,1,11,5,6,14,austria
Salzburg,6,4,0,2,10,2,8,12,austria
Hartberg,7,3,2,2,11,13,-2,11,austria
Wolfsberger AC,7,3,1,3,11,10,1,10,austria
Austria Wien,6,2,3,1,7,5,2,9,austria
A. Klagenfurt,6,2,3,1,8,8,0,9,austria
Rapid Wien,7,1,4,2,14,12,2,7,austria
BW Linz,6,1,4,1,6,9,-3,7,austria
Altach,6,2,1,3,4,7,-3,7,austria
Tirol,6,0,1,5,6,15,-9,1,austria
A. Lustenau,7,0,0,7,2,22,-20,0,austria
Grazer AK,6,6,0,0,12,0,12,18,austria2
Ried,7,5,2,0,21,4,17,17,austria2
SV Horn,7,5,0,2,15,6,9,15,austria2
Lafnitz,7,5,0,2,17,9,8,15,austria2
Admira Wacker,7,4,3,0,9,4,5,15,austria2
Leoben,8,4,1,3,15,12,3,13,austria2
Stripfing,7,4,1,2,14,11,3,13,austria2
First Vienna,7,3,3,1,11,8,3,12,austria2
Floridsdorfer,7,3,2,2,11,7,4,11,austria2
Bregenz,7,3,2,2,9,7,2,11,austria2
St. Polten,7,3,0,4,9,8,1,9,austria2
Kapfenberger,6,2,3,1,7,8,-1,9,austria2
Liefering,7,1,4,2,9,10,-1,7,austria2
Sturm Graz B,6,1,3,2,10,14,-4,6,austria2
Dornbirn,7,2,0,5,6,14,-8,6,austria2
Amstetten,6,0,2,4,6,10,-4,2,austria2
Qarabag,7,5,1,1,20,4,16,16,azerbaijan
Zira,6,4,2,0,8,4,4,14,azerbaijan
Araz,7,4,1,2,7,6,1,13,azerbaijan
Sumqayit,6,3,2,1,4,1,3,11,azerbaijan
Sebail,7,3,1,3,11,14,-3,10,azerbaijan
Sabah,7,2,3,2,12,9,3,9,azerbaijan
Turan,5,1,2,2,9,8,1,5,azerbaijan
Neftci,5,1,1,3,4,6,-2,4,azerbaijan
Kapaz,6,1,1,4,2,8,-6,4,azerbaijan
Qabala,6,1,0,5,4,11,-7,3,azerbaijan
Bashundhara K.,8,8,0,0,20,3,17,24,bangladesh
Abahani,8,7,0,1,23,5,18,21,bangladesh
B. Police,8,5,1,2,21,10,11,16,bangladesh
Sheikh Russel,8,3,4,1,15,13,2,13,bangladesh
Chittagong,8,3,2,3,11,12,-1,11,bangladesh
Mohammedan,8,2,3,3,16,11,5,9,bangladesh
Fortis,8,2,3,3,9,7,2,9,bangladesh
Muktijoddha S.,8,2,2,4,7,13,-6,8,bangladesh
Sheikh Jamal,8,1,3,4,11,17,-6,6,bangladesh
Rahmatgonj,8,1,3,4,2,10,-8,6,bangladesh
A. Uttara,8,0,3,5,6,29,-23,3,bangladesh
Dinamo Minsk,8,6,1,1,25,8,17,19,belarus
Neman Grodno,8,4,3,1,12,5,7,15,belarus
Gomel,8,5,0,3,14,15,-1,15,belarus
Isloch,8,4,2,2,14,8,6,14,belarus
Slavia Mozyr,8,4,1,3,10,8,2,13,belarus
BATE Borisov,8,4,0,4,16,12,4,12,belarus
Slutsk,8,3,3,2,12,10,2,12,belarus
FC Minsk,8,3,3,2,6,5,1,12,belarus
S. Soligorsk,8,4,0,4,11,13,-2,12,belarus
Dinamo Brest,8,3,2,3,11,13,-2,11,belarus
Naftan,8,2,3,3,11,13,-2,9,belarus
Smorgon,8,2,2,4,7,12,-5,8,belarus
T. Zhodino,8,0,7,1,7,8,-1,7,belarus
Energetik-BGU,8,2,1,5,7,14,-7,7,belarus
Belshina,8,2,1,5,5,13,-8,7,belarus
Dnepr Mogilev,8,7,1,0,21,3,18,22,belarus2
Vitebsk,8,7,1,0,21,4,17,22,belarus2
Maxline,8,7,0,1,25,11,14,21,belarus2
Arsenal D.,8,6,1,1,25,8,17,19,belarus2
Lokomotiv Gomel,8,5,0,3,12,10,2,15,belarus2
Baranovichi,8,4,2,2,12,11,1,14,belarus2
Bumprom,8,4,2,2,15,19,-4,14,belarus2
Molodechno-DYuS,8,4,1,3,16,7,9,13,belarus2
Niva,8,3,3,2,14,10,4,12,belarus2
Zhodino Yuzhnoe,8,3,2,3,16,13,3,11,belarus2
Orsha,8,3,1,4,9,10,-1,10,belarus2
Volna Pinsk,8,3,1,4,10,16,-6,10,belarus2
S.Petrikov,8,2,2,4,10,16,-6,8,belarus2
FC Ostrovets,8,2,2,4,11,19,-8,8,belarus2
Slonim,8,2,1,5,6,19,-13,7,belarus2
Lida,8,1,3,4,7,14,-7,6,belarus2
Osipovichy,8,0,1,7,1,16,-15,1,belarus2
Royale Union SG,7,5,1,1,18,8,10,16,belgium
Anderlecht,6,5,1,0,14,5,9,16,belgium
Antwerp,6,4,2,0,14,3,11,14,belgium
Gent,6,4,2,0,13,8,5,14,belgium
Club Brugge,6,3,3,0,16,7,9,12,belgium
Charleroi,7,3,3,1,10,9,1,12,belgium
Cercle Brugge,7,4,0,3,9,9,0,12,belgium
Sint-Truiden,7,3,1,3,6,9,-3,10,belgium
Standard Liege,7,2,3,2,7,7,0,9,belgium
RWDM,7,2,3,2,8,11,-3,9,belgium
OH Leuven,7,2,2,3,11,8,3,8,belgium
Kortrijk,7,2,2,3,7,11,-4,8,belgium
KRC Genk,6,1,4,1,11,8,3,7,belgium
KV Mechelen,6,2,1,3,6,5,1,7,belgium
Eupen,6,2,1,3,9,14,-5,7,belgium
Westerlo,7,1,1,5,8,16,-8,4,belgium
Bolivar,8,8,0,0,32,6,26,24,bolivia
The Strongest,8,8,0,0,27,3,24,24,bolivia
Always Ready,8,7,1,0,18,6,12,22,bolivia
Wilstermann,8,6,2,0,14,3,11,20,bolivia
Nacional Potosi,8,6,1,1,29,11,18,19,bolivia
Santa Cruz,8,6,1,1,10,8,2,19,bolivia
Blooming,8,5,2,1,12,8,4,17,bolivia
Guabira,8,4,3,1,14,9,5,15,bolivia
Libertad,8,5,0,3,10,9,1,15,bolivia
Vaca Diez,8,4,2,2,16,11,5,14,bolivia
Oriente P.,8,3,4,1,9,5,4,13,bolivia
Aurora,8,4,1,3,12,9,3,13,bolivia
Real Tomayapo,8,3,4,1,7,4,3,13,bolivia
Royal Pari,8,2,4,2,13,10,3,10,bolivia
A. Palmaflor,8,2,4,2,9,8,1,10,bolivia
U. de Vinto,8,2,4,2,8,9,-1,10,bolivia
I. Petrolero,8,3,1,4,8,12,-4,10,bolivia
Bolivar,8,7,1,0,19,2,17,22,bolivia2
Nacional Potosi,8,7,1,0,20,8,12,22,bolivia2
Oriente P.,8,6,2,0,16,6,10,20,bolivia2
Always Ready,8,6,0,2,18,6,12,18,bolivia2
Guabira,8,5,3,0,12,7,5,18,bolivia2
U. de Vinto,8,4,3,1,14,7,7,15,bolivia2
I. Petrolero,8,4,3,1,13,6,7,15,bolivia2
The Strongest,8,4,3,1,19,13,6,15,bolivia2
Blooming,8,4,3,1,9,4,5,15,bolivia2
Royal Pari,8,5,0,3,12,10,2,15,bolivia2
U. Sucre,8,4,2,2,14,12,2,14,bolivia2
A. Palmaflor,8,3,4,1,15,10,5,13,bolivia2
Wilstermann,8,4,1,3,12,10,2,13,bolivia2
Real Tomayapo,8,3,3,2,9,8,1,12,bolivia2
Santa Cruz,8,3,2,3,8,11,-3,11,bolivia2
Aurora,8,2,2,4,6,14,-8,8,bolivia2
Gremio,8,7,0,1,14,5,9,21,brazil
Vasco da Gama,8,6,1,1,14,5,9,19,brazil
Fluminense,8,6,1,1,16,10,6,19,brazil
Atletico MG,8,6,0,2,11,4,7,18,brazil
Palmeiras,8,6,0,2,11,4,7,18,brazil
Bragantino,8,5,2,1,10,4,6,17,brazil
Bahia,8,5,1,2,13,7,6,16,brazil
Sao Paulo,8,5,1,2,10,6,4,16,brazil
Athletico PR,8,3,5,0,13,9,4,14,brazil
Fortaleza,8,4,1,3,13,11,2,13,brazil
Corinthians,8,2,6,0,10,8,2,12,brazil
Flamengo,8,3,3,2,8,7,1,12,brazil
Santos,8,3,3,2,12,12,0,12,brazil
Internacional,8,3,2,3,16,12,4,11,brazil
Cuiaba,8,2,3,3,9,8,1,9,brazil
Botafogo,8,2,2,4,15,14,1,8,brazil
Cruzeiro,8,1,4,3,6,7,-1,7,brazil
Goias,8,1,4,3,8,11,-3,7,brazil
America MG,8,2,1,5,9,14,-5,7,brazil
Coritiba,8,1,0,7,7,16,-9,3,brazil
Cherno More,8,7,1,0,12,4,8,22,bulgaria
Ludogorets,8,6,2,0,24,4,20,20,bulgaria
Lok. Plovdiv,8,6,0,2,16,6,10,18,bulgaria
Levski Sofia,8,6,0,2,13,3,10,18,bulgaria
CSKA Sofia,8,4,4,0,11,3,8,16,bulgaria
Arda,7,4,3,0,14,4,10,15,bulgaria
CSKA 1948 Sofia,7,4,3,0,9,3,6,15,bulgaria
Beroe,8,4,2,2,8,5,3,14,bulgaria
L. Krumovgrad,8,4,2,2,11,9,2,14,bulgaria
Hebar,8,3,3,2,9,8,1,12,bulgaria
Slavia Sofia,8,4,0,4,6,8,-2,12,bulgaria
Botev Plovdiv,8,3,1,4,16,11,5,10,bulgaria
Pirin Blag.,8,2,2,4,5,8,-3,8,bulgaria
Lokomotiv Sofia,8,2,2,4,7,11,-4,8,bulgaria
Botev Vratsa,8,2,0,6,7,17,-10,6,bulgaria
Etar,8,1,1,6,7,15,-8,4,bulgaria
Cavalry,8,7,0,1,16,6,10,21,canada
Forge,8,3,4,1,12,8,4,13,canada
Vancouver FC,8,4,1,3,11,15,-4,13,canada
HFX Wanderers,8,4,0,4,14,10,4,12,canada
A. Ottawa,8,3,3,2,11,8,3,12,canada
Pacific,8,2,2,4,8,11,-3,8,canada
York Utd,8,2,1,5,5,15,-10,7,canada
Valour,8,1,0,7,7,17,-10,3,canada
Cobresal,8,6,2,0,15,6,9,20,chile
Colo-Colo,8,6,1,1,19,6,13,19,chile
Audax Italiano,8,5,1,2,9,6,3,16,chile
Coquimbo Unido,8,5,1,2,12,10,2,16,chile
Copiapo,8,5,1,2,13,13,0,16,chile
Union Espanola,8,4,3,1,16,8,8,15,chile
Huachipato,8,4,3,1,14,7,7,15,chile
Palestino,8,4,1,3,11,10,1,13,chile
Magallanes,8,3,1,4,10,12,-2,10,chile
U. Catolica,8,3,1,4,7,9,-2,10,chile
U. de Chile,8,2,3,3,10,10,0,9,chile
Union La Calera,8,2,3,3,11,13,-2,9,chile
Nublense,8,2,3,3,7,10,-3,9,chile
Everton,8,2,2,4,11,13,-2,8,chile
O`Higgins,8,1,3,4,7,12,-5,6,chile
Curico Unido,8,1,0,7,6,16,-10,3,chile
Cobreloa,8,8,0,0,11,1,10,24,chile2
S. Wanderers,8,4,4,0,11,4,7,16,chile2
U. Concepcion,8,4,4,0,14,8,6,16,chile2
San Marcos,8,5,1,2,18,15,3,16,chile2
Deportes Temuco,8,5,0,3,13,10,3,15,chile2
Antofagasta,8,4,2,2,12,8,4,14,chile2
Barnechea,8,3,3,2,13,11,2,12,chile2
U. San Felipe,8,3,2,3,11,7,4,11,chile2
D. Iquique,8,3,2,3,14,15,-1,11,chile2
La Serena,8,3,2,3,6,7,-1,11,chile2
CD Santa Cruz,8,2,4,2,8,8,0,10,chile2
Rangers,8,3,1,4,8,10,-2,10,chile2
S. Morning,8,2,2,4,7,10,-3,8,chile2
San Luis,8,1,3,4,12,11,1,6,chile2
Puerto Montt,8,1,3,4,8,16,-8,6,chile2
Recoleta,8,1,2,5,12,14,-2,5,chile2
S. Taishan,8,7,0,1,25,6,19,21,china
Zhejiang,8,6,2,0,19,5,14,20,china
Wuhan Three T.,8,6,0,2,15,8,7,18,china
Henan SL,8,5,2,1,18,5,13,17,china
Meizhou Hakka,8,5,2,1,16,10,6,17,china
Beijing Guoan,8,5,1,2,17,7,10,16,china
Qingdao Jonoon,8,5,1,2,17,14,3,16,china
Chengdu,8,5,0,3,16,6,10,15,china
Shanghai Port,8,4,2,2,16,10,6,14,china
Cangzhou,8,4,2,2,9,10,-1,14,china
S. Shenhua,8,4,1,3,11,11,0,13,china
Tianjin T.,8,2,6,0,11,8,3,12,china
Changchun Yatai,8,2,4,2,12,13,-1,10,china
Dalian P.,8,2,3,3,8,12,-4,9,china
Nantong Zhiyun,8,0,2,6,4,11,-7,2,china
Shenzhen,8,0,0,8,3,22,-19,0,china
Qingdao Y. I.,8,7,1,0,14,2,12,22,china2
Sichuan Jiuniu,8,6,0,2,16,6,10,18,china2
Shanghai Jiadin,8,5,2,1,9,5,4,17,china2
Hebei Kungfu,8,4,4,0,12,6,6,16,china2
Nanjing,8,5,1,2,11,5,6,16,china2
Shenyang Urban,8,4,3,1,12,5,7,15,china2
Dongguan United,8,4,3,1,11,6,5,15,china2
Guangxi Baoyun,8,4,3,1,8,5,3,15,china2
Yanbian Longdin,8,3,5,0,12,7,5,14,china2
Jinan Xingzhou,8,3,3,2,8,7,1,12,china2
Wuxi Wugou,8,3,2,3,12,9,3,11,china2
Heilongjiang L.,8,2,4,2,10,8,2,10,china2
Dantong Hantong,8,2,4,2,11,10,1,10,china2
Guangzhou FC,8,2,2,4,6,11,-5,8,china2
Jiangxi L.,8,1,1,6,12,17,-5,4,china2
Suzhou Dongwu,8,1,1,6,6,13,-7,4,china2
R. Aguilas,8,6,2,0,18,5,13,20,colombia2
I. Medelin,8,6,2,0,11,3,8,20,colombia2
A. Nacional,8,6,0,2,20,5,15,18,colombia2
America de Cali,8,6,0,2,18,6,12,18,colombia2
Deportivo Cali,8,5,3,0,14,4,10,18,colombia2
Junior,8,5,2,1,18,8,10,17,colombia2
Deportes Tolima,8,5,2,1,11,5,6,17,colombia2
Deportivo Pasto,8,5,2,1,10,4,6,17,colombia2
Millonarios,8,5,2,1,13,8,5,17,colombia2
La Equidad,8,3,5,0,7,3,4,14,colombia2
A. Petrolera,8,4,1,3,10,12,-2,13,colombia2
Boyaca Chico,8,3,3,2,9,9,0,12,colombia2
Once Caldas,8,2,5,1,7,6,1,11,colombia2
Union Magdalena,8,3,2,3,10,12,-2,11,colombia2
D. Pereira,8,3,1,4,10,11,-1,10,colombia2
Santa Fe,8,3,1,4,7,11,-4,10,colombia2
Atletico Huila,8,1,6,1,10,8,2,9,colombia2
Envigado,8,2,3,3,11,10,1,9,colombia2
A. Bucaramanga,8,2,3,3,7,9,-2,9,colombia2
Jaguares de C.,8,1,3,4,2,5,-3,6,colombia2
Saprissa,8,8,0,0,24,3,21,24,costarica
Alajuelense,8,7,0,1,16,3,13,21,costarica
Cartagines,8,6,1,1,19,12,7,19,costarica
Herediano,8,5,1,2,14,8,6,16,costarica
Santos DG,8,4,3,1,10,7,3,15,costarica
Puntarenas,8,5,0,3,14,12,2,15,costarica
Guanacasteca,8,4,1,3,12,10,2,13,costarica
M. Liberia,8,3,3,2,13,10,3,12,costarica
San Carlos,8,2,3,3,10,11,-1,9,costarica
Sporting SJ,8,2,2,4,12,14,-2,8,costarica
AD Grecia,8,1,4,3,8,10,-2,7,costarica
Zeledon,8,1,4,3,10,15,-5,7,costarica
Sparta Prague,7,7,0,0,23,4,19,21,czechrepublic
Viktoria Plzen,7,5,1,1,17,8,9,16,czechrepublic
Mlada Boleslav,7,5,1,1,16,7,9,16,czechrepublic
Slavia Prague,7,5,1,1,14,5,9,16,czechrepublic
Sigma Olomouc,7,5,1,1,13,6,7,16,czechrepublic
Slovacko,8,4,3,1,12,6,6,15,czechrepublic
Banik Ostrava,7,4,2,1,12,3,9,14,czechrepublic
Hradec Kralove,7,4,1,2,12,8,4,13,czechrepublic
Slovan Liberec,8,4,1,3,13,10,3,13,czechrepublic
Karvina,7,3,1,3,13,10,3,10,czechrepublic
Teplice,7,2,3,2,3,3,0,9,czechrepublic
C. Budejovice,8,3,0,5,10,13,-3,9,czechrepublic
Bohemians,7,2,2,3,7,9,-2,8,czechrepublic
Jablonec,6,1,3,2,6,9,-3,6,czechrepublic
Pardubice,8,1,3,4,4,7,-3,6,czechrepublic
Zlin,7,1,3,3,11,21,-10,6,czechrepublic
Silkeborg,8,5,2,1,14,4,10,17,denmark
FC Kobenhavn,7,5,0,2,15,7,8,15,denmark
Nordsjaelland,7,4,2,1,13,5,8,14,denmark
FC Midtjylland,7,4,2,1,10,6,4,14,denmark
Brondby IF,7,4,1,2,13,8,5,13,denmark
Viborg,7,3,3,1,10,9,1,12,denmark
AGF Aarhus,7,3,2,2,8,10,-2,11,denmark
Lyngby,7,2,3,2,10,9,1,9,denmark
Randers FC,7,2,3,2,9,14,-5,9,denmark
Vejle BK,7,1,2,4,8,10,-2,5,denmark
Odense BK,7,0,2,5,7,14,-7,2,denmark
Hvidovre,7,0,0,7,3,19,-16,0,denmark
Aalborg BK,8,6,2,0,18,5,13,20,denmark2
SonderjyskE,7,5,1,1,20,4,16,16,denmark2
AC Horsens,8,4,2,2,14,10,4,14,denmark2
Vendsyssel,8,4,2,2,10,10,0,14,denmark2
Fredericia,7,4,1,2,11,7,4,13,denmark2
Kolding IF,7,4,0,3,13,9,4,12,denmark2
Hobro,8,3,0,5,10,12,-2,9,denmark2
Hillerod,8,2,3,3,6,9,-3,9,denmark2
Helsingor,8,2,2,4,13,19,-6,8,denmark2
HB Koge,8,2,1,5,7,20,-13,7,denmark2
Naestved,7,1,3,3,9,13,-4,6,denmark2
B 93,8,1,1,6,4,23,-19,4,denmark2
Cuniburo,8,6,2,0,22,5,17,20,ecuador3
Nueve Octubre,8,5,2,1,15,5,10,17,ecuador3
America de Q.,8,5,1,2,14,7,7,16,ecuador3
Imbabura,8,4,2,2,16,11,5,14,ecuador3
Macara,8,4,2,2,12,8,4,14,ecuador3
Chacaritas,8,4,1,3,13,7,6,13,ecuador3
I. Juniors,8,3,3,2,12,10,2,12,ecuador3
Vargas Torres,8,3,3,2,7,6,1,12,ecuador3
Manta,8,2,3,3,6,7,-1,9,ecuador3
Guayaquil,8,1,3,4,6,10,-4,6,ecuador3
ENPPI,3,2,1,0,5,2,3,7,egypt
Al Ittihad,3,2,1,0,6,4,2,7,egypt
Pyramids FC,3,2,1,0,6,4,2,7,egypt
Al Ahly,2,2,0,0,7,1,6,6,egypt
Ceramica C.,3,2,0,1,7,2,5,6,egypt
El Geish,3,2,0,1,3,2,1,6,egypt
Al Masry,3,2,0,1,2,4,-2,6,egypt
ZED FC,3,1,2,0,5,4,1,5,egypt
Zamalek,3,1,1,1,7,4,3,4,egypt
Smouha,3,1,1,1,3,3,0,4,egypt
Baladiyyat,3,1,1,1,5,6,-1,4,egypt
El Daklyeh,3,1,1,1,2,3,-1,4,egypt
El Gouna,2,1,0,1,2,1,1,3,egypt
Ismaily,3,1,0,2,5,5,0,3,egypt
Future FC,3,1,0,2,2,3,-1,3,egypt
Al Mokawloon,3,0,1,2,4,7,-3,1,egypt
Pharco,3,0,1,2,2,5,-3,1,egypt
National Bank,3,0,0,3,2,5,-3,0,egypt
Arsenal,7,5,2,0,18,7,11,17,england
Aston Villa,5,5,0,0,20,4,16,15,england
Manchester City,5,5,0,0,16,3,13,15,england
Liverpool,5,5,0,0,14,2,12,15,england
Newcastle Utd,6,5,0,1,14,3,11,15,england
Tottenham,5,4,0,1,9,6,3,12,england
Manchester Utd,7,4,0,3,8,10,-2,12,england
Brighton,6,3,2,1,14,9,5,11,england
Nottm Forest,5,2,3,0,8,5,3,9,england
Brentford,6,2,3,1,12,10,2,9,england
Wolverhampton,6,2,2,2,9,12,-3,8,england
West Ham Utd,5,2,1,2,8,7,1,7,england
Fulham,5,2,0,3,4,7,-3,6,england
Chelsea,6,1,2,3,6,7,-1,5,england
Crystal Palace,6,1,2,3,6,8,-2,5,england
Bournemouth,6,1,2,3,4,10,-6,5,england
Everton,6,1,1,4,5,6,-1,4,england
Sheffield Utd,6,1,1,4,6,16,-10,4,england
Luton Town,5,0,2,3,4,7,-3,2,england
Burnley,6,0,0,6,4,18,-14,0,england
Ipswich Town,8,7,0,1,25,15,10,21,england2
Leeds Utd,8,5,3,0,15,6,9,18,england2
Leicester City,8,6,0,2,11,4,7,18,england2
West Brom,8,5,2,1,14,7,7,17,england2
Preston,8,5,2,1,14,13,1,17,england2
Cardiff City,8,5,1,2,15,9,6,16,england2
Sunderland,8,5,0,3,16,10,6,15,england2
Birmingham City,8,4,3,1,13,8,5,15,england2
Southampton,8,4,2,2,16,14,2,14,england2
Plymouth,8,4,1,3,20,13,7,13,england2
Hull City,8,3,4,1,10,7,3,13,england2
Stoke City,8,4,1,3,9,8,1,13,england2
Middlesbrough,8,4,1,3,7,7,0,13,england2
Watford,8,3,3,2,14,8,6,12,england2
Norwich City,8,4,0,4,12,12,0,12,england2
Coventry City,8,2,5,1,9,7,2,11,england2
Bristol City,8,3,2,3,9,8,1,11,england2
Rotherham,8,2,4,2,12,11,1,10,england2
Swansea City,8,2,3,3,9,9,0,9,england2
Blackburn,8,3,0,5,9,14,-5,9,england2
Huddersfield,8,2,3,3,7,13,-6,9,england2
Millwall,8,2,1,5,7,12,-5,7,england2
Sheffield Wed,8,1,2,5,4,12,-8,5,england2
QP Rangers,7,0,2,5,4,14,-10,2,england2
Portsmouth,8,6,2,0,13,5,8,20,england3
Peterborough,8,5,2,1,18,7,11,17,england3
Oxford Utd,8,5,2,1,15,7,8,17,england3
Bolton,8,5,1,2,13,13,0,16,england3
Wigan Athletic,8,5,0,3,13,10,3,15,england3
Derby County,8,4,2,2,13,5,8,14,england3
Lincoln City,8,4,2,2,13,6,7,14,england3
Blackpool,8,4,2,2,15,11,4,14,england3
Charlton,8,4,1,3,18,12,6,13,england3
Stevenage,8,3,4,1,10,7,3,13,england3
Shrewsbury,8,4,1,3,7,8,-1,13,england3
Bristol Rovers,7,3,3,1,13,7,6,12,england3
Burton Albion,8,3,3,2,10,9,1,12,england3
Cambridge Utd,8,3,3,2,7,8,-1,12,england3
Northampton,8,3,2,3,11,9,2,11,england3
Reading,8,3,2,3,9,8,1,11,england3
Wycombe,8,3,2,3,9,10,-1,11,england3
Barnsley,8,3,1,4,18,12,6,10,england3
Leyton Orient,7,3,1,3,8,12,-4,10,england3
Port Vale,7,3,0,4,6,7,-1,9,england3
Carlisle Utd,8,2,2,4,6,9,-3,8,england3
Exeter City,8,2,2,4,5,9,-4,8,england3
Fleetwood,8,2,1,5,8,14,-6,7,england3
Cheltenham,8,1,2,5,3,13,-10,5,england3
Stockport,8,6,2,0,18,6,12,20,england4
Wrexham,8,6,2,0,24,14,10,20,england4
Crewe Alexandra,8,6,1,1,16,8,8,19,england4
Morecambe,8,5,3,0,14,5,9,18,england4
Notts County,8,6,0,2,19,14,5,18,england4
Swindon Town,8,5,1,2,21,11,10,16,england4
Crawley Town,8,5,0,3,17,11,6,15,england4
Mansfield,7,4,3,0,9,3,6,15,england4
Milton Keynes,8,4,2,2,14,10,4,14,england4
Doncaster,8,4,2,2,12,10,2,14,england4
Tranmere,8,4,1,3,16,10,6,13,england4
Barrow,7,3,4,0,8,5,3,13,england4
Grimsby,8,4,1,3,14,12,2,13,england4
Accrington,8,4,1,3,11,11,0,13,england4
Gillingham,8,4,1,3,8,10,-2,13,england4
Walsall,8,3,3,2,10,8,2,12,england4
Bradford,8,3,3,2,9,9,0,12,england4
Colchester Utd,8,3,2,3,16,15,1,11,england4
Newport,8,2,4,2,13,14,-1,10,england4
AFC Wimbledon,8,2,3,3,13,12,1,9,england4
Salford City,8,2,2,4,12,14,-2,8,england4
Sutton Utd,8,2,1,5,9,12,-3,7,england4
Forest Green,8,2,0,6,11,16,-5,6,england4
Harrogate,8,2,0,6,7,13,-6,6,england4
Chesterfield,8,7,1,0,23,10,13,22,england5
Bromley,8,7,1,0,19,6,13,22,england5
Barnet,8,6,2,0,16,7,9,20,england5
Southend Utd,8,6,0,2,19,6,13,18,england5
Aldershot Town,8,5,2,1,18,12,6,17,england5
Altrincham,8,4,3,1,17,9,8,15,england5
Solihull Moors,8,4,3,1,13,7,6,15,england5
Wealdstone,8,4,3,1,11,8,3,15,england5
Eastleigh,8,4,2,2,18,16,2,14,england5
Gateshead FC,8,4,1,3,17,12,5,13,england5
Oxford City,8,4,1,3,16,12,4,13,england5
Ebbsfleet Utd,8,4,0,4,12,7,5,12,england5
Oldham,8,2,5,1,11,7,4,11,england5
Halifax Town,8,2,4,2,8,8,0,10,england5
Maidenhead Utd,8,2,4,2,7,7,0,10,england5
Hartlepool,8,3,1,4,12,14,-2,10,england5
Rochdale,8,2,3,3,16,15,1,9,england5
Dagenham & R.,8,3,0,5,10,13,-3,9,england5
York City,8,1,5,2,15,16,-1,8,england5
Dorking,8,2,2,4,11,13,-2,8,england5
Woking,8,2,2,4,9,11,-2,8,england5
Boreham Wood,8,1,4,3,5,8,-3,7,england5
AFC Fylde,8,1,3,4,10,14,-4,6,england5
Kidderminster,8,1,3,4,5,9,-4,6,england5
Paide,8,5,3,0,19,6,13,18,estonia
Nomme Kalju,8,5,3,0,21,9,12,18,estonia
Flora,8,5,3,0,15,4,11,18,estonia
Levadia,8,5,3,0,14,4,10,18,estonia
Tallinna Kalev,8,4,3,1,14,7,7,15,estonia
Kuressaare,8,4,3,1,10,7,3,15,estonia
Narva Trans,8,4,1,3,11,11,0,13,estonia
Vaprus,8,3,3,2,12,11,1,12,estonia
Tammeka,8,2,2,4,10,14,-4,8,estonia
Harju Jalgpalli,8,2,0,6,6,13,-7,6,estonia
Nomme Utd,8,6,2,0,24,7,17,20,estonia2
Viimsi,8,5,1,2,14,7,7,16,estonia2
Elva,8,4,2,2,12,8,4,14,estonia2
Tabasalu,8,4,0,4,21,17,4,12,estonia2
Flora B,8,4,0,4,16,14,2,12,estonia2
Paide B,8,3,0,5,10,20,-10,9,estonia2
Levadia B,8,1,5,2,9,9,0,8,estonia2
FC Tallinn,8,2,1,5,13,14,-1,7,estonia2
Alliance,8,2,0,6,15,24,-9,6,estonia2
Legion,8,0,1,7,7,26,-19,1,estonia2
Vikingur,8,7,1,0,31,3,28,22,faroeislands
B36 Torshavn,8,6,2,0,14,3,11,20,faroeislands
Klaksvik,8,5,2,1,16,7,9,17,faroeislands
07 Vestur,8,5,2,1,15,9,6,17,faroeislands
HB Torshavn,8,5,1,2,22,9,13,16,faroeislands
AB Argir,8,5,1,2,17,11,6,16,faroeislands
Streymur,8,3,0,5,8,11,-3,9,faroeislands
IF Fuglafjordur,8,2,2,4,7,21,-14,8,faroeislands
B68 Toftir,8,1,3,4,11,16,-5,6,faroeislands
TB Tvoroyri,8,1,0,7,5,19,-14,3,faroeislands
B71 Sandur,8,8,0,0,28,4,24,24,faroeislands2
Skala,8,8,0,0,30,7,23,24,faroeislands2
NSI Runavik,8,5,1,2,20,8,12,16,faroeislands2
Klaksvik B,8,4,2,2,20,9,11,14,faroeislands2
Vikingur B,8,4,2,2,17,15,2,14,faroeislands2
B36 Torshavn B,8,4,1,3,17,10,7,13,faroeislands2
Hoyvik,8,4,1,3,13,12,1,13,faroeislands2
HB B,8,3,1,4,14,22,-8,10,faroeislands2
B68 Toftir B,8,3,1,4,14,25,-11,10,faroeislands2
Streymur B,8,1,1,6,7,29,-22,4,faroeislands2
VPS,8,6,1,1,19,9,10,19,finland
Honka,8,6,1,1,14,6,8,19,finland
HJK Helsinki,8,5,1,2,14,7,7,16,finland
Haka,8,3,5,0,13,8,5,14,finland
Oulu,8,4,2,2,14,11,3,14,finland
KuPS,8,4,1,3,10,6,4,13,finland
Lahti,8,4,0,4,10,15,-5,12,finland
Ilves,8,2,3,3,8,12,-4,9,finland
Inter Turku,8,2,1,5,8,13,-5,7,finland
KTP,8,2,1,5,6,13,-7,7,finland
SJK,8,2,0,6,11,18,-7,6,finland
Mariehamn,8,1,2,5,4,10,-6,5,finland
Ekenas IF,8,6,2,0,14,7,7,20,finland2
TPS,8,6,0,2,21,9,12,18,finland2
Gnistan,8,5,2,1,13,10,3,17,finland2
KaPa,8,4,3,1,18,10,8,15,finland2
SalPa,8,4,2,2,16,8,8,14,finland2
SJK Akatemia,8,4,2,2,14,12,2,14,finland2
Jaro,8,3,3,2,15,13,2,12,finland2
HIFK,8,3,3,2,14,13,1,12,finland2
KPV Kokkola,8,2,3,3,12,15,-3,9,finland2
Mikkelin,8,2,3,3,6,9,-3,9,finland2
JaPS,8,2,2,4,15,16,-1,8,finland2
JJK,8,1,1,6,5,13,-8,4,finland2
Monaco,6,5,0,1,13,4,9,15,france
Paris SG,6,4,1,1,15,4,11,13,france
Lille,5,4,0,1,7,2,5,12,france
Nice,6,3,3,0,6,1,5,12,france
Marseille,5,3,2,0,7,1,6,11,france
Rennes,6,2,3,1,14,10,4,9,france
Lorient,6,2,3,1,9,8,1,9,france
Reims,6,3,0,3,7,8,-1,9,france
Lens,5,2,2,1,8,4,4,8,france
Nantes,6,2,2,2,12,10,2,8,france
Brest,5,2,2,1,7,6,1,8,france
Strasbourg,6,2,2,2,7,6,1,8,france
Le Havre,5,2,1,2,6,5,1,7,france
Toulouse,5,1,3,1,8,6,2,6,france
Montpellier,5,1,3,1,6,5,1,6,france
Metz,5,0,3,2,4,6,-2,3,france
Lyon,6,0,3,3,7,14,-7,3,france
Clermont,5,0,1,4,2,7,-5,1,france
Angers,7,5,2,0,12,2,10,17,france2
Laval,6,5,0,1,7,3,4,15,france2
Rodez Aveyron,6,4,1,1,14,8,6,13,france2
Pau FC,6,4,1,1,11,7,4,13,france2
SC Bastia,7,4,1,2,12,11,1,13,france2
Guingamp,7,3,3,1,13,6,7,12,france2
AC Ajaccio,6,3,3,0,9,4,5,12,france2
Grenoble,7,3,3,1,9,7,2,12,france2
Amiens,7,3,3,1,8,6,2,12,france2
Saint-Etienne,7,3,2,2,6,3,3,11,france2
Bordeaux,7,3,2,2,11,9,2,11,france2
Auxerre,6,2,2,2,9,5,4,8,france2
Troyes,6,2,2,2,8,7,1,8,france2
Concarneau,6,2,2,2,7,8,-1,8,france2
Caen,6,2,1,3,8,6,2,7,france2
Paris FC,6,2,1,3,8,7,1,7,france2
Annecy,7,1,4,2,9,11,-2,7,france2
Quevilly Rouen,7,1,2,4,8,10,-2,5,france2
Valenciennes,6,0,3,3,5,10,-5,3,france2
USL Dunkerque,7,0,2,5,4,10,-6,2,france2
Red Star,6,6,0,0,14,3,11,18,france3
Niort,7,5,2,0,13,5,8,17,france3
Dijon,7,4,2,1,13,5,8,14,france3
Avranches,6,4,2,0,11,3,8,14,france3
Villefranche,6,4,1,1,10,5,5,13,france3
Versailles,7,2,4,1,14,8,6,10,france3
Martigues,6,3,1,2,9,5,4,10,france3
Rouen,6,2,4,0,6,4,2,10,france3
Sochaux,6,3,1,2,11,10,1,10,france3
Orleans,7,3,1,3,10,10,0,10,france3
Nimes,7,2,4,1,7,7,0,10,france3
Cholet,7,3,0,4,5,7,-2,9,france3
Nancy,7,1,5,1,10,9,1,8,france3
G. O. A. L.,6,2,2,2,8,7,1,8,france3
Marignane G.,7,1,4,2,6,7,-1,7,france3
Chateauroux,6,2,1,3,6,8,-2,7,france3
Epinal,7,1,3,3,7,8,-1,6,france3
Le Mans,5,1,2,2,4,5,-1,5,france3
Dinamo Tbilisi,8,6,1,1,21,7,14,19,georgia
Dinamo Batumi,8,4,4,0,19,7,12,16,georgia
Torpedo Kutaisi,8,5,1,2,15,7,8,16,georgia
Dila Gori,8,4,0,4,18,12,6,12,georgia
Saburtalo,8,3,2,3,14,8,6,11,georgia
Samgurali,8,3,2,3,11,10,1,11,georgia
Telavi,8,3,2,3,10,10,0,11,georgia
Samtredia,8,3,1,4,14,15,-1,10,georgia
Gagra,8,2,2,4,7,12,-5,8,georgia
Shukura,8,0,2,6,9,21,-12,2,georgia
Kolkheti Poti,8,8,0,0,17,3,14,24,georgia2
Gareji Sagarejo,8,5,2,1,27,13,14,17,georgia2
Spaeri,8,5,2,1,20,12,8,17,georgia2
L. Tbilisi,8,4,2,2,19,11,8,14,georgia2
WIT Georgia,8,3,3,2,8,7,1,12,georgia2
Kolkheti Khobi,8,3,2,3,9,9,0,11,georgia2
D. Tbilisi B,8,3,1,4,14,11,3,10,georgia2
Bolnisi,8,3,1,4,14,12,2,10,georgia2
Merani Martvili,8,0,1,7,6,22,-16,1,georgia2
Merani Tbilisi,8,0,1,7,4,25,-21,1,georgia2
Bayern Munich,6,5,1,0,27,5,22,16,germany
Stuttgart,6,5,0,1,20,6,14,15,germany
Leverkusen,5,5,0,0,17,5,12,15,germany
Dortmund,6,4,1,1,9,8,1,13,germany
RB Leipzig,5,3,2,0,16,3,13,11,germany
Wolfsburg,5,3,1,1,9,5,4,10,germany
Freiburg,5,3,1,1,10,8,2,10,germany
E. Frankfurt,5,2,3,0,7,4,3,9,germany
Werder Bremen,5,3,0,2,10,8,2,9,germany
FC Augsburg,6,2,3,1,13,12,1,9,germany
Heidenheim,5,3,0,2,11,10,1,9,germany
Monchengladbach,6,2,1,3,9,9,0,7,germany
Darmstadt,6,1,2,3,10,14,-4,5,germany
FC Koln,5,1,1,3,6,9,-3,4,germany
FSV Mainz,5,1,1,3,5,10,-5,4,germany
Bochum,4,0,3,1,5,7,-2,3,germany
Hoffenheim,5,1,0,4,8,12,-4,3,germany
Union Berlin,5,1,0,4,4,12,-8,3,germany
Hamburger SV,6,6,0,0,15,3,12,18,germany2
Sankt Pauli,7,4,3,0,15,4,11,15,germany2
Hannover 96,6,4,1,1,15,4,11,13,germany2
Greuther Furth,6,4,1,1,15,6,9,13,germany2
Kaiserslautern,7,4,1,2,16,12,4,13,germany2
FC Nurnberg,6,3,2,1,10,7,3,11,germany2
Dusseldorf,7,3,2,2,12,11,1,11,germany2
Holstein Kiel,7,3,1,3,13,14,-1,10,germany2
Hansa Rostock,7,3,1,3,8,9,-1,10,germany2
Hertha Berlin,5,3,0,2,12,4,8,9,germany2
Schalke 04,6,3,0,3,12,11,1,9,germany2
Wehen Wiesbaden,6,2,3,1,5,5,0,9,germany2
Magdeburg,5,2,2,1,11,9,2,8,germany2
Paderborn,6,2,2,2,10,10,0,8,germany2
Karlsruher SC,6,2,2,2,8,8,0,8,germany2
Braunschweig,7,2,2,3,9,13,-4,8,germany2
Elversberg,6,2,1,3,7,11,-4,7,germany2
Osnabruck,7,1,2,4,9,13,-4,5,germany2
Dynamo Dresden,7,7,0,0,14,4,10,21,germany3
Unterhaching,8,4,3,1,13,5,8,15,germany3
Viktoria Koln,8,4,3,1,12,10,2,15,germany3
FC Ingolstadt,7,4,2,1,18,8,10,14,germany3
Verl,8,4,2,2,18,12,6,14,germany3
Regensburg,7,4,2,1,10,6,4,14,germany3
RW Essen,7,4,2,1,9,9,0,14,germany3
Ulm,7,4,1,2,12,8,4,13,germany3
Preuss. Munster,7,3,3,1,13,8,5,12,germany3
Bielefeld,8,3,3,2,17,13,4,12,germany3
Erzgebirge Aue,7,4,0,3,10,7,3,12,germany3
1860 Munchen,7,3,1,3,7,5,2,10,germany3
Hallescher,7,3,1,3,11,12,-1,10,germany3
Dortmund B,7,3,1,3,8,9,-1,10,germany3
Sandhausen,7,2,3,2,12,11,1,9,germany3
Mannheim,7,2,3,2,10,11,-1,9,germany3
Saarbrucken,6,2,2,2,11,10,1,8,germany3
VfB Lubeck,7,1,3,3,8,10,-2,6,germany3
MSV Duisburg,8,1,2,5,6,12,-6,5,germany3
Freiburg B,6,0,2,4,2,10,-8,2,germany3
Olympiakos,7,5,0,2,20,8,12,15,greece
PAOK,5,4,1,0,10,1,9,13,greece
Aris,6,4,1,1,11,6,5,13,greece
AEK Athens,5,3,2,0,9,3,6,11,greece
Panathinaikos,5,3,1,1,16,4,12,10,greece
Panserraikos,4,3,1,0,8,4,4,10,greece
Lamia,5,3,1,1,7,5,2,10,greece
OFI Crete,5,3,1,1,7,5,2,10,greece
Kifisia,5,1,4,0,8,7,1,7,greece
Atromitos,3,1,2,0,4,3,1,5,greece
Panaitolikos,5,1,2,2,3,7,-4,5,greece
Volos,4,1,1,2,7,8,-1,4,greece
PAS Giannina,5,1,1,3,5,8,-3,4,greece
Asteras T.,5,1,1,3,6,10,-4,4,greece
Comunicaciones,7,5,2,0,15,5,10,17,guatemala
Mixco,7,5,0,2,9,5,4,15,guatemala
Antigua GFC,7,4,2,1,13,8,5,14,guatemala
Malacateco,7,4,2,1,12,7,5,14,guatemala
Xelaju,7,4,2,1,8,4,4,14,guatemala
Achuapa,6,4,1,1,12,8,4,13,guatemala
Coban Imperial,7,4,1,2,10,8,2,13,guatemala
Zacapa Tellioz,7,4,0,3,11,8,3,12,guatemala
Guastatoya,6,3,1,2,12,7,5,10,guatemala
Municipal,6,3,1,2,10,7,3,10,guatemala
Xinabajul,7,2,3,2,12,12,0,9,guatemala
Coatepecano IB,7,2,2,3,8,6,2,8,guatemala
Olimpia,8,7,1,0,25,5,20,22,honduras
Motagua,8,5,2,1,13,4,9,17,honduras
Marathon,8,5,1,2,11,7,4,16,honduras
Real Sociedad,8,4,2,2,10,6,4,14,honduras
Real Espana,8,4,2,2,13,10,3,14,honduras
UPNFM,8,4,1,3,12,14,-2,13,honduras
Vida,8,3,3,2,16,14,2,12,honduras
Génesis,8,3,3,2,11,9,2,12,honduras
Olancho,8,3,1,4,6,8,-2,10,honduras
Victoria,8,2,2,4,9,14,-5,8,honduras
LM Warriors,5,4,1,0,17,6,11,13,hongkong
Kitchee,4,4,0,0,18,1,17,12,hongkong
Wofoo Tai Po,3,3,0,0,5,0,5,9,hongkong
Southern D.,2,2,0,0,8,1,7,6,hongkong
Eastern,3,2,0,1,5,2,3,6,hongkong
HK Rangers,1,1,0,0,9,0,9,3,hongkong
Resources C.,4,0,2,2,2,10,-8,2,hongkong
HK U23,2,0,1,1,1,6,-5,1,hongkong
North District,0,0,0,0,0,0,0,0,hongkong
Hong Kong FC,2,0,0,2,0,5,-5,0,hongkong
Sham Shui Po,4,0,0,4,2,10,-8,0,hongkong
MOL Fehervar,7,5,1,1,20,10,10,16,hungary
Paks,6,5,1,0,12,2,10,16,hungary
Kecskemeti TE,7,5,1,1,14,7,7,16,hungary
Ujpest,7,5,1,1,15,10,5,16,hungary
Debrecen,7,5,0,2,15,8,7,15,hungary
Ferencvaros,6,4,1,1,14,5,9,13,hungary
Diosgyor VTK,7,4,1,2,12,6,6,13,hungary
MTK,7,3,2,2,7,13,-6,11,hungary
Puskas Akad.,6,1,4,1,7,8,-1,7,hungary
Mezokovesd,5,2,0,3,7,10,-3,6,hungary
Zalaegerszegi,6,1,1,4,8,18,-10,4,hungary
Kisvarda,2,1,0,1,2,2,0,3,hungary
Nyiregyhaza,7,6,1,0,12,3,9,19,hungary2
Vasas,8,5,2,1,20,5,15,17,hungary2
Gyori ETO,6,5,1,0,17,3,14,16,hungary2
Kozarmisleny,7,4,2,1,15,9,6,14,hungary2
Csakvari,8,4,1,3,9,6,3,13,hungary2
Szeged,7,3,3,1,9,8,1,12,hungary2
Gyirmot,8,3,3,2,14,14,0,12,hungary2
Kazincbarcika,8,2,5,1,9,8,1,11,hungary2
Budafoki,6,3,1,2,7,4,3,10,hungary2
Honved,7,3,1,3,11,10,1,10,hungary2
Soroksar,6,2,2,2,7,7,0,8,hungary2
Siofok,7,2,2,3,9,10,-1,8,hungary2
BVSC,8,2,1,5,4,9,-5,7,hungary2
Tiszakecske,6,1,3,2,7,8,-1,6,hungary2
Pecsi MFC,7,1,3,3,1,6,-5,6,hungary2
Haladas,4,1,2,1,4,4,0,5,hungary2
MTE,7,1,2,4,6,14,-8,5,hungary2
Ajka,8,1,2,5,3,11,-8,5,hungary2
Stjarnan,8,8,0,0,26,2,24,24,iceland
Vikingur R.,8,7,1,0,31,9,22,22,iceland
Valur,8,7,0,1,21,11,10,21,iceland
KA Akureyri,8,6,2,0,17,9,8,20,iceland
Fram,8,5,1,2,16,10,6,16,iceland
KR Reykjavik,8,5,1,2,15,13,2,16,iceland
Hafnarfjordur,8,4,0,4,16,17,-1,12,iceland
IBV,8,2,4,2,9,9,0,10,iceland
Breidablik,8,3,1,4,12,14,-2,10,iceland
HK Kopavogur,8,1,6,1,12,11,1,9,iceland
Keflavik,8,1,4,3,13,16,-3,7,iceland
Fylkir,8,1,4,3,14,18,-4,7,iceland
Dalvik / Reynir,8,7,1,0,24,9,15,22,iceland3
Fjardabyggd,8,6,1,1,18,9,9,19,iceland3
V. Olafsvik,8,5,2,1,21,8,13,17,iceland3
IR Reykjavik,8,5,1,2,21,10,11,16,iceland3
Hottur / Huginn,8,5,1,2,15,14,1,16,iceland3
Throttur Vogar,8,4,3,1,16,8,8,15,iceland3
Fjallabyggd,8,5,0,3,16,15,1,15,iceland3
Volsungur,8,4,0,4,14,10,4,12,iceland3
Sindri,8,3,2,3,13,12,1,11,iceland3
KFG,8,3,1,4,15,15,0,10,iceland3
Haukar,8,3,1,4,12,16,-4,10,iceland3
KV Reykjavik,8,0,1,7,6,24,-18,1,iceland3
Kerala Blasters,8,6,0,2,14,8,6,18,india
Bengaluru,8,6,0,2,13,8,5,18,india
ATK Mohun Bagan,8,6,0,2,11,6,5,18,india
Mumbai City,8,5,2,1,21,6,15,17,india
Hyderabad,8,5,1,2,14,6,8,16,india
Odisha FC,8,4,2,2,14,12,2,14,india
Goa,8,4,0,4,17,16,1,12,india
Chennaiyin,8,3,3,2,15,16,-1,12,india
East Bengal,8,2,1,5,9,17,-8,7,india
NorthEast Utd,8,1,1,6,9,22,-13,4,india
Jamshedpur,8,0,3,5,6,14,-8,3,india
Borneo,8,6,2,0,15,6,9,20,indonesia
Bali Utd,8,6,1,1,18,8,10,19,indonesia
PSIS Semarang,8,6,1,1,14,5,9,19,indonesia
Persis Solo,8,5,3,0,15,8,7,18,indonesia
Barito Putera,8,5,2,1,14,6,8,17,indonesia
Persik Kediri,8,5,1,2,20,7,13,16,indonesia
Persib,8,4,4,0,18,7,11,16,indonesia
Dewa United,8,4,3,1,13,8,5,15,indonesia
Persebaya S.,8,4,2,2,13,10,3,14,indonesia
R. Nusantara,8,3,4,1,9,6,3,13,indonesia
Madura Utd,8,4,1,3,12,10,2,13,indonesia
PSM,8,4,0,4,14,11,3,12,indonesia
Persija,8,2,5,1,12,8,4,11,indonesia
Arema,8,3,2,3,6,9,-3,11,indonesia
PSS Sleman,8,1,5,2,10,11,-1,8,indonesia
Persita,8,2,2,4,10,13,-3,8,indonesia
TIRA Persikabo,8,1,3,4,13,18,-5,6,indonesia
Bhayangkara S.,8,0,3,5,5,12,-7,3,indonesia
Esteghlal,5,5,0,0,8,2,6,15,iran
Malavan,6,3,2,1,9,3,6,11,iran
Sepahan,4,3,0,1,10,5,5,9,iran
Gol Gohar,4,2,2,0,9,4,5,8,iran
Persepolis,4,2,2,0,5,3,2,8,iran
Mes Rafsanjan,5,2,1,2,6,5,1,7,iran
Aluminium Arak,4,2,1,1,4,5,-1,7,iran
Tractor Sazi,4,2,0,2,6,4,2,6,iran
Foolad,5,2,0,3,3,5,-2,6,iran
N. Mazandaran,5,1,2,2,5,5,0,5,iran
Zob Ahan,4,1,1,2,2,4,-2,4,iran
Sanat Naft,5,0,3,2,3,8,-5,3,iran
E. Khuzestan,5,0,2,3,3,6,-3,2,iran
Havadar,5,0,2,3,1,4,-3,2,iran
Paykan,5,0,2,3,3,8,-5,2,iran
Shams A. Qazvin,3,0,1,2,4,6,-2,1,iran
Al Quwa Al J.,2,2,0,0,4,2,2,6,iraq
Al Shorta,2,2,0,0,4,2,2,6,iraq
Duhok,2,1,1,0,2,0,2,4,iraq
Al-Qasim,2,1,1,0,2,1,1,4,iraq
Erbil,2,1,1,0,2,1,1,4,iraq
Al Najaf,3,1,1,1,2,2,0,4,iraq
Naft Al-Janoob,1,1,0,0,3,0,3,3,iraq
Al Karkh,2,1,0,1,4,2,2,3,iraq
Al Hudod,2,1,0,1,2,2,0,3,iraq
Al Naft,2,1,0,1,2,3,-1,3,iraq
Al Zawraa,2,1,0,1,1,2,-1,3,iraq
Al Talaba,2,1,0,1,1,4,-3,3,iraq
Karbala,2,0,2,0,4,4,0,2,iraq
Zakho,2,0,2,0,1,1,0,2,iraq
Al Kahrabaa,1,0,1,0,1,1,0,1,iraq
Baghdad,2,0,1,1,1,2,-1,1,iraq
Naft Maysan,2,0,1,1,1,2,-1,1,iraq
Naft Al-Wasat,2,0,1,1,0,1,-1,1,iraq
Newroz SC,2,0,1,1,0,1,-1,1,iraq
Al Minaa Basra,2,0,0,2,1,6,-5,0,iraq
Shamrock Rovers,8,8,0,0,21,3,18,24,ireland
Derry City,8,5,3,0,17,2,15,18,ireland
Dundalk,8,5,2,1,16,6,10,17,ireland
Bohemians,8,5,2,1,19,10,9,17,ireland
Shelbourne,8,4,4,0,12,8,4,16,ireland
St. Patricks,8,4,2,2,14,6,8,14,ireland
Sligo Rovers,8,4,1,3,9,6,3,13,ireland
Drogheda Utd,8,2,4,2,11,9,2,10,ireland
Cork City,8,1,3,4,6,8,-2,6,ireland
UC Dublin,8,0,1,7,3,22,-19,1,ireland
Galway Utd,8,8,0,0,23,2,21,24,ireland2
Cobh Ramblers,8,4,4,0,16,8,8,16,ireland2
Wexford,8,4,2,2,13,12,1,14,ireland2
Waterford,8,3,3,2,16,9,7,12,ireland2
Treaty Utd,8,3,2,3,16,14,2,11,ireland2
Finn Harps,8,3,2,3,12,13,-1,11,ireland2
Longford Town,8,3,1,4,11,14,-3,10,ireland2
Athlone Town,8,2,2,4,9,10,-1,8,ireland2
Bray Wanderers,8,1,3,4,10,18,-8,6,ireland2
Kerry,8,0,3,5,8,17,-9,3,ireland2
H. Beer Sheva,3,2,1,0,6,0,6,7,israel
M. Petah Tikva,3,2,1,0,9,4,5,7,israel
M. Tel Aviv,3,2,1,0,7,2,5,7,israel
Maccabi Netanya,3,1,1,1,7,5,2,4,israel
Hapoel Haifa,3,1,1,1,5,4,1,4,israel
Bnei Sakhnin,2,1,1,0,3,2,1,4,israel
M. Bnei Raina,2,1,1,0,3,2,1,4,israel
H. Petah Tikva,2,1,1,0,2,1,1,4,israel
B. Jerusalem,3,1,0,2,3,5,-2,3,israel
Hapoel Tel Aviv,2,1,0,1,2,5,-3,3,israel
Maccabi Haifa,1,0,1,0,1,1,0,1,israel
H. Jerusalem,2,0,1,1,2,3,-1,1,israel
Ashdod,3,0,1,2,2,4,-2,1,israel
Hapoel Hadera,2,0,0,2,1,5,-4,0,israel
Kiryat Shmona,4,4,0,0,11,1,10,12,israel2
Ironi Tiberias,4,3,1,0,7,3,4,10,israel2
Bnei Yehuda,3,3,0,0,8,1,7,9,israel2
H. Nof Hagalil,3,3,0,0,5,2,3,9,israel2
Maccabi Jaffa,4,2,1,1,12,6,6,7,israel2
Ramat Hasharon,3,2,1,0,8,4,4,7,israel2
H. Umm al-Fahm,4,1,2,1,4,3,1,5,israel2
Kafr Qasim,4,1,2,1,5,6,-1,5,israel2
H. Ramat Gan,3,1,1,1,5,2,3,4,israel2
Nes Tziona,2,1,0,1,1,2,-1,3,israel2
Ihud B. Shfaram,4,1,0,3,4,6,-2,3,israel2
M. Herziliya,4,0,3,1,3,5,-2,3,israel2
Hapoel Afula,3,0,2,1,3,5,-2,2,israel2
H. Ironi Rishon,3,0,2,1,1,3,-2,2,israel2
Hapoel Akko,2,0,1,1,3,4,-1,1,israel2
H. Kfar Saba,3,0,1,2,4,9,-5,1,israel2
AS Roma,6,4,1,1,15,5,10,13,italy
Inter Milan,6,4,1,1,15,5,10,13,italy
Juventus,5,4,1,0,8,2,6,13,italy
Bologna,6,4,1,1,8,4,4,13,italy
Frosinone,6,4,1,1,12,9,3,13,italy
Lecce,7,3,2,2,8,9,-1,11,italy
Atalanta,5,3,1,1,8,2,6,10,italy
Lazio,5,3,1,1,7,4,3,10,italy
Genoa,6,3,1,2,9,8,1,10,italy
Monza,5,2,3,0,7,2,5,9,italy
AC Milan,5,3,0,2,7,3,4,9,italy
Torino,6,2,3,1,4,5,-1,9,italy
Sassuolo,7,2,2,3,10,11,-1,8,italy
Napoli,5,2,1,2,10,8,2,7,italy
Fiorentina,5,2,1,2,8,7,1,7,italy
Cagliari,6,2,1,3,8,13,-5,7,italy
Hellas Verona,5,1,1,3,4,8,-4,4,italy
Empoli,6,1,1,4,1,7,-6,4,italy
Udinese,5,0,3,2,3,8,-5,3,italy
Salernitana,6,0,3,3,4,13,-9,3,italy
Parma,7,5,2,0,11,3,8,17,italy2
Venezia,7,5,1,1,13,8,5,16,italy2
Cosenza,7,3,2,2,13,7,6,11,italy2
Cittadella,7,3,2,2,9,10,-1,11,italy2
Palermo,6,3,1,2,9,6,3,10,italy2
Catanzaro,6,3,1,2,10,9,1,10,italy2
Como,5,3,1,1,7,6,1,10,italy2
Modena,6,3,1,2,6,6,0,10,italy2
Sudtirol,6,2,2,2,10,8,2,8,italy2
Bari,6,1,5,0,6,5,1,8,italy2
Ascoli,6,2,1,3,7,6,1,7,italy2
Reggiana,6,1,4,1,6,7,-1,7,italy2
Cremonese,7,1,3,3,7,7,0,6,italy2
Brescia,6,1,3,2,4,5,-1,6,italy2
Sampdoria,6,2,0,4,6,8,-2,6,italy2
Ternana,7,1,2,4,5,6,-1,5,italy2
Pisa,6,1,2,3,7,9,-2,5,italy2
Spezia,5,0,3,2,1,3,-2,3,italy2
FeralpiSalo,6,0,2,4,5,12,-7,2,italy2
Lecco,5,0,1,4,4,10,-6,1,italy2
Arnett Gardens,8,6,2,0,15,3,12,20,jamaica
Cavalier,8,6,1,1,16,6,10,19,jamaica
Dunbeholden,8,5,1,2,20,10,10,16,jamaica
Humble Lions,8,4,4,0,11,3,8,16,jamaica
Waterhouse,8,4,3,1,11,4,7,15,jamaica
Mount Pleasant,8,3,4,1,14,4,10,13,jamaica
Harbour View,8,3,3,2,7,5,2,12,jamaica
Portmore Utd,8,2,5,1,10,6,4,11,jamaica
Molynes Utd,8,3,1,4,14,20,-6,10,jamaica
Montego Bay,8,1,4,3,11,15,-4,7,jamaica
Vere Utd,8,1,3,4,3,14,-11,6,jamaica
Tivoli Gardens,8,1,2,5,7,10,-3,5,jamaica
Faulkland,8,0,4,4,9,17,-8,4,jamaica
Chapelton,8,1,1,6,5,21,-16,4,jamaica
Vissel Kobe,8,5,3,0,15,9,6,18,japan
Yokohama M.,8,5,1,2,17,11,6,16,japan
Nagoya G.,8,4,4,0,11,6,5,16,japan
Kashima Antlers,8,4,3,1,10,4,6,15,japan
S. Hiroshima,8,4,3,1,12,7,5,15,japan
Cerezo Osaka,8,5,0,3,11,6,5,15,japan
Kyoto Sanga,8,5,0,3,10,5,5,15,japan
Urawa RD,8,3,5,0,9,3,6,14,japan
K. Frontale,8,4,1,3,16,12,4,13,japan
FC Tokyo,8,4,1,3,14,11,3,13,japan
Gamba Osaka,8,4,1,3,11,10,1,13,japan
Yokohama FC,8,3,2,3,9,6,3,11,japan
Albirex Niigata,8,2,4,2,10,9,1,10,japan
Avispa Fukuoka,8,3,1,4,6,11,-5,10,japan
Kashiwa Reysol,8,1,5,2,10,11,-1,8,japan
C. Sapporo,8,2,2,4,9,10,-1,8,japan
Sagan Tosu,8,2,2,4,9,13,-4,8,japan
Shonan Bellmare,8,2,2,4,6,14,-8,8,japan
JEF Utd Chiba,8,7,1,0,16,5,11,22,japan2
M. Yamagata,8,6,1,1,15,4,11,19,japan2
Jubilo Iwata,8,5,2,1,20,8,12,17,japan2
Shimizu S-Pulse,8,5,2,1,13,5,8,17,japan2
Tokyo Verdy,8,4,2,2,11,8,3,14,japan2
Machida Zelvia,8,4,1,3,16,12,4,13,japan2
Mito Hollyhock,8,3,3,2,14,9,5,12,japan2
Fujieda MYFC,8,3,2,3,13,11,2,11,japan2
Kusatsu,8,2,5,1,5,4,1,11,japan2
R. Yamaguchi,8,3,2,3,13,14,-1,11,japan2
V-V. Nagasaki,8,3,2,3,13,15,-2,11,japan2
Ventforet Kofu,8,3,2,3,9,11,-2,11,japan2
Fagiano Okayama,8,3,2,3,8,14,-6,11,japan2
Omiya Ardija,8,3,2,3,6,12,-6,11,japan2
Tochigi SC,8,2,4,2,12,9,3,10,japan2
Vegalta Sendai,8,2,3,3,7,9,-2,9,japan2
Tokushima V.,8,2,2,4,8,10,-2,8,japan2
Oita Trinita,8,2,1,5,10,13,-3,7,japan2
Iwaki,8,1,3,4,7,16,-9,6,japan2
Blaublitz Akita,8,0,5,3,4,7,-3,5,japan2
R. Kumamoto,8,1,1,6,7,15,-8,4,japan2
Z. Kanazawa,8,0,2,6,4,15,-11,2,japan2
Al Wihdat,4,3,1,0,8,4,4,10,jordan
Al Faysali,3,3,0,0,10,2,8,9,jordan
Al Hussein,3,3,0,0,8,0,8,9,jordan
Shabab Al Ordon,3,2,0,1,4,1,3,6,jordan
Al Ahli,3,1,1,1,4,4,0,4,jordan
Aqaba,4,1,1,2,6,11,-5,4,jordan
Sahab,4,1,1,2,3,8,-5,4,jordan
Al Ramtha,3,1,0,2,3,2,1,3,jordan
Al Jalil,3,0,3,0,2,2,0,3,jordan
Moghayer Al S.,4,1,0,3,2,5,-3,3,jordan
Al Salt,3,1,0,2,1,4,-3,3,jordan
Maan,3,0,2,1,3,4,-1,2,jordan
Ordabasy,8,7,0,1,13,5,8,21,kazakhstan
FC Astana,8,6,2,0,17,8,9,20,kazakhstan
Aktobe,8,5,3,0,15,7,8,18,kazakhstan
Kairat Almaty,8,5,2,1,14,8,6,17,kazakhstan
Maqtaaral,8,4,2,2,15,10,5,14,kazakhstan
Tobol,8,4,2,2,7,5,2,14,kazakhstan
Atyrau,8,3,4,1,7,2,5,13,kazakhstan
Aksu,8,4,1,3,11,9,2,13,kazakhstan
S. Karagandy,8,3,3,2,10,8,2,12,kazakhstan
Kyzylzhar,8,3,3,2,7,6,1,12,kazakhstan
Kaspiy Aktau,8,2,2,4,10,12,-2,8,kazakhstan
Kaisar K.,8,2,2,4,7,9,-2,8,kazakhstan
Okzhetpes,8,1,4,3,7,12,-5,7,kazakhstan
Zhetysu,8,1,2,5,8,15,-7,5,kazakhstan
Ballkani,6,6,0,0,14,5,9,18,kosovo
Drita,6,4,2,0,11,3,8,14,kosovo
Llapi,7,4,2,1,9,3,6,14,kosovo
Gjilani,6,4,2,0,6,2,4,14,kosovo
Prishtina,7,3,4,0,14,9,5,13,kosovo
Malisheva,7,4,0,3,18,12,6,12,kosovo
Dukagjini,7,2,4,1,4,3,1,10,kosovo
Fushe Kosova,7,2,3,2,8,7,1,9,kosovo
Feronikeli,7,2,2,3,4,8,-4,8,kosovo
Liria,7,1,3,3,9,12,-3,6,kosovo
Al Kuwait,4,3,1,0,10,3,7,10,kuwait
Al Arabi SC,3,3,0,0,9,3,6,9,kuwait
Al Salmiyah,4,3,0,1,9,6,3,9,kuwait
Al Nasar,4,2,1,1,10,5,5,7,kuwait
Al Fahaheel,3,1,1,1,5,6,-1,4,kuwait
Al Shabab,4,1,1,2,5,7,-2,4,kuwait
Al Qadsia,3,0,3,0,3,3,0,3,kuwait
Khaitan,3,1,0,2,3,5,-2,3,kuwait
Kazma,4,1,0,3,5,10,-5,3,kuwait
Al Jahra,3,0,1,2,3,5,-2,1,kuwait
RFS,8,7,1,0,27,2,25,22,latvia
Riga FC,8,6,1,1,19,7,12,19,latvia
Auda,8,5,1,2,12,8,4,16,latvia
Liepaja,8,4,3,1,12,10,2,15,latvia
Valmiera,8,3,3,2,14,8,6,12,latvia
Daugavpils,8,3,2,3,9,9,0,11,latvia
Tukums,8,3,2,3,14,17,-3,11,latvia
FS Jelgava,8,2,2,4,8,11,-3,8,latvia
Metta / LU,8,1,3,4,8,10,-2,6,latvia
Super Nova,8,0,1,7,5,23,-18,1,latvia
Panevezys,8,7,1,0,16,3,13,22,lithuania
Hegelmann L.,8,5,3,0,11,3,8,18,lithuania
Zalgiris,8,5,1,2,19,7,12,16,lithuania
Kauno Zalgiris,8,4,3,1,17,12,5,15,lithuania
FA Siauliai,8,2,4,2,8,8,0,10,lithuania
Suduva,8,3,1,4,7,10,-3,10,lithuania
Banga,8,2,2,4,6,12,-6,8,lithuania
Dziugas Telsiai,8,1,3,4,9,15,-6,6,lithuania
Dainava,8,1,1,6,6,12,-6,4,lithuania
Riteriai,8,0,1,7,6,18,-12,1,lithuania
TransINVEST,8,7,0,1,29,6,23,21,lithuania2
Minija,8,7,0,1,18,8,10,21,lithuania2
Be1 NFA,8,6,1,1,16,10,6,19,lithuania2
Neptuna K.,8,5,2,1,22,6,16,17,lithuania2
Nevezis,8,5,2,1,21,9,12,17,lithuania2
Babrungas,8,5,1,2,23,12,11,16,lithuania2
Kauno Z. B,8,4,3,1,16,6,10,15,lithuania2
FA Siauliai B,8,4,3,1,20,14,6,15,lithuania2
Panevezys B,8,3,2,3,12,7,5,11,lithuania2
Garliava,8,3,2,3,11,9,2,11,lithuania2
BFA Vilnius,8,3,2,3,11,11,0,11,lithuania2
Ekranas,8,3,1,4,12,15,-3,10,lithuania2
Riteriai B,8,2,3,3,12,12,0,9,lithuania2
Zalgiris B,8,2,3,3,17,18,-1,9,lithuania2
Jonava,8,1,1,6,6,24,-18,4,lithuania2
Marijampole C.,8,0,1,7,1,22,-21,1,lithuania2
Petange,6,4,2,0,16,6,10,14,luxembourg
Niedercorn,6,4,2,0,13,7,6,14,luxembourg
Differdange,5,4,1,0,16,3,13,13,luxembourg
Dudelange,5,4,1,0,12,4,8,13,luxembourg
Wiltz,6,3,1,2,9,8,1,10,luxembourg
Mondorf,5,3,0,2,13,10,3,9,luxembourg
Hesperang,5,2,3,0,7,5,2,9,luxembourg
Schifflange,6,2,3,1,10,9,1,9,luxembourg
UNA Strassen,6,2,3,1,11,12,-1,9,luxembourg
V. Rosport,6,3,0,3,9,11,-2,9,luxembourg
Racing,5,2,1,2,7,9,-2,7,luxembourg
Mondercange,5,2,1,2,8,13,-5,7,luxembourg
Marisca Mersch,5,1,3,1,7,7,0,6,luxembourg
Jeunesse Esch,5,1,1,3,8,9,-1,4,luxembourg
UN Käerjéng,5,1,1,3,3,5,-2,4,luxembourg
Fola Esch,6,1,1,4,6,9,-3,4,luxembourg
Johor Darul,8,8,0,0,33,1,32,24,malaysia
Selangor,8,8,0,0,21,5,16,24,malaysia
Kedah,8,6,1,1,23,8,15,19,malaysia
Sabah,8,6,1,1,22,15,7,19,malaysia
Pahang,8,5,1,2,15,12,3,16,malaysia
Kuala Lumpur,8,4,3,1,16,7,9,15,malaysia
PDRM,8,4,2,2,9,5,4,14,malaysia
Pulau Pinang,8,4,1,3,15,13,2,13,malaysia
Terengganu,8,4,1,3,12,10,2,13,malaysia
Negeri Sembilan,8,2,3,3,12,15,-3,9,malaysia
Perak,8,2,2,4,14,16,-2,8,malaysia
Kelantan United,8,2,1,5,8,24,-16,7,malaysia
Kelantan,8,1,1,6,9,38,-29,4,malaysia
Kuching,8,0,3,5,4,13,-9,3,malaysia
Hamrun Spartans,8,7,1,0,14,0,14,22,malta
Birkirkara,8,6,2,0,22,6,16,20,malta
Mosta,8,5,1,2,16,8,8,16,malta
Balzan,8,4,1,3,12,13,-1,13,malta
Hibernians,8,4,1,3,11,13,-2,13,malta
Sirens,8,3,2,3,11,12,-1,11,malta
Gzira Utd,8,3,1,4,11,9,2,10,malta
Floriana,8,2,3,3,8,11,-3,9,malta
Santa Lucia,8,2,1,5,6,11,-5,7,malta
Valletta,8,0,6,2,3,5,-2,6,malta
Gudja Utd,8,2,0,6,7,13,-6,6,malta
Zebbug Rangers,8,2,0,6,9,20,-11,6,malta
Pieta Hotspurs,8,1,0,7,7,24,-17,3,malta
Marsaxlokk,8,0,2,6,6,17,-11,2,malta
CF America,8,6,2,0,21,7,14,20,mexico
Tijuana,8,6,1,1,18,8,10,19,mexico
Tigres,8,5,3,0,19,8,11,18,mexico
Monterrey,8,6,0,2,17,8,9,18,mexico
A. San Luis,8,5,1,2,18,7,11,16,mexico
Santos Laguna,8,5,1,2,16,12,4,16,mexico
Club Leon,8,4,3,1,12,6,6,15,mexico
Pumas UNAM,7,4,2,1,13,5,8,14,mexico
Toluca,8,4,2,2,16,9,7,14,mexico
Mazatlan,8,4,1,3,13,11,2,13,mexico
Guadalajara,8,4,1,3,10,10,0,13,mexico
Juarez,8,3,2,3,13,12,1,11,mexico
Puebla,8,3,1,4,13,14,-1,10,mexico
Pachuca,8,2,4,2,8,10,-2,10,mexico
Atlas,7,2,2,3,7,8,-1,8,mexico
Necaxa,8,2,2,4,9,11,-2,8,mexico
Cruz Azul,7,2,1,4,9,14,-5,7,mexico
Queretaro,7,1,3,3,7,9,-2,6,mexico
Monterrey,8,7,0,1,21,6,15,21,mexico2
Toluca,8,5,3,0,18,7,11,18,mexico2
Guadalajara,8,5,1,2,15,10,5,16,mexico2
CF America,8,4,3,1,17,11,6,15,mexico2
A. San Luis,8,4,3,1,10,5,5,15,mexico2
Cruz Azul,8,5,0,3,10,9,1,15,mexico2
Club Leon,8,4,2,2,12,5,7,14,mexico2
Pachuca,8,4,1,3,16,11,5,13,mexico2
Pumas UNAM,8,4,1,3,17,14,3,13,mexico2
Puebla,8,4,0,4,14,14,0,12,mexico2
Tijuana,8,2,5,1,9,7,2,11,mexico2
Necaxa,8,2,4,2,8,8,0,10,mexico2
Queretaro,8,2,4,2,7,9,-2,10,mexico2
Santos Laguna,8,3,1,4,12,20,-8,10,mexico2
Juarez,8,2,3,3,9,8,1,9,mexico2
Tigres,8,2,2,4,7,9,-2,8,mexico2
Atlas,8,1,4,3,11,12,-1,7,mexico2
Mazatlan,8,1,0,7,10,16,-6,3,mexico2
Deren,4,3,1,0,13,6,7,10,mongolia
SP Falcons,4,3,1,0,8,1,7,10,mongolia
Tuv Buganuud,5,3,0,2,16,13,3,9,mongolia
FC Ulaanbaatar,4,2,0,2,7,4,3,6,mongolia
Khangarid,4,1,2,1,10,8,2,5,mongolia
Erchim,4,1,2,1,4,4,0,5,mongolia
Khoromkhon,4,1,0,3,6,10,-4,3,mongolia
Bayanzurkh S.,5,1,0,4,7,20,-13,3,mongolia
Khovd,5,0,1,4,2,9,-7,1,mongolia
Bavarians,5,0,1,4,10,19,-9,1,mongolia
Buducnost,7,4,3,0,11,5,6,15,montenegro
Sutjeska,8,3,3,2,13,11,2,12,montenegro
Decic,7,4,0,3,12,10,2,12,montenegro
Jezero,8,3,2,3,7,6,1,11,montenegro
Jedinstvo,8,3,2,3,10,12,-2,11,montenegro
Petrovac,7,2,4,1,7,5,2,10,montenegro
Arsenal Tivat,8,1,6,1,12,11,1,9,montenegro
Mornar,7,2,3,2,7,7,0,9,montenegro
Mladost DG,7,2,1,4,6,10,-4,7,montenegro
Rudar,8,1,3,4,3,9,-6,6,montenegro
FAR Rabat,5,4,1,0,10,2,8,13,morocco
Berkane,5,3,2,0,7,2,5,11,morocco
Raja Casablanca,4,3,1,0,6,2,4,10,morocco
Moghreb Tetouan,4,2,2,0,7,2,5,8,morocco
Maghreb de Fes,5,2,2,1,6,3,3,8,morocco
R. Zemamra,4,2,2,0,6,4,2,8,morocco
FUS Rabat,3,2,1,0,3,0,3,7,morocco
Union Touarga,4,2,1,1,7,7,0,7,morocco
Wydad,3,2,0,1,4,3,1,6,morocco
Ittihad Tanger,5,1,2,2,5,9,-4,5,morocco
Olympic Safi,4,0,4,0,3,3,0,4,morocco
Salmi,4,1,1,2,4,6,-2,4,morocco
Youssoufia B.,4,1,1,2,3,5,-2,4,morocco
C. Mohammedia,3,1,0,2,5,5,0,3,morocco
Hassania Agadir,3,0,2,1,3,5,-2,2,morocco
Mouloudia Oujda,4,0,1,3,3,10,-7,1,morocco
Stade Marocain,5,4,1,0,12,4,8,13,morocco2
Kawkab M.,5,4,1,0,11,4,7,13,morocco2
USM Oujda,5,4,1,0,6,0,6,13,morocco2
Difaa El Jadida,4,2,2,0,6,3,3,8,morocco2
Rapide Oued Z.,5,1,4,0,4,3,1,7,morocco2
Wydad Fès,5,2,1,2,5,6,-1,7,morocco2
Ittifaq M.,4,1,3,0,2,1,1,6,morocco2
R. Beni Mellal,5,1,3,1,5,5,0,6,morocco2
Meknes,4,2,0,2,2,4,-2,6,morocco2
C. Benguerir,4,1,2,1,4,3,1,5,morocco2
Dcheira,5,1,2,2,3,4,-1,5,morocco2
AS Salé,4,1,1,2,4,5,-1,4,morocco2
Chabab Atlas K.,4,1,1,2,3,4,-1,4,morocco2
El Massira,4,1,1,2,3,4,-1,4,morocco2
Khouribga,4,1,1,2,2,3,-1,4,morocco2
RAC Casablanca,5,0,3,2,4,6,-2,3,morocco2
Shan Utd,8,8,0,0,27,6,21,24,myanmar
Yangon Utd,8,6,2,0,25,2,23,20,myanmar
Hantharwady,8,6,0,2,14,7,7,18,myanmar
Sagaing Utd,8,3,3,2,9,8,1,12,myanmar
Ayeyawady,8,3,2,3,20,18,2,11,myanmar
Dagon,8,3,1,4,16,14,2,10,myanmar
Ispe FC,8,3,1,4,14,13,1,10,myanmar
Yadanarbon,8,2,4,2,8,7,1,10,myanmar
Myawady,8,2,2,4,11,16,-5,8,myanmar
Chinland,8,2,2,4,10,19,-9,8,myanmar
Kachin Utd,8,1,2,5,6,12,-6,5,myanmar
Rakhine Utd,8,1,2,5,7,14,-7,5,myanmar
PSV Eindhoven,6,6,0,0,20,4,16,18,netherlands
Go Ahead Eagles,6,5,1,0,19,4,15,16,netherlands
FC Twente,5,5,0,0,10,3,7,15,netherlands
Feyenoord,5,4,1,0,19,3,16,13,netherlands
AZ Alkmaar,5,4,1,0,15,2,13,13,netherlands
Fortuna Sittard,6,3,2,1,9,6,3,11,netherlands
Heracles Almelo,6,3,1,2,10,14,-4,10,netherlands
Ajax Amsterdam,5,3,0,2,11,8,3,9,netherlands
NEC Nijmegen,6,2,2,2,14,11,3,8,netherlands
Sparta,6,2,2,2,7,9,-2,8,netherlands
Heerenveen,5,2,1,2,8,8,0,7,netherlands
FC Volendam,5,2,1,2,7,7,0,7,netherlands
Excelsior,6,1,4,1,9,10,-1,7,netherlands
PEC Zwolle,6,2,1,3,5,8,-3,7,netherlands
RKC Waalwijk,5,2,0,3,5,10,-5,6,netherlands
FC Utrecht,5,1,1,3,6,13,-7,4,netherlands
Almere City,5,1,1,3,3,10,-7,4,netherlands
Vitesse Arnhem,5,0,2,3,2,8,-6,2,netherlands
Willem II,8,7,0,1,19,10,9,21,netherlands2
Jong AZ,8,6,1,1,17,6,11,19,netherlands2
Roda JC,7,6,0,1,18,5,13,18,netherlands2
Helmond Sport,7,4,2,1,11,5,6,14,netherlands2
De Graafschap,7,4,2,1,7,4,3,14,netherlands2
FC Dordrecht,8,3,4,1,22,14,8,13,netherlands2
Cambuur,7,4,1,2,17,13,4,13,netherlands2
FC Emmen,7,4,1,2,13,10,3,13,netherlands2
Jong Utrecht,5,3,2,0,7,4,3,11,netherlands2
VVV,7,3,2,2,13,12,1,11,netherlands2
NAC Breda,7,3,2,2,12,12,0,11,netherlands2
FC Groningen,7,2,3,2,10,7,3,9,netherlands2
Jong Ajax,6,2,3,1,9,6,3,9,netherlands2
Telstar,7,3,0,4,10,11,-1,9,netherlands2
ADO Den Haag,5,2,2,1,9,8,1,8,netherlands2
FC Eindhoven,7,1,4,2,7,8,-1,7,netherlands2
FC Den Bosch,7,2,1,4,8,10,-2,7,netherlands2
Jong PSV,7,2,1,4,10,13,-3,7,netherlands2
TOP Oss,7,2,0,5,7,14,-7,6,netherlands2
MVV Maastricht,6,1,2,3,5,9,-4,5,netherlands2
Real Esteli,8,7,0,1,16,3,13,21,nicaragua
Diriangen,8,5,1,2,10,7,3,16,nicaragua
Managua FC,8,4,2,2,22,14,8,14,nicaragua
UNAN Managua,8,4,1,3,16,10,6,13,nicaragua
Jalapa,8,3,4,1,9,6,3,13,nicaragua
O. Masachapa,8,4,1,3,12,15,-3,13,nicaragua
Matagalpa,8,3,2,3,12,9,3,11,nicaragua
Walter Ferreti,8,2,5,1,10,9,1,11,nicaragua
Export Sebaco,7,3,2,2,9,10,-1,11,nicaragua
D. Ocotal,8,3,1,4,11,12,-1,10,nicaragua
Akwa Utd,8,7,1,0,15,4,11,22,nigeria
Doma Utd,8,7,1,0,12,3,9,22,nigeria
Rivers Utd,8,7,1,0,12,3,9,22,nigeria
Lobi Stars,8,7,0,1,14,5,9,21,nigeria
Sunshine Stars,8,6,2,0,11,2,9,20,nigeria
Plateau Utd,8,6,1,1,14,4,10,19,nigeria
Enyimba,8,5,3,0,17,4,13,18,nigeria
Bayelsa Utd,8,5,3,0,18,7,11,18,nigeria
Remo Stars,8,5,3,0,11,2,9,18,nigeria
Abia Warriors,8,5,2,1,11,4,7,17,nigeria
Shooting Stars,8,4,4,0,14,7,7,16,nigeria
Enugu Rangers,8,4,4,0,12,6,6,16,nigeria
Bendel,8,4,4,0,10,4,6,16,nigeria
Wikki Tourist,8,4,3,1,13,6,7,15,nigeria
Gombe Utd,8,4,2,2,9,7,2,14,nigeria
Niger Tornadoes,8,3,4,1,7,3,4,13,nigeria
Kwara Utd,8,3,2,3,7,6,1,11,nigeria
Nasarawa Utd,8,3,2,3,9,9,0,11,nigeria
Dakkada,8,2,3,3,10,12,-2,9,nigeria
El Kanemi,8,0,4,4,5,9,-4,4,nigeria
Larne,8,6,2,0,22,7,15,20,northernireland
Linfield,7,6,1,0,24,8,16,19,northernireland
Cliftonville,7,4,2,1,19,3,16,14,northernireland
Crusaders,8,4,2,2,16,7,9,14,northernireland
Glentoran,8,3,2,3,16,10,6,11,northernireland
Loughgall,8,3,1,4,15,14,1,10,northernireland
Coleraine,7,3,1,3,11,12,-1,10,northernireland
Carrick Rangers,7,3,0,4,8,10,-2,9,northernireland
Glenavon,7,3,0,4,5,10,-5,9,northernireland
Dungannon,7,1,2,4,9,13,-4,5,northernireland
Ballymena Utd,8,1,1,6,6,14,-8,4,northernireland
Newry City,8,0,1,7,5,23,-18,1,northernireland
Ballyclare,8,5,3,0,20,11,9,18,northernireland2
Institute,8,6,0,2,14,6,8,18,northernireland2
H&W Welders,7,5,1,1,17,9,8,16,northernireland2
Dundela,6,5,0,1,15,6,9,15,northernireland2
Portadown,7,5,0,2,16,8,8,15,northernireland2
Newington Youth,7,4,0,3,12,10,2,12,northernireland2
Bangor,7,3,2,2,9,9,0,11,northernireland2
Ballinamallard,6,3,1,2,9,7,2,10,northernireland2
Dergview,7,3,0,4,11,10,1,9,northernireland2
Annagh Utd,5,2,2,1,7,6,1,8,northernireland2
Ards,7,1,2,4,13,16,-3,5,northernireland2
Knockbreda,7,0,0,7,7,20,-13,0,northernireland2
Shkupi,7,6,1,0,13,2,11,19,northmacedonia
Struga,7,6,0,1,15,4,11,18,northmacedonia
Rabotnicki,7,5,0,2,9,4,5,15,northmacedonia
Skendija,7,4,3,0,7,2,5,15,northmacedonia
Sileks,6,4,2,0,11,5,6,14,northmacedonia
A. Pandev,7,4,2,1,8,3,5,14,northmacedonia
Bregalnica Stip,7,4,1,2,10,9,1,13,northmacedonia
Tikves,7,3,3,1,9,7,2,12,northmacedonia
Makedonija,6,3,2,1,6,4,2,11,northmacedonia
Gostivar,7,3,2,2,9,9,0,11,northmacedonia
Voska Sport,7,3,1,3,10,9,1,10,northmacedonia
Vardar,7,2,1,4,6,10,-4,7,northmacedonia
Brann,8,7,0,1,16,8,8,21,norway
Bodo / Glimt,8,6,1,1,20,11,9,19,norway
Viking,8,6,1,1,20,12,8,19,norway
Lillestrom,8,6,0,2,19,9,10,18,norway
Sarpsborg 08,8,5,1,2,22,13,9,16,norway
Molde,8,5,1,2,18,9,9,16,norway
Tromso,8,5,1,2,13,7,6,16,norway
Rosenborg,8,4,2,2,15,11,4,14,norway
HamKam,8,4,2,2,16,13,3,14,norway
Odd,8,4,2,2,13,10,3,14,norway
Stromsgodset,8,4,1,3,14,11,3,13,norway
Haugesund,8,4,0,4,13,11,2,12,norway
Aalesund,8,3,2,3,7,12,-5,11,norway
Sandefjord,8,2,3,3,13,12,1,9,norway
Stabaek,8,2,0,6,6,11,-5,6,norway
Valerenga,8,1,2,5,11,18,-7,5,norway
Bryne,8,7,1,0,17,5,12,22,norway2
Start,8,6,2,0,15,3,12,20,norway2
Fredrikstad,8,6,1,1,18,6,12,19,norway2
KFUM Oslo,8,6,1,1,13,5,8,19,norway2
Asane,8,6,1,1,14,9,5,19,norway2
Mjondalen,8,4,1,3,15,10,5,13,norway2
Moss,8,4,1,3,14,9,5,13,norway2
Sandnes Ulf,8,4,1,3,14,12,2,13,norway2
Raufoss,8,3,3,2,12,9,3,12,norway2
Hodd,8,3,3,2,11,9,2,12,norway2
Kristiansund,8,3,2,3,13,8,5,11,norway2
Kongsvinger,8,3,2,3,14,12,2,11,norway2
Sogndal,8,3,2,3,16,15,1,11,norway2
Ranheim,8,2,1,5,11,20,-9,7,norway2
Jerv,8,1,2,5,7,15,-8,5,norway2
Skeid,8,1,0,7,9,15,-6,3,norway2
Oman Club,5,4,0,1,4,2,2,12,oman
Al-Nahda,4,3,1,0,8,3,5,10,oman
Al Seeb,4,3,1,0,7,2,5,10,oman
Sohar,4,2,2,0,8,2,6,8,oman
Sur,5,1,3,1,10,9,1,6,oman
Dhofar,5,2,0,3,3,5,-2,6,oman
Ibri,5,2,0,3,3,6,-3,6,oman
Al Nasr,4,1,2,1,5,4,1,5,oman
Al-Rustaq,5,0,3,2,3,6,-3,3,oman
Al-Shabab Club,4,0,1,3,2,5,-3,1,oman
Bahla,4,0,1,3,2,8,-6,1,oman
Al Wehda,5,0,0,5,3,15,-12,0,oman
Herrera,8,5,2,1,16,7,9,17,panama
Independiente,8,5,1,2,18,7,11,16,panama
San Miguelito,8,4,3,1,13,8,5,15,panama
UMECIT,8,4,2,2,12,7,5,14,panama
Costa del Este,8,4,1,3,13,8,5,13,panama
Universitario,8,3,3,2,9,7,2,12,panama
A. Chiriqui,8,3,3,2,8,11,-3,12,panama
San Francisco,8,2,5,1,8,8,0,11,panama
Alianza,8,3,2,3,6,7,-1,11,panama
Tauro,8,3,1,4,8,6,2,10,panama
Arabe Unido,8,2,4,2,6,5,1,10,panama
Plaza Amador,8,2,2,4,6,8,-2,8,panama
Independiente,8,7,1,0,21,5,16,22,panama2
San Miguelito,8,6,1,1,16,2,14,19,panama2
Tauro,8,5,2,1,14,9,5,17,panama2
Herrera,8,4,4,0,18,4,14,16,panama2
Plaza Amador,8,4,3,1,15,5,10,15,panama2
Alianza,8,3,3,2,8,6,2,12,panama2
Universitario,8,3,3,2,7,5,2,12,panama2
San Francisco,8,3,3,2,9,9,0,12,panama2
Arabe Unido,8,3,2,3,7,10,-3,11,panama2
Costa del Este,8,1,2,5,10,18,-8,5,panama2
UMECIT,8,1,1,6,8,12,-4,4,panama2
A. Chiriqui,8,0,1,7,8,29,-21,1,panama2
Libertad,8,7,1,0,18,3,15,22,paraguay
Cerro Porteno,8,5,2,1,18,10,8,17,paraguay
S. Trinidense,8,5,2,1,13,6,7,17,paraguay
Nacional,8,4,2,2,9,5,4,14,paraguay
S. Luqueno,8,3,3,2,9,6,3,12,paraguay
Tacuary,8,3,2,3,11,8,3,11,paraguay
G. Caballero,8,3,1,4,10,10,0,10,paraguay
Olimpia,8,2,3,3,11,11,0,9,paraguay
S. Ameliano,8,2,3,3,11,13,-2,9,paraguay
Guarani,8,2,3,3,8,11,-3,9,paraguay
Resistencia,8,2,3,3,6,10,-4,9,paraguay
Guairena,8,1,2,5,4,11,-7,5,paraguay
Cerro Porteno,8,5,3,0,18,7,11,18,paraguay2
Olimpia,8,4,4,0,17,8,9,16,paraguay2
Guarani,8,5,1,2,10,7,3,16,paraguay2
Libertad,8,4,3,1,14,3,11,15,paraguay2
Nacional,8,5,0,3,19,10,9,15,paraguay2
S. Luqueno,8,4,2,2,12,9,3,14,paraguay2
Guairena,8,3,2,3,10,14,-4,11,paraguay2
Tacuary,8,3,2,3,7,11,-4,11,paraguay2
S. Ameliano,8,3,1,4,9,10,-1,10,paraguay2
G. Caballero,8,2,4,2,5,6,-1,10,paraguay2
Resistencia,8,3,1,4,8,12,-4,10,paraguay2
S. Trinidense,8,0,4,4,7,15,-8,4,paraguay2
Alianza Lima,8,8,0,0,23,4,19,24,peru
Cusco,8,8,0,0,16,5,11,24,peru
Universitario,8,7,0,1,17,4,13,21,peru
Cesar Vallejo,8,6,1,1,16,5,11,19,peru
S. Cristal,8,5,3,0,14,7,7,18,peru
FBC Melgar,8,5,2,1,17,9,8,17,peru
Binacional,8,5,1,2,20,9,11,16,peru
Sport Huancayo,8,5,1,2,16,8,8,16,peru
Atletico Grau,8,4,3,1,17,5,12,15,peru
Cienciano,8,4,3,1,12,6,6,15,peru
Alianza A.,8,4,3,1,16,11,5,15,peru
ADT,8,4,2,2,12,8,4,14,peru
Carlos Manucci,8,4,2,2,8,4,4,14,peru
D. Municipal,8,4,1,3,11,9,2,13,peru
Cajamarca,8,3,4,1,5,3,2,13,peru
Union Comercio,8,3,3,2,15,18,-3,12,peru
D. Garcilaso,8,2,5,1,15,13,2,11,peru
Sport Boys,8,3,1,4,8,12,-4,10,peru
AD Cantolao,8,2,2,4,6,9,-3,8,peru
Universitario,8,7,1,0,16,1,15,22,peru2
S. Cristal,8,6,2,0,18,3,15,20,peru2
Sport Huancayo,8,6,2,0,15,4,11,20,peru2
ADT,8,5,3,0,10,2,8,18,peru2
Binacional,8,5,1,2,16,7,9,16,peru2
Alianza Lima,8,4,4,0,6,1,5,16,peru2
Cienciano,8,4,3,1,9,5,4,15,peru2
FBC Melgar,8,4,2,2,15,8,7,14,peru2
Cajamarca,8,3,5,0,14,7,7,14,peru2
Cusco,8,3,5,0,11,4,7,14,peru2
Carlos Manucci,8,4,2,2,12,7,5,14,peru2
Alianza A.,8,4,2,2,11,7,4,14,peru2
D. Garcilaso,8,4,1,3,12,9,3,13,peru2
Sport Boys,8,3,3,2,8,9,-1,12,peru2
Cesar Vallejo,8,3,2,3,13,8,5,11,peru2
Union Comercio,8,3,2,3,10,11,-1,11,peru2
Atletico Grau,8,2,4,2,12,11,1,10,peru2
AD Cantolao,8,2,1,5,5,13,-8,7,peru2
D. Municipal,8,2,0,6,8,13,-5,6,peru2
Santa Rosa,8,7,1,0,38,5,33,22,peru3
Comerciantes U.,8,7,1,0,16,1,15,22,peru3
A. Huanuco,8,7,1,0,17,5,12,22,peru3
Santos FC,8,6,2,0,14,2,12,20,peru3
Comerciantes,8,5,3,0,11,3,8,18,peru3
D. Coopsol,8,5,2,1,14,5,9,17,peru3
Llacuabamba,8,4,3,1,14,9,5,15,peru3
U. San Martin,8,5,0,3,13,9,4,15,peru3
Ayacucho,8,4,2,2,15,8,7,14,peru3
Alfonso Ugarte,8,3,4,1,17,8,9,13,peru3
Juan Aurich,8,1,6,1,4,5,-1,9,peru3
M. El Pirata,8,2,2,4,12,16,-4,8,peru3
Huaral,8,1,3,4,9,13,-4,6,peru3
Carlos Stein,8,1,2,5,9,19,-10,5,peru3
Kaya,8,7,0,1,28,9,19,21,philippines
Cebu FC,8,5,3,0,15,6,9,18,philippines
United City,6,4,2,0,9,3,6,14,philippines
Stallion,8,4,1,3,16,9,7,13,philippines
Azkals,8,2,0,6,9,15,-6,6,philippines
Maharlika,8,1,0,7,7,19,-12,3,philippines
Mendiola,8,1,0,7,5,25,-20,3,philippines
Jagiellonia,7,7,0,0,22,5,17,21,poland
Rakow C.,8,6,2,0,19,3,16,20,poland
Lech Poznan,8,6,2,0,21,8,13,20,poland
Slask Wroclaw,7,5,1,1,14,6,8,16,poland
Legia Warsaw,7,5,0,2,14,7,7,15,poland
Zaglebie Lubin,7,4,2,1,9,6,3,14,poland
Pogon Szczecin,7,4,0,3,15,11,4,12,poland
Widzew Lodz,6,4,0,2,7,5,2,12,poland
Stal Mielec,7,3,2,2,13,9,4,11,poland
Gornik Zabrze,7,3,2,2,5,6,-1,11,poland
Piast Gliwice,7,2,4,1,7,6,1,10,poland
Korona Kielce,6,2,3,1,10,7,3,9,poland
Radomiak Radom,7,2,3,2,9,7,2,9,poland
Puszcza Niepolo,7,2,3,2,8,10,-2,9,poland
LKS Lodz,6,2,1,3,5,12,-7,7,poland
Warta Poznan,8,1,3,4,5,9,-4,6,poland
Cracovia Krakow,7,1,3,3,7,13,-6,6,poland
Ruch Chorzow,6,1,2,3,8,12,-4,5,poland
Arka Gdynia,7,5,1,1,13,6,7,16,poland2
Lechia Gdansk,7,4,2,1,12,4,8,14,poland2
Odra Opole,8,4,2,2,5,6,-1,14,poland2
Wisla Krakow,8,3,4,1,17,8,9,13,poland2
Wisla Plock,6,4,1,1,13,7,6,13,poland2
Gornik Leczna,7,3,4,0,11,6,5,13,poland2
Tychy,6,4,1,1,9,4,5,13,poland2
Miedz Legnica,8,3,3,2,11,7,4,12,poland2
Motor Lublin,8,3,2,3,13,15,-2,11,poland2
Katowice,6,3,1,2,10,5,5,10,poland2
Podbeskidzie,7,2,4,1,8,7,1,10,poland2
Znicz Pruszkow,7,3,1,3,6,6,0,10,poland2
Chrobry Glogow,8,3,1,4,6,14,-8,10,poland2
Resovia Rzeszow,6,2,2,2,7,8,-1,8,poland2
T. Nieciecza,6,2,2,2,7,8,-1,8,poland2
Stal Rzeszow,8,2,2,4,11,15,-4,8,poland2
Z. Sosnowiec,6,1,1,4,7,10,-3,4,poland2
Polonia Warszaw,8,1,1,6,10,14,-4,4,poland2
K. Kolobrzeg,8,6,1,1,14,7,7,19,poland3
Kalisz,8,5,2,1,12,5,7,17,poland3
Olimpia Elblag,8,5,2,1,11,5,6,17,poland3
LKS Lodz B,8,5,1,2,16,10,6,16,poland3
Stalowa Wola,7,5,0,2,14,7,7,15,poland3
Chojniczanka,8,4,3,1,12,6,6,15,poland3
Pogon Siedlce,7,4,2,1,13,8,5,14,poland3
SKRA Czestochow,8,4,2,2,10,6,4,14,poland3
Jastrzebie,8,4,2,2,12,10,2,14,poland3
Stomil Olsztyn,8,4,2,2,8,8,0,14,poland3
Radunia Stezyca,8,3,4,1,13,6,7,13,poland3
O. Grudziadz,8,3,2,3,11,9,2,11,poland3
Polonia Bytom,6,3,2,1,10,8,2,11,poland3
Zaglebie L. B,7,3,2,2,10,8,2,11,poland3
Hutnik Krakow,8,3,2,3,13,13,0,11,poland3
Wisla Pulawy,8,2,4,2,12,11,1,10,poland3
Lech Poznan B,7,3,1,3,9,17,-8,10,poland3
Sandecja Nowy,6,2,2,2,7,7,0,8,poland3
Sporting CP,6,6,0,0,14,5,9,18,portugal
Guimaraes,5,4,0,1,13,5,8,12,portugal
Gil Vicente,5,3,1,1,17,9,8,10,portugal
Sporting Braga,5,3,1,1,14,6,8,10,portugal
Benfica,4,3,1,0,8,1,7,10,portugal
Farense,6,3,1,2,12,7,5,10,portugal
Famalicao,5,3,1,1,6,4,2,10,portugal
FC Porto,5,3,1,1,6,4,2,10,portugal
Boavista,5,2,2,1,10,8,2,8,portugal
Estoril,5,2,1,2,9,5,4,7,portugal
Moreirense,5,2,1,2,6,6,0,7,portugal
Rio Ave,6,2,1,3,9,11,-2,7,portugal
Estrela Amadora,5,2,0,3,5,7,-2,6,portugal
Chaves,5,1,1,3,9,12,-3,4,portugal
Vizela,5,1,1,3,6,9,-3,4,portugal
Arouca,5,1,1,3,5,8,-3,4,portugal
Portimonense,4,1,1,2,4,8,-4,4,portugal
Casa Pia,5,0,2,3,2,5,-3,2,portugal
Nacional,6,4,1,1,13,4,9,13,portugal2
Santa Clara,5,3,2,0,7,1,6,11,portugal2
Pacos Ferreira,5,3,1,1,9,3,6,10,portugal2
AVS,5,3,1,1,4,1,3,10,portugal2
Mafra,4,3,0,1,7,3,4,9,portugal2
Feirense,5,3,0,2,5,4,1,9,portugal2
Oliveirense,5,2,2,1,10,9,1,8,portugal2
FC Porto B,5,2,2,1,7,6,1,8,portugal2
Torreense,4,2,1,1,9,5,4,7,portugal2
Uniao de Leiria,4,2,1,1,10,8,2,7,portugal2
Tondela,5,2,1,2,9,8,1,7,portugal2
Penafiel,4,2,1,1,5,4,1,7,portugal2
Benfica B,5,2,0,3,6,8,-2,6,portugal2
Academico Viseu,4,1,2,1,5,4,1,5,portugal2
Leixoes,4,1,2,1,3,4,-1,5,portugal2
Maritimo,4,1,1,2,5,5,0,4,portugal2
Os Belenense,5,0,2,3,3,11,-8,2,portugal2
Vilaverdense,4,0,0,4,3,13,-10,0,portugal2
Al Wakrah,5,4,1,0,11,5,6,13,qatar
Al Gharafa,4,4,0,0,15,8,7,12,qatar
Al Sadd,4,3,1,0,13,2,11,10,qatar
Al Duhail,2,2,0,0,7,3,4,6,qatar
Al Rayyan,3,2,0,1,5,4,1,6,qatar
Al Arabi,5,1,3,1,8,8,0,6,qatar
Qatar SC,3,1,1,1,9,7,2,4,qatar
Al Muaidar,4,1,1,2,8,9,-1,4,qatar
Umm Salal,4,1,1,2,6,8,-2,4,qatar
Al Markhiya,4,1,0,3,3,7,-4,3,qatar
Al Ahli Doha,5,1,0,4,9,14,-5,3,qatar
Al Shamal,3,0,0,3,5,9,-4,0,qatar
CFR Cluj,8,6,2,0,15,3,12,20,romania
Rapid Bucharest,8,5,2,1,17,8,9,17,romania
Hermannstadt,8,4,3,1,15,8,7,15,romania
Univ. Craiova,7,4,2,1,13,6,7,14,romania
FCSB,7,4,2,1,11,6,5,14,romania
Sepsi OSK,8,3,4,1,11,9,2,13,romania
Farul Constanta,8,3,3,2,13,10,3,12,romania
Petrolul,8,2,5,1,12,12,0,11,romania
UTA Arad,7,3,2,2,8,8,0,11,romania
Otelul,8,1,5,2,6,8,-2,8,romania
U Craiova 1948,8,2,1,5,17,19,-2,7,romania
P. Iasi,7,1,4,2,6,10,-4,7,romania
Voluntari,7,2,1,4,8,13,-5,7,romania
Din. Bucharest,8,1,3,4,3,10,-7,6,romania
U. Cluj,7,1,2,4,7,13,-6,5,romania
Botosani,7,0,4,3,5,10,-5,4,romania
Krylya Sovetov,8,6,2,0,23,8,15,20,russia
FC Krasnodar,7,6,1,0,13,4,9,19,russia
Nizhny Novgorod,7,6,0,1,11,4,7,18,russia
CSKA Moscow,7,5,2,0,15,7,8,17,russia
Spartak Moscow,8,5,2,1,12,8,4,17,russia
Rostov,8,4,3,1,16,9,7,15,russia
Zenit,6,4,0,2,14,7,7,12,russia
Dinamo Moscow,6,3,2,1,8,6,2,11,russia
Fakel Voronezh,7,3,2,2,8,6,2,11,russia
Baltika,7,3,2,2,8,8,0,11,russia
Lokomotiv M.,7,2,4,1,8,8,0,10,russia
Ural,8,2,3,3,8,11,-3,9,russia
Rubin Kazan,8,2,3,3,7,13,-6,9,russia
Orenburg,7,2,2,3,9,9,0,8,russia
PFC Sochi,6,2,1,3,10,8,2,7,russia
Akhmat Grozny,7,1,2,4,10,10,0,5,russia
A. Vladikavkaz,8,6,2,0,12,4,8,20,russia2
Arsenal Tula,8,5,2,1,12,4,8,17,russia2
Yenisey,8,5,1,2,18,10,8,16,russia2
Makhachkala,8,5,1,2,10,3,7,16,russia2
Tyumen,8,4,3,1,11,4,7,15,russia2
Kamaz,8,4,3,1,11,5,6,15,russia2
Khimki,8,4,3,1,10,6,4,15,russia2
SKA Khabarovsk,8,4,3,1,10,6,4,15,russia2
Akron,8,4,2,2,13,7,6,14,russia2
Torpedo Moscow,8,4,1,3,9,9,0,13,russia2
Urozhay,8,3,3,2,8,6,2,12,russia2
Shinnik,8,3,3,2,11,10,1,12,russia2
Sokol Saratov,8,3,3,2,8,7,1,12,russia2
Rodina Moskva,8,3,2,3,10,8,2,11,russia2
Neftekhimik,8,3,2,3,8,10,-2,11,russia2
Chernomorets,8,2,4,2,10,10,0,10,russia2
V. Astrakhan,8,2,2,4,8,15,-7,8,russia2
Leningradets,8,0,3,5,4,9,-5,3,russia2
Al Hilal,7,6,1,0,17,3,14,19,saudiarabia
Al Ahli Jeddah,7,6,1,0,15,4,11,19,saudiarabia
Al Taawon,6,4,2,0,11,3,8,14,saudiarabia
Al Nassr,6,4,1,1,14,8,6,13,saudiarabia
Abha,7,4,0,3,10,11,-1,12,saudiarabia
Al Shabab,6,3,2,1,10,6,4,11,saudiarabia
Al Ittifaq,6,3,2,1,11,8,3,11,saudiarabia
Damak,6,2,4,0,13,8,5,10,saudiarabia
Al Fateh,6,3,1,2,15,11,4,10,saudiarabia
Al Wahda,6,3,1,2,14,10,4,10,saudiarabia
Al Ittihad,6,3,1,2,13,10,3,10,saudiarabia
Al Tai,6,3,1,2,9,10,-1,10,saudiarabia
Al Riyadh,7,2,2,3,6,11,-5,8,saudiarabia
Al Feiha,6,1,3,2,4,5,-1,6,saudiarabia
Al Khaleej,7,1,3,3,7,11,-4,6,saudiarabia
Al Raed,7,2,0,5,8,15,-7,6,saudiarabia
Al Hazm,6,1,1,4,8,16,-8,4,saudiarabia
Al Akhdoud,6,0,0,6,2,11,-9,0,saudiarabia
Al Orubah,5,5,0,0,12,2,10,15,saudiarabia2
Al Bukayriyah,6,4,2,0,7,2,5,14,saudiarabia2
Al Jabalain,5,4,1,0,10,4,6,13,saudiarabia2
Al Quadisiya,5,4,1,0,8,4,4,13,saudiarabia2
Al Adalh,4,4,0,0,10,5,5,12,saudiarabia2
Al-Jndal,5,3,1,1,6,4,2,10,saudiarabia2
Al Faisaly,4,3,0,1,7,1,6,9,saudiarabia2
Al Arabi,6,3,0,3,13,9,4,9,saudiarabia2
Al Batin,5,2,2,1,8,8,0,8,saudiarabia2
Al Kholood,5,2,2,1,4,4,0,8,saudiarabia2
Al-Ain,4,2,1,1,6,4,2,7,saudiarabia2
Al Taraji,5,2,1,2,8,9,-1,7,saudiarabia2
Jeddah,4,2,0,2,3,3,0,6,saudiarabia2
Al Safa,5,2,0,3,7,8,-1,6,saudiarabia2
Hajer,6,1,2,3,3,8,-5,5,saudiarabia2
Ohod,5,1,1,3,6,6,0,4,saudiarabia2
Al Najma,4,1,1,2,4,6,-2,4,saudiarabia2
Al Qaisoma,5,1,1,3,7,10,-3,4,saudiarabia2
Kilmarnock,7,4,2,1,10,5,5,14,scotland
Celtic,5,4,1,0,12,4,8,13,scotland
Rangers,6,4,0,2,12,5,7,12,scotland
Dundee FC,7,3,3,1,9,8,1,12,scotland
St. Mirren,6,3,2,1,11,8,3,11,scotland
Hibernian,7,2,3,2,9,8,1,9,scotland
St. Johnstone,7,2,3,2,8,10,-2,9,scotland
Hearts,6,2,2,2,6,7,-1,8,scotland
Motherwell,7,2,1,4,11,14,-3,7,scotland
Livingston,5,1,2,2,3,6,-3,5,scotland
Aberdeen,4,1,1,2,5,5,0,4,scotland
Ross County,5,1,1,3,3,7,-4,4,scotland
Raith Rovers,6,4,2,0,10,6,4,14,scotland2
Airdrieonians,7,4,1,2,9,7,2,13,scotland2
Dundee Utd,6,3,3,0,15,4,11,12,scotland2
Partick Thistle,7,3,2,2,12,14,-2,11,scotland2
Inverness,6,2,2,2,6,5,1,8,scotland2
Dunfermline,5,2,0,3,6,6,0,6,scotland2
Arbroath,6,2,0,4,9,12,-3,6,scotland2
Queen`s Park,6,1,2,3,8,13,-5,5,scotland2
Ayr Utd,6,1,1,4,4,12,-8,4,scotland2
Greenock Morton,6,1,0,5,6,13,-7,3,scotland2
Falkirk,6,5,1,0,13,2,11,16,scotland3
Hamilton,5,4,1,0,10,2,8,13,scotland3
Kelty Hearts,6,3,1,2,8,10,-2,10,scotland3
Montrose,6,3,0,3,8,11,-3,9,scotland3
Annan Athletic,6,2,2,2,10,9,1,8,scotland3
Cove Rangers,5,2,2,1,9,8,1,8,scotland3
Stirling Albion,6,2,2,2,7,8,-1,8,scotland3
Alloa Athletic,5,2,1,2,6,7,-1,7,scotland3
Queen of South,7,1,1,5,10,13,-3,4,scotland3
Edinburgh City,7,1,1,5,8,20,-12,4,scotland3
Dumbarton,6,4,1,1,12,4,8,13,scotland4
Peterhead,5,3,1,1,10,2,8,10,scotland4
Stranraer,6,3,1,2,10,9,1,10,scotland4
Spartans,6,2,3,1,9,7,2,9,scotland4
Bonnyrigg Rose,5,2,2,1,10,6,4,8,scotland4
East Fife,5,2,1,2,7,6,1,7,scotland4
Stenhousemuir,4,1,2,1,9,6,3,5,scotland4
Elgin City,4,1,2,1,4,3,1,5,scotland4
Clyde,6,1,1,4,4,11,-7,4,scotland4
Forfar Athletic,5,0,2,3,5,10,-5,2,scotland4
Red Star,8,7,1,0,22,5,17,22,serbia
Vojvodina,7,5,1,1,14,9,5,16,serbia
Partizan,5,5,0,0,13,4,9,15,serbia
Novi Pazar,7,5,0,2,12,7,5,15,serbia
Vozdovac,7,3,4,0,10,6,4,13,serbia
Mladost Lucani,8,3,3,2,10,10,0,12,serbia
Sp. Subotica,8,4,0,4,10,13,-3,12,serbia
Backa Topola,6,3,2,1,12,9,3,11,serbia
Cukaricki,7,2,4,1,9,8,1,10,serbia
Javor Ivanjica,5,3,0,2,6,7,-1,9,serbia
IMT N. Beograd,6,2,2,2,10,8,2,8,serbia
Radnicki Nis,6,2,2,2,7,7,0,8,serbia
Radnicki 1923,5,2,0,3,10,11,-1,6,serbia
Rad. Surdulica,6,1,2,3,2,3,-1,5,serbia
Z. Pancevo,6,1,1,4,6,10,-4,4,serbia
Napredak,7,1,1,5,3,12,-9,4,serbia
OFK Beograd,6,5,1,0,15,5,10,16,serbia2
Tekstilac Odzac,7,5,1,1,10,2,8,16,serbia2
Macva Sabac,8,4,3,1,8,2,6,15,serbia2
Semendrija 1924,8,4,3,1,9,5,4,15,serbia2
Jedinstvo Ub,7,4,2,1,11,7,4,14,serbia2
S. Mitrovica,7,3,4,0,9,4,5,13,serbia2
Dubocica,6,4,1,1,9,7,2,13,serbia2
OFK Vrac,8,3,3,2,5,4,1,12,serbia2
Novi Sad,6,3,2,1,8,5,3,11,serbia2
Kolubara,7,3,2,2,12,10,2,11,serbia2
Indija,7,3,2,2,7,7,0,11,serbia2
Sloboda Uzice,7,2,4,1,7,6,1,10,serbia2
Radnicki B.,7,2,3,2,8,7,1,9,serbia2
Metalac GM,7,1,4,2,2,5,-3,7,serbia2
Graficar,6,2,0,4,11,12,-1,6,serbia2
Mladost Novi S.,8,0,4,4,6,10,-4,4,serbia2
A. Niigata (S),8,8,0,0,34,6,28,24,singapore
Lion City,8,6,1,1,23,12,11,19,singapore
Tampines Rovers,8,4,2,2,15,12,3,14,singapore
Hougang,8,3,1,4,13,22,-9,10,singapore
Khalsa,8,3,0,5,20,26,-6,9,singapore
Geylang,8,2,1,5,12,20,-8,7,singapore
DPMM FC,8,1,2,5,15,15,0,5,singapore
Tanjong Pagar,8,1,2,5,14,25,-11,5,singapore
Young Lions,8,0,1,7,10,26,-16,1,singapore
Zilina,7,6,0,1,24,14,10,18,slovakia
Podbrezova,7,5,2,0,18,7,11,17,slovakia
S. Bratislava,6,5,1,0,18,5,13,16,slovakia
Trencin,7,4,2,1,10,4,6,14,slovakia
Skalica,7,4,1,2,7,4,3,13,slovakia
DAC Streda,6,4,0,2,14,9,5,12,slovakia
Ruzomberok,7,3,2,2,7,6,1,11,slovakia
Spartak Trnava,7,3,1,3,10,8,2,10,slovakia
Banska Bystrica,6,1,2,3,7,13,-6,5,slovakia
FC Kosice,6,1,1,4,3,13,-10,4,slovakia
Z. Michalovce,7,0,3,4,5,15,-10,3,slovakia
Zlate Moravce,6,0,2,4,4,11,-7,2,slovakia
Komarno,8,7,1,0,18,4,14,22,slovakia2
P. Bystrica,8,5,2,1,20,9,11,17,slovakia2
Futura Humenne,8,5,1,2,15,6,9,16,slovakia2
Petrzalka,8,5,1,2,13,7,6,16,slovakia2
Tatran Presov,7,4,3,0,9,3,6,15,slovakia2
Spartak Myjava,8,5,0,3,14,15,-1,15,slovakia2
Puchov,8,4,1,3,12,8,4,13,slovakia2
OFK Malzenice,8,3,2,3,11,9,2,11,slovakia2
Slavoj Trebisov,8,3,2,3,9,10,-1,11,slovakia2
Pohronie,8,3,2,3,12,15,-3,11,slovakia2
Zilina B,7,3,0,4,16,15,1,9,slovakia2
Dolny Kubin,8,2,2,4,9,15,-6,8,slovakia2
Samorin,6,1,2,3,10,21,-11,5,slovakia2
S. Bratislava B,8,1,2,5,8,20,-12,5,slovakia2
L. Mikulas,1,1,0,0,4,2,2,3,slovakia2
Spisska Nova V.,8,0,1,7,4,13,-9,1,slovakia2
NK Celje,8,6,0,2,16,6,10,18,slovenia
Maribor,7,5,1,1,12,6,6,16,slovenia
Bravo,7,5,0,2,13,10,3,15,slovenia
Koper,7,4,2,1,13,7,6,14,slovenia
NK Olimpija,7,3,3,1,13,8,5,12,slovenia
Domzale,8,2,1,5,9,12,-3,7,slovenia
Aluminij,7,1,2,4,9,13,-4,5,slovenia
Radomlje,6,1,2,3,6,11,-5,5,slovenia
Mura,7,1,2,4,7,13,-6,5,slovenia
Rogaska,7,1,2,4,5,12,-7,5,slovenia
Cape Town City,5,4,0,1,8,3,5,12,southafrica
SuperSport Utd,5,4,0,1,7,4,3,12,southafrica
Kaizer Chiefs,6,3,2,1,8,4,4,11,southafrica
TS Galaxy,6,3,2,1,7,4,3,11,southafrica
Polokwane,6,3,2,1,6,4,2,11,southafrica
Orlando Pirates,5,3,1,1,8,4,4,10,southafrica
Moroka Swallows,6,3,1,2,6,4,2,10,southafrica
Mamelodi S.,3,3,0,0,9,2,7,9,southafrica
AmaZulu,5,2,3,0,4,2,2,9,southafrica
Stellenbosch,6,3,0,3,7,7,0,9,southafrica
Golden Arrows,4,2,2,0,6,4,2,8,southafrica
Royal AM,5,2,1,2,3,4,-1,7,southafrica
Chippa Utd,6,1,3,2,5,7,-2,6,southafrica
Cape Town Spurs,5,1,0,4,4,8,-4,3,southafrica
Sekhukhune,4,0,1,3,2,5,-3,1,southafrica
Richards Bay,6,0,1,5,4,10,-6,1,southafrica
Incheon Utd,8,5,1,2,12,7,5,16,southkorea
Pohang Steelers,8,4,3,1,14,9,5,15,southkorea
Daejeon Citizen,8,4,2,2,12,9,3,14,southkorea
Ulsan,8,4,2,2,10,7,3,14,southkorea
Gwangju,8,4,1,3,10,5,5,13,southkorea
Jeonbuk Motors,8,3,3,2,10,10,0,12,southkorea
Daegu,8,2,5,1,6,5,1,11,southkorea
Suwon Bluewings,8,3,2,3,8,8,0,11,southkorea
Jeju Utd,8,2,4,2,8,6,2,10,southkorea
Seoul,8,2,3,3,15,13,2,9,southkorea
Gangwon,8,1,5,2,9,9,0,8,southkorea
Suwon City,8,0,3,5,11,17,-6,3,southkorea
Gimcheon Sangmu,8,7,1,0,24,4,20,22,southkorea2
Busan IPark,8,7,1,0,13,2,11,22,southkorea2
Gimpo,8,6,0,2,13,7,6,18,southkorea2
Jeonnam Dragons,8,5,2,1,18,11,7,17,southkorea2
Cheongju,8,5,2,1,9,5,4,17,southkorea2
Bucheon FC,8,4,4,0,6,1,5,16,southkorea2
Chungnam Asan,8,5,0,3,12,9,3,15,southkorea2
Anyang,8,3,4,1,12,6,6,13,southkorea2
Seongnam,8,3,3,2,10,9,1,12,southkorea2
Cheonan City,8,3,3,2,11,11,0,12,southkorea2
Seoul E-Land,8,2,1,5,8,15,-7,7,southkorea2
Gyeongnam,8,1,3,4,8,12,-4,6,southkorea2
Ansan Greeners,8,1,1,6,7,17,-10,4,southkorea2
FC Barcelona,6,5,0,1,13,4,9,15,spain
Girona,6,5,0,1,15,8,7,15,spain
Atletico Madrid,5,5,0,0,13,6,7,15,spain
Athletic Bilbao,7,4,2,1,18,11,7,14,spain
Real Betis,6,4,2,0,9,2,7,14,spain
Real Sociedad,7,4,2,1,15,9,6,14,spain
Real Madrid,5,4,1,0,10,2,8,13,spain
Valencia,6,4,0,2,8,3,5,12,spain
Getafe,6,3,3,0,6,3,3,12,spain
Las Palmas,6,3,2,1,6,4,2,11,spain
Alaves,6,3,1,2,7,8,-1,10,spain
Cadiz,6,2,3,1,7,5,2,9,spain
Sevilla FC,6,2,2,2,11,8,3,8,spain
Rayo Vallecano,6,1,3,2,8,14,-6,6,spain
Granada,6,1,2,3,10,14,-4,5,spain
Mallorca,5,0,4,1,3,4,-1,4,spain
Villarreal,7,1,1,5,11,15,-4,4,spain
Osasuna,6,1,1,4,5,10,-5,4,spain
Celta Vigo,7,0,3,4,4,11,-7,3,spain
Almeria,7,0,2,5,10,18,-8,2,spain
Leganes,8,6,1,1,15,3,12,19,spain2
Valladolid,8,6,1,1,14,5,9,19,spain2
Burgos,7,5,2,0,12,4,8,17,spain2
Sporting Gijon,6,5,1,0,13,4,9,16,spain2
Racing,7,5,1,1,14,6,8,16,spain2
Tenerife,7,5,1,1,8,2,6,16,spain2
Racing Ferrol,7,4,3,0,9,4,5,15,spain2
Espanyol,7,4,2,1,15,8,7,14,spain2
Elche,7,4,2,1,7,4,3,14,spain2
Eibar,6,4,1,1,13,4,9,13,spain2
FC Andorra,7,4,1,2,8,4,4,13,spain2
Albacete,8,3,3,2,12,11,1,12,spain2
Levante,7,3,3,1,11,10,1,12,spain2
Real Oviedo,6,3,2,1,7,2,5,11,spain2
Eldense,7,3,2,2,10,8,2,11,spain2
Real Zaragoza,8,3,2,3,8,7,1,11,spain2
Mirandes,7,3,1,3,13,12,1,10,spain2
Villarreal B,7,3,1,3,12,13,-1,10,spain2
Amorebieta,7,2,3,2,7,4,3,9,spain2
Alcorcon,7,1,2,4,6,11,-5,5,spain2
Huesca,7,0,3,4,3,8,-5,3,spain2
Cartagena,7,0,0,7,4,15,-11,0,spain2
Hacken,8,8,0,0,25,10,15,24,sweden
Malmo FF,8,5,2,1,19,6,13,17,sweden
Elfsborg,8,5,2,1,14,9,5,17,sweden
AIK,8,4,3,1,12,5,7,15,sweden
Hammarby,8,4,3,1,16,12,4,15,sweden
Norrkoping,8,5,0,3,12,9,3,15,sweden
IFK Goteborg,8,4,2,2,11,7,4,14,sweden
Varnamo,8,4,2,2,7,4,3,14,sweden
Djurgarden,8,4,1,3,12,11,1,13,sweden
Sirius,8,4,0,4,20,13,7,12,sweden
Kalmar,8,3,2,3,5,10,-5,11,sweden
Halmstad,8,2,3,3,9,13,-4,9,sweden
Brommapojkarna,8,2,1,5,10,15,-5,7,sweden
Degerfors,8,2,1,5,7,13,-6,7,sweden
Mjallby,8,2,0,6,7,13,-6,6,sweden
Varberg BoIS,8,1,1,6,7,16,-9,4,sweden
Vasteras,8,7,1,0,15,4,11,22,sweden2
Skovde AIK,8,6,0,2,19,8,11,18,sweden2
Oster,8,5,2,1,16,6,10,17,sweden2
GAIS,8,5,2,1,17,9,8,17,sweden2
Brage,8,5,1,2,18,11,7,16,sweden2
Orebro,8,4,3,1,18,6,12,15,sweden2
Gefle,8,4,2,2,12,13,-1,14,sweden2
Utsikten,8,3,4,1,15,7,8,13,sweden2
Helsingborg,8,4,1,3,14,11,3,13,sweden2
Ostersunds,8,3,4,1,14,11,3,13,sweden2
GIF Sundsvall,8,3,4,1,12,10,2,13,sweden2
AFC Eskilstuna,8,3,2,3,12,11,1,11,sweden2
Landskrona,8,2,3,3,11,10,1,9,sweden2
Jonkopings,8,2,3,3,9,12,-3,9,sweden2
Trelleborg,8,2,3,3,9,17,-8,9,sweden2
Orgryte,8,1,3,4,8,16,-8,6,sweden2
St. Gallen,6,6,0,0,15,5,10,18,switzerland
Luzern,7,5,1,1,13,9,4,16,switzerland
FC Zurich,7,4,2,1,12,7,5,14,switzerland
BSC Young Boys,5,4,1,0,14,4,10,13,switzerland
Lausanne Sport,7,3,2,2,13,10,3,11,switzerland
Yverdon,6,3,2,1,11,9,2,11,switzerland
Winterthur,7,3,2,2,11,11,0,11,switzerland
Lugano,5,3,1,1,10,4,6,10,switzerland
Servette,6,2,3,1,11,9,2,9,switzerland
FC Basel,7,2,2,3,11,12,-1,8,switzerland
Grasshopper,6,2,1,3,7,8,-1,7,switzerland
Lausanne Ouchy,7,1,3,3,8,16,-8,6,switzerland
Jabala,3,2,1,0,6,2,4,7,syria
Teshrin,2,2,0,0,3,1,2,6,syria
Foutoua,2,2,0,0,2,0,2,6,syria
Hottin,2,2,0,0,2,0,2,6,syria
Wathbah,3,1,2,0,2,0,2,5,syria
Taliya,2,1,1,0,2,0,2,4,syria
Al Jaish,3,1,1,1,4,3,1,4,syria
Al Sahel,3,1,0,2,2,4,-2,3,syria
Al Wahda,2,0,2,0,3,3,0,2,syria
Al Ittihad,2,0,2,0,2,2,0,2,syria
Karama,2,0,1,1,2,3,-1,1,syria
Horriya,2,0,0,2,0,2,-2,0,syria
Young Africans,5,5,0,0,16,2,14,15,tanzania
Simba,5,3,1,1,9,7,2,10,tanzania
KMC,5,3,1,1,6,4,2,10,tanzania
Azam,4,3,0,1,10,5,5,9,tanzania
Dodoma Jiji,4,2,2,0,4,2,2,8,tanzania
Kagera Sugar,4,2,2,0,4,2,2,8,tanzania
Tabora,3,2,1,0,5,2,3,7,tanzania
JKT Tanzania,4,2,1,1,3,2,1,7,tanzania
Mashujaa,5,2,1,2,5,6,-1,7,tanzania
Ihefu,5,2,1,2,4,5,-1,7,tanzania
Coastal Union,5,1,2,2,2,2,0,5,tanzania
T. Prisons,4,1,2,1,5,6,-1,5,tanzania
Mtibwa Sugar,6,1,1,4,7,11,-4,4,tanzania
Singida,4,0,3,1,3,4,-1,3,tanzania
Namungo,4,0,2,2,3,5,-2,2,tanzania
Geita Gold,4,0,2,2,3,7,-4,2,tanzania
Bangkok Utd,5,4,1,0,10,2,8,13,thailand
Port FC,5,4,0,1,15,7,8,12,thailand
Chiangrai Utd,5,3,2,0,8,2,6,11,thailand
Trat,6,3,2,1,9,7,2,11,thailand
Pathum Utd,4,3,1,0,11,2,9,10,thailand
Ratchaburi,5,3,0,2,13,6,7,9,thailand
Police Tero,7,2,3,2,12,13,-1,9,thailand
Buriram Utd,4,2,2,0,9,2,7,8,thailand
Nakhon Pathom,5,2,2,1,11,9,2,8,thailand
Lamphun Warrior,5,2,1,2,6,6,0,7,thailand
Sukhothai,5,2,1,2,6,6,0,7,thailand
Khon Kaen Utd,5,1,3,1,8,8,0,6,thailand
Uthai Thani,5,2,0,3,7,13,-6,6,thailand
Chonburi,3,1,1,1,1,2,-1,4,thailand
Prachuap,4,1,1,2,5,7,-2,4,thailand
Muang Thong Utd,3,1,0,2,4,5,-1,3,thailand
N. Ratchasima,6,5,1,0,9,1,8,16,thailand2
Chiangmai FC,6,5,0,1,21,9,12,15,thailand2
Suphanburi,6,4,1,1,10,5,5,13,thailand2
Nakhon Si Thamm,6,3,3,0,9,3,6,12,thailand2
N. Bua Pitchaya,5,3,2,0,10,2,8,11,thailand2
Lampang,6,3,2,1,7,5,2,11,thailand2
Kanchanaburi,5,3,1,1,11,5,6,10,thailand2
Chiangmai Utd,6,2,2,2,11,8,3,8,thailand2
Ayutthaya Utd,5,2,2,1,9,6,3,8,thailand2
Phrae Utd,6,2,2,2,8,7,1,8,thailand2
Rayong,5,2,2,1,4,3,1,8,thailand2
Kasetsart,6,2,2,2,6,7,-1,8,thailand2
Samut Prakan,5,2,1,2,7,6,1,7,thailand2
Pattaya United,6,1,3,2,7,9,-2,6,thailand2
Chanthaburi,5,1,2,2,8,7,1,5,thailand2
Chainat,6,1,0,5,7,14,-7,3,thailand2
Krabi,8,0,3,5,1,8,-7,3,thailand2
Customs Utd,6,0,1,5,4,17,-13,1,thailand2
Adana Demirspor,6,6,0,0,17,3,14,18,turkey
Fenerbahce,6,5,0,1,20,8,12,15,turkey
Galatasaray,5,5,0,0,12,5,7,15,turkey
Trabzonspor,6,5,0,1,11,5,6,15,turkey
Kayserispor,6,4,2,0,8,2,6,14,turkey
Besiktas,5,4,1,0,9,2,7,13,turkey
Antalyaspor,6,3,2,1,8,6,2,11,turkey
Kasimpasa,6,3,1,2,10,12,-2,10,turkey
Gaziantep,5,3,0,2,6,6,0,9,turkey
Hatayspor,5,2,2,1,10,8,2,8,turkey
Alanyaspor,6,2,2,2,8,7,1,8,turkey
Rizespor,5,2,2,1,3,2,1,8,turkey
Ankaragucu,6,2,2,2,7,7,0,8,turkey
Samsunspor,5,2,1,2,5,6,-1,7,turkey
F. Karagumruk,6,1,3,2,5,5,0,6,turkey
Konyaspor,6,1,2,3,6,8,-2,5,turkey
Basaksehir,5,1,1,3,6,8,-2,4,turkey
Sivasspor,6,0,4,2,4,7,-3,4,turkey
Istanbulspor,6,1,1,4,6,11,-5,4,turkey
Pendikspor,5,0,2,3,5,15,-10,2,turkey
Eyupspor,6,5,0,1,14,3,11,15,turkey2
Bodrumspor,5,4,1,0,10,2,8,13,turkey2
Bandirmaspor,5,3,2,0,9,2,7,11,turkey2
Kocaelispor,6,3,2,1,11,8,3,11,turkey2
Genclerbirligi,6,3,2,1,8,5,3,11,turkey2
Sakaryaspor,6,2,3,1,6,4,2,9,turkey2
Keciorengucu,6,3,0,3,6,5,1,9,turkey2
Adanaspor,6,3,0,3,7,8,-1,9,turkey2
Boluspor,6,2,2,2,5,7,-2,8,turkey2
Erzurum BB,5,2,1,2,7,4,3,7,turkey2
Goztepe,6,2,1,3,6,5,1,7,turkey2
Manisa BB,5,1,3,1,7,4,3,6,turkey2
Sanliurfaspor,5,1,2,2,3,5,-2,5,turkey2
Giresunspor,6,1,2,3,1,3,-2,5,turkey2
Umraniyespor,5,1,2,2,4,7,-3,5,turkey2
Altay,5,1,1,3,3,7,-4,4,turkey2
Tuzlaspor,6,1,1,4,4,13,-9,4,turkey2
Corum,5,1,0,4,5,9,-4,3,turkey2
Al Wasl,4,3,1,0,8,4,4,10,uae
Bani Yas,4,3,1,0,7,3,4,10,uae
Al Ain,3,3,0,0,12,3,9,9,uae
Shabab Al Ahli,3,2,1,0,8,5,3,7,uae
Al Khaleej,4,2,1,1,9,8,1,7,uae
Al Wahda,3,2,0,1,4,3,1,6,uae
Al Jazira,4,1,2,1,6,5,1,5,uae
Al Bataeh,4,1,2,1,4,4,0,5,uae
Al Sharjah,3,1,0,2,8,6,2,3,uae
Al Nasr,4,1,0,3,2,6,-4,3,uae
Ittihad Kalba,4,1,0,3,6,12,-6,3,uae
Emirates,3,0,1,2,7,11,-4,1,uae
Ajman,3,0,0,3,3,9,-6,0,uae
Hatta,3,0,0,3,0,10,-10,0,uae
Dnipro-1,7,4,2,1,8,4,4,14,ukraine
Chornomorets,5,4,1,0,9,2,7,13,ukraine
Kryvbas KR,6,4,1,1,12,7,5,13,ukraine
Kolos Kovalivka,8,3,3,2,7,6,1,12,ukraine
Polessya,5,3,1,1,8,5,3,10,ukraine
Metalist 1925,6,3,1,2,7,7,0,10,ukraine
Dynamo Kyiv,5,3,0,2,10,5,5,9,ukraine
Shakhtar,4,3,0,1,7,3,4,9,ukraine
Rukh Lviv,8,1,6,1,9,8,1,9,ukraine
LNZ Cherkasy,8,2,2,4,9,11,-2,8,ukraine
Vorskla Poltava,7,2,1,4,9,15,-6,7,ukraine
Oleksandria,6,2,1,3,4,10,-6,7,ukraine
Obolon,6,1,3,2,5,8,-3,6,ukraine
Veres,7,1,3,3,9,13,-4,6,ukraine
FC Minaj,7,0,4,3,3,10,-7,4,ukraine
Zorya Luhansk,4,0,1,3,1,5,-4,1,ukraine
Penarol,8,6,2,0,13,4,9,20,uruguay
Nacional,7,6,1,0,18,3,15,19,uruguay
Liverpool M.,7,5,1,1,15,8,7,16,uruguay
River Plate,7,5,0,2,13,10,3,15,uruguay
Cerro Largo,8,4,3,1,8,7,1,15,uruguay
Danubio,7,3,3,1,12,4,8,12,uruguay
D. Maldonado,6,3,3,0,9,5,4,12,uruguay
Defensor S.,8,2,5,1,14,11,3,11,uruguay
Plaza Colonia,8,3,2,3,11,9,2,11,uruguay
Cerro,7,2,4,1,5,4,1,10,uruguay
La Luz,8,3,1,4,15,19,-4,10,uruguay
Fenix,7,1,3,3,3,6,-3,6,uruguay
Boston River,7,1,3,3,6,11,-5,6,uruguay
Wanderers,7,1,2,4,5,8,-3,5,uruguay
Racing CM,8,0,5,3,4,9,-5,5,uruguay
Montevideo City,8,0,3,5,4,15,-11,3,uruguay
Liverpool M.,4,3,1,0,11,6,5,10,uruguay2
Nacional,4,3,0,1,9,2,7,9,uruguay2
Defensor S.,3,3,0,0,7,1,6,9,uruguay2
Penarol,4,3,0,1,7,5,2,9,uruguay2
Racing CM,3,2,1,0,8,3,5,7,uruguay2
Danubio,3,2,1,0,2,0,2,7,uruguay2
Wanderers,4,1,3,0,6,2,4,6,uruguay2
Boston River,4,2,0,2,5,2,3,6,uruguay2
Cerro Largo,4,2,0,2,5,5,0,6,uruguay2
Cerro,4,1,2,1,3,3,0,5,uruguay2
Fenix,3,1,1,1,3,1,2,4,uruguay2
Montevideo City,3,1,1,1,4,3,1,4,uruguay2
La Luz,4,1,0,3,6,10,-4,3,uruguay2
D. Maldonado,3,0,2,1,2,3,-1,2,uruguay2
River Plate,3,0,2,1,1,2,-1,2,uruguay2
Plaza Colonia,3,0,2,1,5,7,-2,2,uruguay2
Orlando City,8,6,2,0,22,10,12,20,usa
Columbus Crew,8,6,2,0,16,4,12,20,usa
New England,8,6,1,1,16,8,8,19,usa
St. Louis City,8,5,1,2,18,10,8,16,usa
Philadelphia,8,4,4,0,16,8,8,16,usa
Sporting KC,8,5,1,2,15,9,6,16,usa
Portland,8,5,1,2,16,13,3,16,usa
Houston Dynamo,8,4,3,1,19,8,11,15,usa
New York City,8,4,3,1,10,4,6,15,usa
Atlanta Utd,8,4,2,2,20,10,10,14,usa
Cincinnati,8,4,2,2,17,8,9,14,usa
Charlotte,8,3,5,0,11,6,5,14,usa
Los Angeles FC,8,4,1,3,20,11,9,13,usa
Austin,8,4,1,3,18,12,6,13,usa
New York RB,8,4,1,3,12,7,5,13,usa
LA Galaxy,8,3,4,1,18,15,3,13,usa
Real Salt Lake,8,4,1,3,16,13,3,13,usa
Chicago Fire,8,4,1,3,12,9,3,13,usa
DC United,8,3,3,2,16,11,5,12,usa
Vancouver,8,3,3,2,15,11,4,12,usa
CF Montreal,8,3,3,2,11,8,3,12,usa
Colorado Rapids,8,3,3,2,8,7,1,12,usa
Inter Miami,8,2,5,1,13,9,4,11,usa
Dallas,8,2,5,1,9,7,2,11,usa
Nashville SC,8,3,2,3,9,8,1,11,usa
Seattle,8,2,5,1,6,6,0,11,usa
Minnesota Utd,8,2,4,2,13,9,4,10,usa
SJ Earthquakes,8,2,4,2,12,11,1,10,usa
Toronto,8,1,1,6,9,14,-5,4,usa
Pittsburgh,8,7,0,1,18,9,9,21,usa2
Orange County,8,6,1,1,11,3,8,19,usa2
Tampa Bay,8,6,0,2,17,9,8,18,usa2
Charleston,8,6,0,2,13,5,8,18,usa2
Rio Grande,8,5,1,2,15,9,6,16,usa2
Sacramento R.,8,4,3,1,10,4,6,15,usa2
Phoenix Rising,8,4,2,2,18,7,11,14,usa2
Indy Eleven,8,4,2,2,12,5,7,14,usa2
San Diego Loyal,8,4,2,2,17,11,6,14,usa2
Detroit City,8,4,2,2,8,6,2,14,usa2
San Antonio,8,3,4,1,17,10,7,13,usa2
Miami FC,8,4,1,3,14,10,4,13,usa2
New Mexico,8,4,1,3,15,13,2,13,usa2
Louisville City,8,3,3,2,12,10,2,12,usa2
Colorado S.,8,3,3,2,11,12,-1,12,usa2
Birmingham L.,8,3,2,3,10,9,1,11,usa2
Memphis,8,3,1,4,15,15,0,10,usa2
FC Tulsa,8,3,1,4,10,14,-4,10,usa2
Monterey Bay,8,2,1,5,8,13,-5,7,usa2
Oakland Roots,8,1,3,4,9,12,-3,6,usa2
El Paso,8,1,3,4,10,14,-4,6,usa2
Las Vegas L.,8,2,0,6,10,19,-9,6,usa2
Loudoun Utd,8,1,2,5,8,16,-8,5,usa2
Hartford A.,8,1,1,6,9,21,-12,4,usa2
Union Omaha,8,8,0,0,22,10,12,24,usa3
Charlotte,8,5,2,1,16,7,9,17,usa3
N. Colorado,8,5,1,2,16,11,5,16,usa3
North Carolina,8,4,2,2,14,11,3,14,usa3
Greenville,8,4,1,3,9,10,-1,13,usa3
Chattanooga RW,8,3,3,2,19,16,3,12,usa3
Lexington,8,3,3,2,15,13,2,12,usa3
Forward Madison,8,2,4,2,7,6,1,10,usa3
Tormenta,8,3,1,4,13,17,-4,10,usa3
One Knoxville,8,1,3,4,11,15,-4,6,usa3
Richmond K.,8,0,3,5,14,20,-6,3,usa3
Central Valley,8,0,3,5,9,17,-8,3,usa3
Andijan,8,5,2,1,9,4,5,17,uzbekistan
Navbahor,8,5,1,2,11,4,7,16,uzbekistan
AMGK,8,5,1,2,17,14,3,16,uzbekistan
Nasaf Qarshi,8,4,3,1,7,1,6,15,uzbekistan
Pakhtakor,8,4,3,1,10,5,5,15,uzbekistan
Neftchi,8,3,4,1,7,3,4,13,uzbekistan
Sogdiana,8,4,1,3,10,8,2,13,uzbekistan
Termez Surkhon,8,4,1,3,9,8,1,13,uzbekistan
Qizilqum,8,3,1,4,14,12,2,10,uzbekistan
Metallurg,8,2,4,2,9,7,2,10,uzbekistan
Turan,8,2,3,3,5,8,-3,9,uzbekistan
Bunyodkor,8,2,2,4,9,12,-3,8,uzbekistan
FK Olympic,8,1,4,3,9,12,-3,7,uzbekistan
Buxoro,8,1,1,6,4,12,-8,4,uzbekistan
Puerto Cabello,8,7,1,0,15,2,13,22,venezuela
D. Tachira,8,7,1,0,13,2,11,22,venezuela
Carabobo,8,5,3,0,16,6,10,18,venezuela
Caracas,8,4,4,0,16,6,10,16,venezuela
UCV,8,5,0,3,17,9,8,15,venezuela
E. Merida,8,3,4,1,13,7,6,13,venezuela
D. La Guaira,8,2,6,0,10,8,2,12,venezuela
Rayo Zuliano,8,3,3,2,7,6,1,12,venezuela
Angostura,8,3,2,3,9,7,2,11,venezuela
Portuguesa,8,3,2,3,9,7,2,11,venezuela
Metropolitanos,8,3,2,3,12,12,0,11,venezuela
Zamora,8,3,1,4,11,12,-1,10,venezuela
M. de Guayana,8,2,3,3,10,12,-2,9,venezuela
Monagas,8,2,2,4,8,13,-5,8,venezuela
H. Colmenares,8,2,1,5,5,10,-5,7,venezuela
Ha Noi,8,6,1,1,16,7,9,19,vietnam
The Cong,8,5,1,2,14,9,5,16,vietnam
Cong An Nhan,8,4,3,1,14,8,6,15,vietnam
Song Lam Nghe,8,4,3,1,11,7,4,15,vietnam
Hong Linh Ha T.,8,3,5,0,11,6,5,14,vietnam
H. A. Gia Lai,8,3,4,1,7,5,2,13,vietnam
S. Khanh Hoa,8,3,3,2,12,9,3,12,vietnam
Nam Dinh,8,2,5,1,7,5,2,11,vietnam
Hai Phong,8,3,2,3,9,9,0,11,vietnam
Binh Dinh,8,2,3,3,9,9,0,9,vietnam
Thanh Hoa,8,3,0,5,12,16,-4,9,vietnam
Ho Chi Minh,8,2,2,4,11,13,-2,8,vietnam
Da Nang,8,1,4,3,5,7,-2,7,vietnam
Binh Duong,8,1,3,4,11,12,-1,6,vietnam
Quang Nam,8,8,0,0,25,5,20,24,vietnam2
Pho Hien,8,5,3,0,15,5,10,18,vietnam2
Long An,8,5,3,0,16,8,8,18,vietnam2
Hue,8,4,3,1,14,3,11,15,vietnam2
Hoa Binh,8,3,5,0,9,5,4,14,vietnam2
Binh Phuoc,8,3,2,3,12,11,1,11,vietnam2
Phu Tho,8,3,2,3,8,9,-1,11,vietnam2
Ba Ria Vung Tau,8,3,2,3,10,12,-2,11,vietnam2
Binh Thuan,8,3,0,5,11,22,-11,9,vietnam2
Phu Dong,8,1,4,3,6,9,-3,7,vietnam2
The New Saints,7,6,1,0,31,6,25,19,wales
Connah`s Quay,7,6,1,0,24,6,18,19,wales
Bala Town,8,5,2,1,8,3,5,17,wales
Cardiff MU,8,5,2,1,12,9,3,17,wales
Newtown,8,4,2,2,11,7,4,14,wales
Caernarfon Town,8,4,1,3,15,14,1,13,wales
Haverfordwest,7,3,2,2,13,10,3,11,wales
Penybont,7,3,1,3,7,9,-2,10,wales
Pontypridd Town,8,2,2,4,4,8,-4,8,wales
Barry Town,8,2,2,4,11,18,-7,8,wales
Colwyn Bay,7,1,1,5,8,15,-7,4,wales
Aberystwyth,5,0,1,4,4,9,-5,1,wales
