Equipe,GP,W,D,L,GF,GA,GD,Pts,albania2
Bylis,4,4,0,0,9,2,7,12,albania2
AF Elbasani,4,3,1,0,11,6,5,10,albania2
Flamurtari,4,3,0,1,4,3,1,9,albania2
Korabi Peshkopi,4,2,2,0,7,2,5,8,albania2
Apolonia Fier,4,2,2,0,8,4,4,8,albania2
Lushnja,4,2,0,2,7,8,-1,6,albania2
Vora,4,1,2,1,3,3,0,5,albania2
Kastrioti Kruje,4,1,1,2,4,5,-1,4,albania2
Luzi 2008,4,1,1,2,4,5,-1,4,albania2
Burreli,4,0,2,2,1,4,-3,2,albania2
Besa Kavaje,4,0,1,3,1,4,-3,1,albania2
Tomori Berat,4,0,0,4,1,11,-10,0,albania2
MC Alger,4,4,0,0,13,3,10,12,algeria
CR Belouizdad,4,3,0,1,6,2,4,9,algeria
US Biskra,4,2,2,0,5,3,2,8,algeria
El Bayadh,4,2,1,1,6,3,3,7,algeria
ASO Chlef,4,2,1,1,7,5,2,7,algeria
CS Constantine,4,2,1,1,6,4,2,7,algeria
JS Kabylie,4,2,1,1,5,3,2,7,algeria
JS Saoura,4,2,1,1,4,6,-2,7,algeria
USM Alger,4,2,0,2,6,4,2,6,algeria
ES Setif,4,1,2,1,5,5,0,5,algeria
NC Magra,4,1,2,1,3,6,-3,5,algeria
Khenchela,4,1,1,2,2,3,-1,4,algeria
Paradou AC,4,1,1,2,1,2,-1,4,algeria
MC Oran,4,1,1,2,2,4,-2,4,algeria
Ben Aknoun,4,0,1,3,1,5,-4,1,algeria
US Souf,4,0,0,4,3,11,-8,0,algeria
Oued Akbou,4,4,0,0,6,2,4,12,algeria2
Bordj Menaïel,4,3,1,0,9,5,4,10,algeria2
Temouchent,4,3,0,1,8,4,4,9,algeria2
MO Constantine,4,3,0,1,6,4,2,9,algeria2
RC Kouba,4,3,0,1,5,3,2,9,algeria2
Mostaganem,4,2,2,0,6,0,6,8,algeria2
WA Mostaganem,4,2,1,1,6,3,3,7,algeria2
MSP Batna,4,2,1,1,5,3,2,7,algeria2
Khroub,4,2,1,1,6,5,1,7,algeria2
GC Mascara,4,2,1,1,4,3,1,7,algeria2
Khemis Melina,4,2,1,1,4,3,1,7,algeria2
Oued Sly,4,2,1,1,4,3,1,7,algeria2
CA Batna,4,1,3,0,3,0,3,6,algeria2
El Ghozlane,4,2,0,2,6,6,0,6,algeria2
Oued Magrane,4,2,0,2,4,4,0,6,algeria2
Chelghoum,4,2,0,2,3,3,0,6,algeria2
Koléa,4,1,2,1,3,2,1,5,algeria2
ASM Oran,4,1,2,1,4,4,0,5,algeria2
Tiaret,4,1,2,1,1,2,-1,5,algeria2
El Harrach,4,1,1,2,4,4,0,4,algeria2
Khemis El K.,4,1,1,2,4,5,-1,4,algeria2
Olympique Medea,4,1,1,2,2,3,-1,4,algeria2
RB Ouargla,4,1,1,2,1,2,-1,4,algeria2
Mechria,4,1,1,2,5,7,-2,4,algeria2
El Eulma,4,1,1,2,2,5,-3,4,algeria2
Hussein Dey,4,1,1,2,4,8,-4,4,algeria2
Teleghma,4,1,0,3,7,9,-2,3,algeria2
Ghir Abadla,4,1,0,3,4,6,-2,3,algeria2
RC Arbaa,4,1,0,3,2,8,-6,3,algeria2
Inter Escaldes,4,4,0,0,18,0,18,12,andorra
A. Escaldes,4,3,0,1,10,4,6,9,andorra
FC Santa Coloma,4,3,0,1,7,4,3,9,andorra
UE Santa Coloma,4,3,0,1,7,5,2,9,andorra
Ordino,4,2,1,1,3,3,0,7,andorra
Penya Encarnada,4,2,0,2,6,3,3,6,andorra
Carroi,4,2,0,2,6,5,1,6,andorra
Pas de la Casa,4,0,1,3,1,7,-6,1,andorra
Esperanca,4,0,0,4,1,14,-13,0,andorra
A. America,4,0,0,4,2,16,-14,0,andorra
Boca Juniors,4,4,0,0,8,2,6,12,argentina
A. Tucuman,4,3,1,0,5,0,5,10,argentina
Tigre,4,3,0,1,6,2,4,9,argentina
River Plate,4,2,2,0,8,5,3,8,argentina
Estudiantes,4,2,1,1,8,5,3,7,argentina
Argentinos Jrs,4,2,1,1,5,3,2,7,argentina
Rosario Central,4,1,3,0,6,4,2,6,argentina
Banfield,4,1,3,0,4,2,2,6,argentina
Union Santa Fe,4,1,3,0,2,0,2,6,argentina
T. de Cordoba,4,1,3,0,4,3,1,6,argentina
Instituto,4,2,0,2,6,6,0,6,argentina
Huracan,4,2,0,2,2,2,0,6,argentina
Defensa y J.,4,1,2,1,7,6,1,5,argentina
Lanus,4,1,2,1,7,6,1,5,argentina
Racing Club,4,1,2,1,5,4,1,5,argentina
Newells,4,1,2,1,4,3,1,5,argentina
Godoy Cruz,4,1,2,1,7,7,0,5,argentina
Arsenal Sarandi,4,1,2,1,2,2,0,5,argentina
Platense,4,1,2,1,2,2,0,5,argentina
Barracas C.,4,1,2,1,1,2,-1,5,argentina
San Lorenzo,4,1,1,2,1,4,-3,4,argentina
Velez Sarsfield,4,0,3,1,2,3,-1,3,argentina
Independiente,4,1,0,3,1,5,-4,3,argentina
Gimnasia,4,0,2,2,4,8,-4,2,argentina
Sarmiento,4,0,2,2,1,5,-4,2,argentina
Belgrano,4,0,2,2,0,5,-5,2,argentina
Colon Santa Fe,4,0,1,3,1,6,-5,1,argentina
Central Cordoba,4,0,0,4,1,8,-7,0,argentina
Atletico Mitre,4,4,0,0,8,1,7,12,argentina3
CA Guemes,4,3,1,0,6,2,4,10,argentina3
Chaco For Ever,4,3,1,0,6,2,4,10,argentina3
E. Rio Cuarto,4,3,0,1,6,3,3,9,argentina3
Racing Cordoba,4,3,0,1,6,4,2,9,argentina3
Agropecuario,4,2,2,0,6,2,4,8,argentina3
Almirante Brown,4,2,2,0,3,0,3,8,argentina3
I. Rivadavia,4,2,2,0,3,1,2,8,argentina3
G. Mendoza,4,2,1,1,11,6,5,7,argentina3
Quilmes,4,2,1,1,9,5,4,7,argentina3
SM San Juan,4,2,1,1,7,4,3,7,argentina3
D. Riestra,4,2,1,1,5,2,3,7,argentina3
Nueva Chicago,4,2,1,1,4,3,1,7,argentina3
Ferro Carril,4,1,3,0,5,3,2,6,argentina3
Chacarita J.,4,1,3,0,6,5,1,6,argentina3
San Telmo,4,2,0,2,6,6,0,6,argentina3
D. de Belgrano,4,2,0,2,4,4,0,6,argentina3
Gimnasia Jujuy,4,2,0,2,4,4,0,6,argentina3
Tristan Suarez,4,2,0,2,6,7,-1,6,argentina3
Guillermo Brown,4,2,0,2,4,7,-3,6,argentina3
Deportivo Maipu,4,1,2,1,4,4,0,5,argentina3
Flandria,4,1,2,1,3,5,-2,5,argentina3
Almagro,4,1,1,2,6,7,-1,4,argentina3
Alvarado,4,1,1,2,6,7,-1,4,argentina3
All Boys,4,1,1,2,3,4,-1,4,argentina3
Defensores U.,4,1,1,2,6,8,-2,4,argentina3
Patronato,4,1,1,2,4,6,-2,4,argentina3
Temperley,4,1,1,2,4,6,-2,4,argentina3
Deportivo Moron,4,0,3,1,2,3,-1,3,argentina3
Ararat-Armenia,4,3,1,0,7,2,5,10,armenia
Noah,4,3,0,1,11,5,6,9,armenia
Pyunik,4,2,2,0,9,4,5,8,armenia
West Armenia,4,2,1,1,5,7,-2,7,armenia
BKMA,4,2,0,2,9,4,5,6,armenia
Alashkert,4,1,3,0,4,3,1,6,armenia
Urartu,4,1,1,2,5,8,-3,4,armenia
Van,4,1,1,2,8,12,-4,4,armenia
Ararat Yerevan,4,1,0,3,3,5,-2,3,armenia
Shirak,4,0,1,3,2,9,-7,1,armenia
Brisbane Roar,4,3,1,0,8,4,4,10,australia
Macarthur FC,4,2,2,0,10,7,3,8,australia
Central Coast,4,2,1,1,10,5,5,7,australia
Western Sydney,4,2,1,1,8,6,2,7,australia
Melbourne City,4,2,1,1,7,5,2,7,australia
Wellington,4,2,1,1,3,4,-1,7,australia
Sydney FC,4,2,0,2,8,6,2,6,australia
Melbourne V.,4,1,3,0,8,7,1,6,australia
Newcastle Jets,4,2,0,2,5,5,0,6,australia
Adelaide Utd,4,1,0,3,7,12,-5,3,australia
Perth Glory,4,0,0,4,4,9,-5,0,australia
Western United,4,0,0,4,1,9,-8,0,australia
Sturm Graz,4,3,1,0,7,1,6,10,austria
Salzburg,4,3,1,0,5,2,3,10,austria
Hartberg,4,2,1,1,6,4,2,7,austria
LASK Linz,4,2,1,1,4,3,1,7,austria
Tirol,4,2,0,2,8,5,3,6,austria
Rapid Wien,4,2,0,2,3,3,0,6,austria
Wolfsberger AC,4,2,0,2,4,5,-1,6,austria
A. Klagenfurt,4,1,2,1,4,6,-2,5,austria
BW Linz,4,1,1,2,4,4,0,4,austria
Austria Wien,4,0,3,1,2,3,-1,3,austria
Altach,4,1,0,3,4,7,-3,3,austria
A. Lustenau,4,0,0,4,3,11,-8,0,austria
Ried,4,3,1,0,13,1,12,10,austria2
Leoben,4,3,1,0,11,2,9,10,austria2
First Vienna,4,3,1,0,7,2,5,10,austria2
Floridsdorfer,4,3,0,1,7,3,4,9,austria2
SV Horn,4,3,0,1,7,3,4,9,austria2
Grazer AK,4,3,0,1,9,6,3,9,austria2
St. Polten,4,3,0,1,8,5,3,9,austria2
Admira Wacker,4,2,0,2,7,5,2,6,austria2
Bregenz,4,1,2,1,6,5,1,5,austria2
Liefering,4,1,1,2,8,6,2,4,austria2
Kapfenberger,4,1,1,2,5,7,-2,4,austria2
Stripfing,4,1,0,3,2,10,-8,3,austria2
Lafnitz,4,1,0,3,5,14,-9,3,austria2
Amstetten,4,0,2,2,5,9,-4,2,austria2
Sturm Graz B,4,0,0,4,2,12,-10,0,austria2
Dornbirn,4,0,0,4,1,12,-11,0,austria2
Qarabag,4,4,0,0,14,3,11,12,azerbaijan
Sabah,4,3,0,1,10,4,6,9,azerbaijan
Kapaz,4,2,1,1,4,2,2,7,azerbaijan
Neftci,4,2,1,1,6,5,1,7,azerbaijan
Zira,4,1,2,1,1,1,0,5,azerbaijan
Sumqayit,4,1,2,1,5,9,-4,5,azerbaijan
Araz,4,0,3,1,2,3,-1,3,azerbaijan
Qabala,4,1,0,3,4,7,-3,3,azerbaijan
Sebail,4,0,2,2,2,8,-6,2,azerbaijan
Turan,4,0,1,3,6,12,-6,1,azerbaijan
B. Police,4,4,0,0,15,5,10,12,bangladesh
Bashundhara K.,4,4,0,0,12,6,6,12,bangladesh
Mohammedan,4,3,0,1,11,3,8,9,bangladesh
Sheikh Russel,4,2,2,0,6,3,3,8,bangladesh
Abahani,4,2,1,1,5,2,3,7,bangladesh
Chittagong,4,1,2,1,7,7,0,5,bangladesh
Fortis,4,1,1,2,4,4,0,4,bangladesh
Sheikh Jamal,4,1,0,3,4,10,-6,3,bangladesh
Rahmatgonj,4,0,2,2,3,7,-4,2,bangladesh
A. Uttara,4,0,1,3,2,11,-9,1,bangladesh
Muktijoddha S.,4,0,0,4,5,13,-8,0,bangladesh
Dinamo Minsk,4,4,0,0,15,1,14,12,belarus
Neman Grodno,4,3,0,1,12,4,8,9,belarus
BATE Borisov,4,3,0,1,11,5,6,9,belarus
Isloch,4,3,0,1,8,5,3,9,belarus
FC Minsk,4,2,1,1,4,3,1,7,belarus
T. Zhodino,4,2,1,1,3,2,1,7,belarus
Smorgon,4,2,1,1,7,10,-3,7,belarus
Energetik-BGU,4,2,0,2,7,6,1,6,belarus
Slutsk,4,2,0,2,9,10,-1,6,belarus
Dinamo Brest,4,2,0,2,6,8,-2,6,belarus
Slavia Mozyr,4,1,1,2,2,5,-3,4,belarus
Naftan,4,1,1,2,5,16,-11,4,belarus
S. Soligorsk,4,1,0,3,6,6,0,3,belarus
Gomel,4,0,2,2,4,7,-3,2,belarus
Belshina,4,0,0,4,3,10,-7,0,belarus
Maxline,4,4,0,0,12,3,9,12,belarus2
Vitebsk,4,4,0,0,11,2,9,12,belarus2
Dnepr Mogilev,4,3,1,0,5,0,5,10,belarus2
Arsenal D.,4,3,0,1,16,7,9,9,belarus2
Zhodino Yuzhnoe,4,3,0,1,14,6,8,9,belarus2
Lida,4,3,0,1,10,4,6,9,belarus2
Niva,4,3,0,1,10,6,4,9,belarus2
Bumprom,4,2,1,1,9,6,3,7,belarus2
Lokomotiv Gomel,4,2,1,1,4,6,-2,7,belarus2
Volna Pinsk,4,2,0,2,4,8,-4,6,belarus2
Baranovichi,4,1,1,2,6,7,-1,4,belarus2
S.Petrikov,4,1,0,3,5,10,-5,3,belarus2
FC Ostrovets,4,0,1,3,3,10,-7,1,belarus2
Slonim,4,0,1,3,3,11,-8,1,belarus2
Orsha,4,0,0,4,5,12,-7,0,belarus2
Osipovichy,4,0,0,4,1,11,-10,0,belarus2
Molodechno-DYuS,4,0,0,4,3,14,-11,0,belarus2
Antwerp,4,3,1,0,11,2,9,10,belgium
Royale Union SG,4,3,1,0,9,3,6,10,belgium
Anderlecht,4,2,2,0,8,5,3,8,belgium
Club Brugge,4,2,2,0,3,0,3,8,belgium
KRC Genk,4,2,1,1,8,5,3,7,belgium
KV Mechelen,4,2,1,1,4,2,2,7,belgium
Gent,4,1,3,0,8,4,4,6,belgium
Sint-Truiden,4,1,3,0,7,5,2,6,belgium
Cercle Brugge,4,1,1,2,4,5,-1,4,belgium
Westerlo,4,1,1,2,8,10,-2,4,belgium
Charleroi,4,1,1,2,4,6,-2,4,belgium
RWDM,4,1,1,2,4,7,-3,4,belgium
Standard Liege,4,1,1,2,3,10,-7,4,belgium
OH Leuven,4,0,1,3,2,6,-4,1,belgium
Eupen,4,0,1,3,3,9,-6,1,belgium
Kortrijk,4,0,1,3,2,9,-7,1,belgium
Bolivar,4,3,0,1,17,6,11,9,bolivia
Aurora,4,3,0,1,7,2,5,9,bolivia
Real Tomayapo,4,3,0,1,8,5,3,9,bolivia
Always Ready,4,2,1,1,9,4,5,7,bolivia
Nacional Potosi,4,2,0,2,13,8,5,6,bolivia
Guabira,4,2,0,2,8,3,5,6,bolivia
Blooming,4,2,0,2,6,5,1,6,bolivia
The Strongest,4,1,3,0,5,4,1,6,bolivia
Oriente P.,4,2,0,2,6,7,-1,6,bolivia
I. Petrolero,4,2,0,2,3,4,-1,6,bolivia
Libertad,4,2,0,2,4,10,-6,6,bolivia
U. de Vinto,4,1,2,1,2,2,0,5,bolivia
Wilstermann,4,1,2,1,2,4,-2,5,bolivia
Santa Cruz,4,1,1,2,3,8,-5,4,bolivia
Royal Pari,4,0,2,2,2,10,-8,2,bolivia
Vaca Diez,4,0,1,3,2,9,-7,1,bolivia
A. Palmaflor,4,0,1,3,2,13,-11,1,bolivia
Guabira,4,3,0,1,7,5,2,9,bolivia2
Santa Cruz,4,3,0,1,7,7,0,9,bolivia2
I. Petrolero,4,2,2,0,8,5,3,8,bolivia2
The Strongest,4,2,1,1,13,9,4,7,bolivia2
Royal Pari,4,2,1,1,6,4,2,7,bolivia2
U. de Vinto,4,2,1,1,5,3,2,7,bolivia2
Nacional Potosi,4,2,0,2,11,8,3,6,bolivia2
Always Ready,4,2,0,2,5,5,0,6,bolivia2
Bolivar,4,1,2,1,9,8,1,5,bolivia2
Oriente P.,4,1,2,1,8,8,0,5,bolivia2
Real Tomayapo,4,1,2,1,3,3,0,5,bolivia2
Blooming,4,1,2,1,2,2,0,5,bolivia2
Wilstermann,4,1,0,3,3,6,-3,3,bolivia2
Aurora,4,0,2,2,3,6,-3,2,bolivia2
A. Palmaflor,4,0,2,2,4,10,-6,2,bolivia2
U. Sucre,4,0,1,3,5,10,-5,1,bolivia2
Internacional,4,4,0,0,8,2,6,12,brazil
Fortaleza,4,3,1,0,7,4,3,10,brazil
Atletico MG,4,3,0,1,9,5,4,9,brazil
Gremio,4,3,0,1,6,6,0,9,brazil
Palmeiras,4,2,2,0,8,3,5,8,brazil
Sao Paulo,4,2,1,1,3,2,1,7,brazil
Bahia,4,2,0,2,11,6,5,6,brazil
Fluminense,4,2,0,2,7,5,2,6,brazil
Cruzeiro,4,1,3,0,3,2,1,6,brazil
Flamengo,4,2,0,2,5,5,0,6,brazil
Corinthians,4,2,0,2,8,9,-1,6,brazil
Athletico PR,4,1,2,1,4,4,0,5,brazil
Cuiaba,4,1,1,2,4,4,0,4,brazil
Vasco da Gama,4,1,1,2,4,6,-2,4,brazil
Botafogo,4,0,3,1,3,5,-2,3,brazil
Bragantino,4,1,0,3,3,5,-2,3,brazil
Goias,4,1,0,3,2,4,-2,3,brazil
America MG,4,1,0,3,3,10,-7,3,brazil
Coritiba,4,0,1,3,2,6,-4,1,brazil
Santos,4,0,1,3,2,9,-7,1,brazil
Cherno More,4,3,1,0,9,4,5,10,bulgaria
Botev Plovdiv,4,3,1,0,7,2,5,10,bulgaria
Ludogorets,4,3,0,1,12,3,9,9,bulgaria
Levski Sofia,4,2,2,0,7,3,4,8,bulgaria
CSKA Sofia,4,2,1,1,7,3,4,7,bulgaria
Slavia Sofia,4,2,1,1,5,6,-1,7,bulgaria
CSKA 1948 Sofia,4,2,0,2,7,6,1,6,bulgaria
L. Krumovgrad,4,2,0,2,7,7,0,6,bulgaria
Arda,4,2,0,2,2,5,-3,6,bulgaria
Pirin Blag.,4,1,2,1,4,5,-1,5,bulgaria
Beroe,4,1,1,2,2,3,-1,4,bulgaria
Lok. Plovdiv,4,1,1,2,2,6,-4,4,bulgaria
Botev Vratsa,4,1,0,3,2,7,-5,3,bulgaria
Lokomotiv Sofia,4,0,2,2,4,6,-2,2,bulgaria
Hebar,4,0,1,3,3,7,-4,1,bulgaria
Etar,4,0,0,4,1,9,-8,0,bulgaria
Vancouver FC,4,3,0,1,6,4,2,9,canada
Cavalry,4,2,0,2,7,5,2,6,canada
Forge,4,2,0,2,5,5,0,6,canada
HFX Wanderers,4,2,0,2,4,4,0,6,canada
York Utd,4,2,0,2,4,6,-2,6,canada
A. Ottawa,4,1,0,3,3,5,-2,3,canada
Valour,4,1,0,3,2,4,-2,3,canada
Pacific,4,1,0,3,3,7,-4,3,canada
Coquimbo Unido,4,3,0,1,7,5,2,9,chile
Colo-Colo,4,3,0,1,4,2,2,9,chile
Huachipato,4,2,2,0,5,2,3,8,chile
Palestino,4,2,1,1,6,3,3,7,chile
Magallanes,4,2,1,1,9,7,2,7,chile
Union Espanola,4,2,1,1,6,7,-1,7,chile
U. de Chile,4,2,0,2,10,8,2,6,chile
Union La Calera,4,2,0,2,6,6,0,6,chile
U. Catolica,4,1,2,1,7,6,1,5,chile
Copiapo,4,1,2,1,5,4,1,5,chile
O`Higgins,4,1,2,1,5,4,1,5,chile
Cobresal,4,1,1,2,7,8,-1,4,chile
Everton,4,1,1,2,3,5,-2,4,chile
Audax Italiano,4,1,0,3,4,8,-4,3,chile
Nublense,4,0,2,2,3,6,-3,2,chile
Curico Unido,4,0,1,3,4,10,-6,1,chile
S. Morning,4,3,0,1,6,2,4,9,chile2
Cobreloa,4,3,0,1,5,3,2,9,chile2
San Marcos,4,2,2,0,11,9,2,8,chile2
Barnechea,4,2,1,1,8,5,3,7,chile2
D. Iquique,4,2,1,1,6,5,1,7,chile2
Deportes Temuco,4,2,1,1,5,4,1,7,chile2
Rangers,4,2,1,1,5,4,1,7,chile2
S. Wanderers,4,2,1,1,4,3,1,7,chile2
Recoleta,4,2,0,2,5,5,0,6,chile2
U. Concepcion,4,1,2,1,5,6,-1,5,chile2
Puerto Montt,4,1,2,1,3,5,-2,5,chile2
San Luis,4,1,1,2,8,5,3,4,chile2
La Serena,4,1,1,2,1,6,-5,4,chile2
CD Santa Cruz,4,0,1,3,5,8,-3,1,chile2
U. San Felipe,4,0,1,3,1,4,-3,1,chile2
Antofagasta,4,0,1,3,4,9,-5,1,chile2
Zhejiang,4,3,1,0,12,3,9,10,china
Chengdu,4,3,1,0,12,4,8,10,china
S. Taishan,4,3,1,0,11,3,8,10,china
Beijing Guoan,4,3,0,1,9,4,5,9,china
Wuhan Three T.,4,3,0,1,9,6,3,9,china
Tianjin T.,4,2,2,0,9,5,4,8,china
Shanghai Port,4,2,1,1,6,5,1,7,china
S. Shenhua,4,2,1,1,4,3,1,7,china
Henan SL,4,1,1,2,8,9,-1,4,china
Changchun Yatai,4,1,1,2,5,8,-3,4,china
Meizhou Hakka,4,1,1,2,2,8,-6,4,china
Nantong Zhiyun,4,1,0,3,5,4,1,3,china
Qingdao Jonoon,4,0,2,2,3,7,-4,2,china
Dalian P.,4,0,1,3,5,10,-5,1,china
Cangzhou,4,0,1,3,1,13,-12,1,china
Shenzhen,4,0,0,4,0,9,-9,0,china
Sichuan Jiuniu,4,4,0,0,8,0,8,12,china2
Guangxi Baoyun,4,3,1,0,7,2,5,10,china2
Hebei Kungfu,4,3,1,0,7,2,5,10,china2
Qingdao Y. I.,4,3,1,0,6,1,5,10,china2
Wuxi Wugou,4,3,0,1,7,6,1,9,china2
Shenyang Urban,4,2,0,2,6,4,2,6,china2
Jiangxi L.,4,2,0,2,6,5,1,6,china2
Yanbian Longdin,4,2,0,2,4,3,1,6,china2
Dongguan United,4,2,0,2,3,3,0,6,china2
Shanghai Jiadin,4,2,0,2,3,5,-2,6,china2
Jinan Xingzhou,4,1,1,2,3,5,-2,4,china2
Dantong Hantong,4,1,1,2,3,6,-3,4,china2
Heilongjiang L.,4,1,0,3,2,5,-3,3,china2
Nanjing,4,0,1,3,0,5,-5,1,china2
Guangzhou FC,4,0,0,4,0,5,-5,0,china2
Suzhou Dongwu,4,0,0,4,1,9,-8,0,china2
Deportes Tolima,4,4,0,0,7,3,4,12,colombia2
R. Aguilas,4,3,1,0,8,2,6,10,colombia2
I. Medelin,4,3,1,0,7,1,6,10,colombia2
Junior,4,3,0,1,5,1,4,9,colombia2
A. Bucaramanga,4,3,0,1,7,5,2,9,colombia2
La Equidad,4,2,1,1,6,5,1,7,colombia2
America de Cali,4,2,1,1,4,3,1,7,colombia2
A. Nacional,4,2,0,2,8,6,2,6,colombia2
Envigado,4,1,2,1,8,7,1,5,colombia2
Deportivo Pasto,4,1,2,1,4,3,1,5,colombia2
Once Caldas,4,1,2,1,2,2,0,5,colombia2
Deportivo Cali,4,1,2,1,3,4,-1,5,colombia2
Millonarios,4,1,1,2,5,6,-1,4,colombia2
Jaguares de C.,4,1,1,2,1,3,-2,4,colombia2
D. Pereira,4,1,0,3,2,5,-3,3,colombia2
A. Petrolera,4,1,0,3,2,7,-5,3,colombia2
Atletico Huila,4,0,2,2,5,8,-3,2,colombia2
Boyaca Chico,4,0,2,2,3,6,-3,2,colombia2
Santa Fe,4,0,1,3,4,7,-3,1,colombia2
Union Magdalena,4,0,1,3,3,9,-6,1,colombia2
Saprissa,4,4,0,0,10,3,7,12,costarica
San Carlos,4,4,0,0,6,1,5,12,costarica
Herediano,4,3,0,1,8,2,6,9,costarica
Alajuelense,4,2,1,1,8,6,2,7,costarica
Guanacasteca,4,2,1,1,8,6,2,7,costarica
Puntarenas,4,1,1,2,6,4,2,4,costarica
AD Grecia,4,1,1,2,3,5,-2,4,costarica
Zeledon,4,1,1,2,1,5,-4,4,costarica
Sporting SJ,4,1,1,2,2,8,-6,4,costarica
Cartagines,4,0,2,2,2,4,-2,2,costarica
M. Liberia,4,0,1,3,3,7,-4,1,costarica
Santos DG,4,0,0,4,1,8,-7,0,costarica
Sparta Prague,4,4,0,0,8,1,7,12,czechrepublic
Slovacko,4,3,1,0,12,4,8,10,czechrepublic
Slovan Liberec,4,3,1,0,9,5,4,10,czechrepublic
Slavia Prague,4,3,0,1,8,4,4,9,czechrepublic
Viktoria Plzen,4,2,1,1,10,6,4,7,czechrepublic
Teplice,4,2,1,1,5,4,1,7,czechrepublic
Jablonec,4,2,1,1,6,7,-1,7,czechrepublic
Banik Ostrava,4,2,0,2,6,6,0,6,czechrepublic
Sigma Olomouc,4,1,2,1,5,5,0,5,czechrepublic
Zlin,4,1,1,2,5,8,-3,4,czechrepublic
Bohemians,4,1,1,2,4,8,-4,4,czechrepublic
Hradec Kralove,4,0,3,1,4,5,-1,3,czechrepublic
Mlada Boleslav,4,1,0,3,3,7,-4,3,czechrepublic
Karvina,4,1,0,3,2,6,-4,3,czechrepublic
Pardubice,4,0,0,4,2,6,-4,0,czechrepublic
C. Budejovice,4,0,0,4,1,9,-8,0,czechrepublic
FC Midtjylland,4,4,0,0,15,3,12,12,denmark
AGF Aarhus,4,2,2,0,5,2,3,8,denmark
Brondby IF,4,1,3,0,8,4,4,6,denmark
Viborg,4,2,0,2,5,9,-4,6,denmark
Lyngby,4,1,2,1,7,6,1,5,denmark
Vejle BK,4,1,2,1,2,2,0,5,denmark
Odense BK,4,1,2,1,4,5,-1,5,denmark
Nordsjaelland,4,1,2,1,2,3,-1,5,denmark
FC Kobenhavn,4,1,1,2,6,6,0,4,denmark
Hvidovre,4,1,1,2,4,9,-5,4,denmark
Randers FC,4,0,2,2,3,6,-3,2,denmark
Silkeborg,4,0,1,3,3,9,-6,1,denmark
Vendsyssel,4,3,1,0,4,0,4,10,denmark2
B 93,4,3,0,1,7,1,6,9,denmark2
SonderjyskE,4,3,0,1,9,4,5,9,denmark2
AC Horsens,4,2,1,1,7,4,3,7,denmark2
Hillerod,4,2,1,1,4,3,1,7,denmark2
Hobro,4,2,1,1,3,2,1,7,denmark2
Aalborg BK,4,1,2,1,6,6,0,5,denmark2
Fredericia,4,1,2,1,2,5,-3,5,denmark2
Kolding IF,4,1,0,3,3,4,-1,3,denmark2
Helsingor,4,0,2,2,5,8,-3,2,denmark2
Naestved,4,0,2,2,4,8,-4,2,denmark2
HB Koge,4,0,0,4,3,12,-9,0,denmark2
Cuniburo,4,3,1,0,10,5,5,10,ecuador3
America de Q.,4,3,1,0,7,3,4,10,ecuador3
Chacaritas,4,3,0,1,8,4,4,9,ecuador3
Nueve Octubre,4,2,1,1,5,3,2,7,ecuador3
Imbabura,4,1,3,0,7,3,4,6,ecuador3
Vargas Torres,4,1,2,1,3,3,0,5,ecuador3
Manta,4,1,1,2,5,5,0,4,ecuador3
I. Juniors,4,1,1,2,6,8,-2,4,ecuador3
Macara,4,0,0,4,3,11,-8,0,ecuador3
Guayaquil,4,0,0,4,2,11,-9,0,ecuador3
El Geish,4,3,1,0,7,3,4,10,egypt
Ceramica C.,4,3,0,1,8,4,4,9,egypt
Pyramids FC,4,3,0,1,6,5,1,9,egypt
El Gouna,4,2,2,0,5,2,3,8,egypt
Al Ittihad,4,2,2,0,6,4,2,8,egypt
Al Ahly,4,2,2,0,5,3,2,8,egypt
Zamalek,4,2,0,2,9,5,4,6,egypt
ZED FC,4,1,3,0,6,5,1,6,egypt
ENPPI,4,2,0,2,6,7,-1,6,egypt
Al Masry,4,2,0,2,5,8,-3,6,egypt
Smouha,4,1,2,1,3,3,0,5,egypt
Baladiyyat,4,1,2,1,5,6,-1,5,egypt
Ismaily,4,1,1,2,5,6,-1,4,egypt
National Bank,4,1,0,3,6,5,1,3,egypt
El Daklyeh,4,0,3,1,0,2,-2,3,egypt
Future FC,4,1,0,3,2,5,-3,3,egypt
Al Mokawloon,4,0,2,2,4,6,-2,2,egypt
Pharco,4,0,1,3,4,7,-3,1,egypt
Bournemouth,4,3,1,0,10,3,7,10,england
Liverpool,4,3,1,0,9,5,4,10,england
Aston Villa,4,3,1,0,6,3,3,10,england
Fulham,4,3,0,1,16,6,10,9,england
Everton,4,3,0,1,6,3,3,9,england
Arsenal,4,3,0,1,7,5,2,9,england
Brighton,4,2,1,1,8,7,1,7,england
West Ham Utd,4,2,1,1,5,8,-3,7,england
Manchester Utd,4,2,0,2,5,5,0,6,england
Newcastle Utd,4,2,0,2,6,8,-2,6,england
Manchester City,4,1,2,1,6,6,0,5,england
Burnley,4,1,1,2,7,4,3,4,england
Tottenham,4,1,1,2,9,8,1,4,england
Wolverhampton,4,1,1,2,5,6,-1,4,england
Brentford,4,1,0,3,4,5,-1,3,england
Luton Town,4,1,0,3,7,10,-3,3,england
Chelsea,4,1,0,3,5,10,-5,3,england
Sheffield Utd,4,1,0,3,2,10,-8,3,england
Crystal Palace,4,0,1,3,3,7,-4,1,england
Nottm Forest,4,0,1,3,3,10,-7,1,england
Leicester City,4,3,1,0,9,2,7,10,england2
Leeds Utd,4,3,1,0,9,4,5,10,england2
QP Rangers,4,3,0,1,8,3,5,9,england2
Coventry City,4,3,0,1,7,2,5,9,england2
Ipswich Town,4,3,0,1,7,4,3,9,england2
Southampton,4,2,2,0,5,2,3,8,england2
Sheffield Wed,4,2,1,1,6,4,2,7,england2
Norwich City,4,2,1,1,5,4,1,7,england2
Watford,4,2,1,1,6,6,0,7,england2
Blackburn,4,2,0,2,8,7,1,6,england2
Huddersfield,4,1,3,0,5,4,1,6,england2
West Brom,4,2,0,2,5,4,1,6,england2
Cardiff City,4,2,0,2,3,4,-1,6,england2
Plymouth,4,2,0,2,4,6,-2,6,england2
Swansea City,4,1,2,1,6,7,-1,5,england2
Hull City,4,1,1,2,7,7,0,4,england2
Bristol City,4,1,1,2,5,6,-1,4,england2
Sunderland,4,1,1,2,4,6,-2,4,england2
Birmingham City,4,1,1,2,4,7,-3,4,england2
Middlesbrough,4,1,0,3,8,8,0,3,england2
Rotherham,4,0,2,2,3,7,-4,2,england2
Millwall,4,0,1,3,2,8,-6,1,england2
Preston,4,0,1,3,1,8,-7,1,england2
Stoke City,4,0,0,4,3,10,-7,0,england2
Derby County,4,4,0,0,9,1,8,12,england3
Peterborough,4,3,1,0,14,2,12,10,england3
Bolton,4,3,1,0,10,0,10,10,england3
Stevenage,4,3,1,0,8,3,5,10,england3
Blackpool,4,3,0,1,12,2,10,9,england3
Northampton,4,3,0,1,7,5,2,9,england3
Lincoln City,4,2,2,0,6,2,4,8,england3
Portsmouth,4,2,1,1,7,6,1,7,england3
Barnsley,4,2,1,1,6,6,0,7,england3
Shrewsbury,4,2,1,1,3,5,-2,7,england3
Wigan Athletic,4,1,3,0,5,2,3,6,england3
Reading,4,2,0,2,10,8,2,6,england3
Charlton,4,1,3,0,7,6,1,6,england3
Cheltenham,4,1,2,1,5,4,1,5,england3
Bristol Rovers,4,1,2,1,4,4,0,5,england3
Port Vale,4,1,1,2,3,4,-1,4,england3
Oxford Utd,4,1,1,2,3,7,-4,4,england3
Fleetwood,4,1,0,3,3,9,-6,3,england3
Leyton Orient,4,0,2,2,2,6,-4,2,england3
Carlisle Utd,4,0,1,3,2,10,-8,1,england3
Cambridge Utd,4,0,1,3,3,12,-9,1,england3
Exeter City,4,0,1,3,0,11,-11,1,england3
Wycombe,4,0,0,4,1,5,-4,0,england3
Burton Albion,4,0,0,4,1,10,-9,0,england3
Barrow,4,4,0,0,9,2,7,12,england4
AFC Wimbledon,4,3,0,1,10,3,7,9,england4
Milton Keynes,4,2,2,0,8,5,3,8,england4
Tranmere,4,2,2,0,8,5,3,8,england4
Wrexham,4,2,1,1,10,4,6,7,england4
Mansfield,4,2,1,1,7,5,2,7,england4
Crewe Alexandra,4,2,1,1,6,5,1,7,england4
Swindon Town,4,2,1,1,7,9,-2,7,england4
Notts County,4,2,0,2,10,9,1,6,england4
Bradford,4,2,0,2,7,6,1,6,england4
Grimsby,4,1,3,0,6,5,1,6,england4
Crawley Town,4,2,0,2,5,6,-1,6,england4
Gillingham,4,2,0,2,5,6,-1,6,england4
Newport,4,2,0,2,5,6,-1,6,england4
Stockport,4,1,2,1,4,3,1,5,england4
Harrogate,4,1,2,1,5,5,0,5,england4
Accrington,4,1,1,2,5,5,0,4,england4
Sutton Utd,4,0,4,0,4,4,0,4,england4
Doncaster,4,1,1,2,5,6,-1,4,england4
Walsall,4,1,1,2,2,4,-2,4,england4
Forest Green,4,0,2,2,2,8,-6,2,england4
Salford City,4,0,1,3,4,9,-5,1,england4
Morecambe,4,0,1,3,4,12,-8,1,england4
Colchester Utd,4,0,0,4,3,11,-8,0,england4
Gateshead FC,4,3,1,0,11,2,9,10,england5
Chesterfield,4,3,0,1,10,6,4,9,england5
Bromley,4,3,0,1,8,4,4,9,england5
Rochdale,4,3,0,1,7,3,4,9,england5
Aldershot Town,4,3,0,1,6,4,2,9,england5
Maidenhead Utd,4,2,2,0,8,4,4,8,england5
York City,4,2,1,1,6,4,2,7,england5
Eastleigh,4,2,1,1,7,6,1,7,england5
Oldham,4,2,1,1,7,6,1,7,england5
Altrincham,4,2,0,2,9,6,3,6,england5
Dagenham & R.,4,2,0,2,6,5,1,6,england5
Wealdstone,4,2,0,2,6,6,0,6,england5
Kidderminster,4,1,2,1,5,4,1,5,england5
Hartlepool,4,1,2,1,7,8,-1,5,england5
Southend Utd,4,1,2,1,4,5,-1,5,england5
Boreham Wood,4,1,1,2,7,7,0,4,england5
Oxford City,4,1,1,2,7,8,-1,4,england5
Halifax Town,4,1,1,2,3,4,-1,4,england5
Ebbsfleet Utd,4,1,1,2,5,8,-3,4,england5
Dorking,4,1,1,2,6,13,-7,4,england5
Solihull Moors,4,1,0,3,5,11,-6,3,england5
AFC Fylde,4,0,2,2,5,8,-3,2,england5
Woking,4,0,0,4,4,10,-6,0,england5
Barnet,4,0,0,4,5,13,-8,0,england5
Tallinna Kalev,4,3,1,0,15,3,12,10,estonia
Kuressaare,4,3,1,0,4,1,3,10,estonia
Flora,4,2,1,1,6,4,2,7,estonia
Nomme Kalju,4,1,3,0,8,7,1,6,estonia
Paide,4,1,2,1,9,8,1,5,estonia
Vaprus,4,1,2,1,2,1,1,5,estonia
Levadia,4,1,2,1,7,7,0,5,estonia
Tammeka,4,1,0,3,4,11,-7,3,estonia
Harju Jalgpalli,4,0,2,2,2,5,-3,2,estonia
Narva Trans,4,0,0,4,2,12,-10,0,estonia
Nomme Utd,4,3,1,0,15,4,11,10,estonia2
Tabasalu,4,3,0,1,9,6,3,9,estonia2
Paide B,4,3,0,1,9,7,2,9,estonia2
FC Tallinn,4,2,1,1,9,7,2,7,estonia2
Viimsi,4,2,0,2,7,8,-1,6,estonia2
Elva,4,2,0,2,7,10,-3,6,estonia2
Alliance,4,1,1,2,7,12,-5,4,estonia2
Flora B,4,1,0,3,11,8,3,3,estonia2
Legion,4,1,0,3,7,13,-6,3,estonia2
Levadia B,4,0,1,3,3,9,-6,1,estonia2
Vikingur,4,4,0,0,19,1,18,12,faroeislands
HB Torshavn,4,3,1,0,10,4,6,10,faroeislands
07 Vestur,4,2,0,2,4,6,-2,6,faroeislands
Klaksvik,4,1,2,1,7,3,4,5,faroeislands
AB Argir,4,1,2,1,7,7,0,5,faroeislands
IF Fuglafjordur,4,1,2,1,1,5,-4,5,faroeislands
B36 Torshavn,4,1,1,2,5,10,-5,4,faroeislands
Streymur,4,1,1,2,1,9,-8,4,faroeislands
B68 Toftir,4,0,3,1,5,8,-3,3,faroeislands
TB Tvoroyri,4,0,0,4,1,7,-6,0,faroeislands
Klaksvik B,4,4,0,0,22,1,21,12,faroeislands2
Skala,4,4,0,0,16,1,15,12,faroeislands2
B71 Sandur,4,3,1,0,11,3,8,10,faroeislands2
Hoyvik,4,3,0,1,5,2,3,9,faroeislands2
Vikingur B,4,2,0,2,9,7,2,6,faroeislands2
B36 Torshavn B,4,1,0,3,9,11,-2,3,faroeislands2
NSI Runavik,4,1,0,3,4,10,-6,3,faroeislands2
Streymur B,4,1,0,3,2,18,-16,3,faroeislands2
HB B,4,0,1,3,2,17,-15,1,faroeislands2
B68 Toftir B,4,0,0,4,3,15,-12,0,faroeislands2
Ilves,4,4,0,0,13,4,9,12,finland
VPS,4,3,1,0,9,3,6,10,finland
KuPS,4,3,1,0,7,3,4,10,finland
Haka,4,2,1,1,6,3,3,7,finland
Mariehamn,4,2,1,1,5,3,2,7,finland
HJK Helsinki,4,2,0,2,9,7,2,6,finland
Oulu,4,1,1,2,6,6,0,4,finland
SJK,4,1,1,2,5,7,-2,4,finland
Lahti,4,1,1,2,3,8,-5,4,finland
Honka,4,1,0,3,4,9,-5,3,finland
Inter Turku,4,0,1,3,2,7,-5,1,finland
KTP,4,0,0,4,0,9,-9,0,finland
Ekenas IF,4,3,1,0,9,4,5,10,finland2
JaPS,4,2,1,1,7,3,4,7,finland2
HIFK,4,2,1,1,10,8,2,7,finland2
Jaro,4,2,1,1,8,6,2,7,finland2
KaPa,4,2,1,1,6,4,2,7,finland2
Gnistan,4,1,3,0,9,8,1,6,finland2
KPV Kokkola,4,2,0,2,6,8,-2,6,finland2
SJK Akatemia,4,1,1,2,7,8,-1,4,finland2
SalPa,4,1,1,2,5,6,-1,4,finland2
Mikkelin,4,1,1,2,5,7,-2,4,finland2
JJK,4,1,0,3,3,8,-5,3,finland2
TPS,4,0,1,3,5,10,-5,1,finland2
Paris SG,4,4,0,0,12,3,9,12,france
Marseille,4,3,1,0,10,3,7,10,france
Brest,4,3,1,0,8,2,6,10,france
Lens,4,3,1,0,7,2,5,10,france
Lille,4,2,2,0,5,1,4,8,france
Nice,4,2,1,1,3,2,1,7,france
Monaco,4,2,1,1,6,6,0,7,france
Metz,4,2,0,2,6,6,0,6,france
Strasbourg,4,1,2,1,5,5,0,5,france
Nantes,4,1,1,2,3,5,-2,4,france
Rennes,4,1,0,3,4,6,-2,3,france
Lyon,4,1,0,3,5,8,-3,3,france
Reims,4,1,0,3,4,9,-5,3,france
Le Havre,4,0,2,2,1,4,-3,2,france
Montpellier,4,0,2,2,2,6,-4,2,france
Toulouse,4,0,2,2,2,6,-4,2,france
Clermont,4,0,2,2,1,7,-6,2,france
Lorient,4,0,1,3,5,9,-4,1,france
Auxerre,4,3,1,0,10,5,5,10,france2
Pau FC,4,3,1,0,8,4,4,10,france2
Paris FC,4,3,0,1,5,2,3,9,france2
Angers,4,2,2,0,9,5,4,8,france2
Guingamp,4,2,1,1,4,2,2,7,france2
Grenoble,4,2,1,1,5,4,1,7,france2
AC Ajaccio,4,2,1,1,4,3,1,7,france2
Caen,4,2,1,1,6,7,-1,7,france2
Bordeaux,4,2,0,2,7,6,1,6,france2
Troyes,4,2,0,2,3,2,1,6,france2
Quevilly Rouen,4,1,2,1,8,8,0,5,france2
SC Bastia,4,1,1,2,5,2,3,4,france2
Annecy,4,1,1,2,4,5,-1,4,france2
Rodez Aveyron,4,1,1,2,3,4,-1,4,france2
Amiens,4,1,1,2,3,5,-2,4,france2
Laval,4,1,1,2,3,6,-3,4,france2
USL Dunkerque,4,1,1,2,2,8,-6,4,france2
Valenciennes,4,0,2,2,1,4,-3,2,france2
Concarneau,4,0,1,3,3,7,-4,1,france2
Saint-Etienne,4,0,0,4,4,11,-7,0,france2
Martigues,4,4,0,0,5,0,5,12,france3
Dijon,4,3,1,0,7,3,4,10,france3
Epinal,4,3,0,1,12,6,6,9,france3
Versailles,4,2,1,1,12,4,8,7,france3
Rouen,4,2,1,1,9,3,6,7,france3
Sochaux,4,2,1,1,9,5,4,7,france3
Villefranche,4,2,1,1,5,2,3,7,france3
Niort,4,2,1,1,8,6,2,7,france3
Nancy,4,2,1,1,5,3,2,7,france3
Red Star,4,2,1,1,6,5,1,7,france3
Avranches,4,2,0,2,4,8,-4,6,france3
G. O. A. L.,4,1,1,2,5,6,-1,4,france3
Orleans,4,1,1,2,6,8,-2,4,france3
Cholet,4,1,0,3,2,9,-7,3,france3
Marignane G.,4,0,2,2,3,8,-5,2,france3
Le Mans,4,0,1,3,3,8,-5,1,france3
Chateauroux,4,0,1,3,3,10,-7,1,france3
Nimes,4,0,0,4,3,14,-11,0,france3
Dinamo Tbilisi,4,3,1,0,15,6,9,10,georgia
Samgurali,4,3,1,0,9,6,3,10,georgia
Gagra,4,3,0,1,15,5,10,9,georgia
Dila Gori,4,3,0,1,6,3,3,9,georgia
Torpedo Kutaisi,4,2,2,0,15,5,10,8,georgia
Dinamo Batumi,4,1,1,2,9,11,-2,4,georgia
Samtredia,4,1,0,3,15,9,6,3,georgia
Telavi,4,1,0,3,5,8,-3,3,georgia
Saburtalo,4,0,1,3,3,10,-7,1,georgia
Shukura,4,0,0,4,2,31,-29,0,georgia
Bolnisi,4,3,0,1,14,5,9,9,georgia2
Spaeri,4,3,0,1,8,3,5,9,georgia2
D. Tbilisi B,4,2,1,1,12,4,8,7,georgia2
Kolkheti Poti,4,2,1,1,5,2,3,7,georgia2
WIT Georgia,4,2,1,1,5,4,1,7,georgia2
L. Tbilisi,4,2,0,2,9,5,4,6,georgia2
Gareji Sagarejo,4,1,2,1,4,5,-1,5,georgia2
Merani Martvili,4,1,1,2,7,15,-8,4,georgia2
Kolkheti Khobi,4,0,2,2,3,10,-7,2,georgia2
Merani Tbilisi,4,0,0,4,3,17,-14,0,georgia2
Stuttgart,4,3,1,0,7,3,4,10,germany
Bayern Munich,4,3,0,1,10,7,3,9,germany
RB Leipzig,4,3,0,1,9,6,3,9,germany
Leverkusen,4,2,2,0,9,2,7,8,germany
Freiburg,4,2,1,1,4,4,0,7,germany
Monchengladbach,4,2,0,2,9,8,1,6,germany
Hoffenheim,4,1,2,1,6,5,1,5,germany
Bochum,4,1,2,1,5,5,0,5,germany
FC Koln,4,1,2,1,2,2,0,5,germany
FC Augsburg,4,1,2,1,4,5,-1,5,germany
E. Frankfurt,4,1,1,2,9,7,2,4,germany
Dortmund,4,1,1,2,8,8,0,4,germany
Heidenheim,4,1,1,2,6,8,-2,4,germany
Werder Bremen,4,1,1,2,4,7,-3,4,germany
Union Berlin,4,1,1,2,4,9,-5,4,germany
FSV Mainz,4,0,3,1,1,2,-1,3,germany
Wolfsburg,4,1,0,3,3,9,-6,3,germany
Darmstadt,4,0,2,2,3,5,-2,2,germany
Holstein Kiel,4,4,0,0,11,4,7,12,germany2
Greuther Furth,4,3,1,0,5,1,4,10,germany2
Hertha Berlin,4,2,2,0,11,6,5,8,germany2
Magdeburg,4,2,1,1,8,4,4,7,germany2
Dusseldorf,4,2,0,2,10,5,5,6,germany2
Karlsruher SC,4,1,3,0,10,7,3,6,germany2
Schalke 04,4,2,0,2,10,7,3,6,germany2
Braunschweig,4,2,0,2,7,6,1,6,germany2
Sankt Pauli,4,1,3,0,6,5,1,6,germany2
Elversberg,4,2,0,2,7,8,-1,6,germany2
Paderborn,4,2,0,2,5,8,-3,6,germany2
FC Nurnberg,4,2,0,2,5,10,-5,6,germany2
Hamburger SV,4,1,1,2,7,9,-2,4,germany2
Hansa Rostock,4,1,1,2,6,8,-2,4,germany2
Hannover 96,4,0,3,1,4,5,-1,3,germany2
Wehen Wiesbaden,4,1,0,3,5,9,-4,3,germany2
Osnabruck,4,0,1,3,3,10,-7,1,germany2
Kaiserslautern,4,0,0,4,3,11,-8,0,germany2
FC Ingolstadt,4,3,1,0,9,3,6,10,germany3
Sandhausen,4,3,1,0,8,2,6,10,germany3
Regensburg,4,3,1,0,7,3,4,10,germany3
Verl,4,3,0,1,7,6,1,9,germany3
Saarbrucken,4,2,2,0,6,0,6,8,germany3
Ulm,4,2,1,1,6,5,1,7,germany3
Unterhaching,4,2,1,1,5,4,1,7,germany3
Preuss. Munster,4,1,3,0,8,6,2,6,germany3
Erzgebirge Aue,4,1,3,0,5,3,2,6,germany3
RW Essen,4,2,0,2,6,5,1,6,germany3
Dortmund B,4,1,2,1,5,4,1,5,germany3
MSV Duisburg,4,1,2,1,2,3,-1,5,germany3
Bielefeld,4,0,4,0,7,7,0,4,germany3
Hallescher,4,1,1,2,6,8,-2,4,germany3
Dynamo Dresden,4,1,0,3,2,4,-2,3,germany3
1860 Munchen,4,1,0,3,3,7,-4,3,germany3
VfB Lubeck,4,0,2,2,3,8,-5,2,germany3
Viktoria Koln,4,0,2,2,6,12,-6,2,germany3
Mannheim,4,0,1,3,2,8,-6,1,germany3
Freiburg B,4,0,0,4,4,11,-7,0,germany3
PAOK,4,4,0,0,14,3,11,12,greece
AEK Athens,4,3,1,0,6,1,5,10,greece
Panathinaikos,4,3,0,1,7,3,4,9,greece
Asteras T.,4,3,0,1,5,3,2,9,greece
Olympiakos,4,2,1,1,9,7,2,7,greece
Atromitos,4,1,3,0,8,6,2,6,greece
Aris,4,2,0,2,5,4,1,6,greece
Volos,4,1,2,1,4,5,-1,5,greece
Panaitolikos,4,1,0,3,5,6,-1,3,greece
PAS Giannina,4,0,3,1,3,4,-1,3,greece
OFI Crete,4,0,2,2,3,8,-5,2,greece
Kifisia,4,0,1,3,2,8,-6,1,greece
Lamia,4,0,1,3,4,11,-7,1,greece
Panserraikos,4,0,1,3,1,8,-7,1,greece
Antigua GFC,4,3,1,0,7,3,4,10,guatemala
Municipal,4,3,0,1,6,2,4,9,guatemala
Zacapa Tellioz,4,2,1,1,7,3,4,7,guatemala
Guastatoya,4,2,1,1,6,2,4,7,guatemala
Achuapa,4,2,1,1,6,4,2,7,guatemala
Comunicaciones,4,2,1,1,6,5,1,7,guatemala
Malacateco,4,2,0,2,8,10,-2,6,guatemala
Mixco,4,1,2,1,1,3,-2,5,guatemala
Xelaju,4,1,1,2,1,2,-1,4,guatemala
Xinabajul,4,0,2,2,1,4,-3,2,guatemala
Coban Imperial,4,0,1,3,2,6,-4,1,guatemala
Coatepecano IB,4,0,1,3,0,7,-7,1,guatemala
Olimpia,4,4,0,0,13,4,9,12,honduras
Marathon,4,3,0,1,7,6,1,9,honduras
Real Espana,4,2,1,1,6,6,0,7,honduras
Motagua,4,2,0,2,8,7,1,6,honduras
Victoria,4,1,1,2,7,7,0,4,honduras
Real Sociedad,4,1,1,2,5,6,-1,4,honduras
Vida,4,1,1,2,6,9,-3,4,honduras
Olancho,4,0,3,1,5,6,-1,3,honduras
Génesis,4,0,2,2,5,7,-2,2,honduras
UPNFM,4,0,1,3,4,12,-8,1,honduras
Kitchee,4,3,1,0,13,4,9,10,hongkong
LM Warriors,4,3,1,0,10,6,4,10,hongkong
Eastern,4,3,1,0,7,3,4,10,hongkong
HK Rangers,4,3,0,1,15,2,13,9,hongkong
Wofoo Tai Po,4,3,0,1,7,3,4,9,hongkong
North District,4,2,1,1,10,6,4,7,hongkong
Southern D.,4,1,1,2,6,5,1,4,hongkong
Hong Kong FC,4,1,1,2,5,7,-2,4,hongkong
Resources C.,4,1,0,3,3,15,-12,3,hongkong
HK U23,4,0,1,3,2,14,-12,1,hongkong
Sham Shui Po,4,0,0,4,3,11,-8,0,hongkong
MOL Fehervar,4,3,1,0,9,4,5,10,hungary
Paks,4,3,0,1,9,5,4,9,hungary
MTK,4,3,0,1,7,5,2,9,hungary
Puskas Akad.,4,2,1,1,7,5,2,7,hungary
Debrecen,4,2,1,1,4,3,1,7,hungary
Diosgyor VTK,4,2,0,2,5,8,-3,6,hungary
Ferencvaros,4,1,2,1,5,4,1,5,hungary
Kisvarda,4,1,1,2,5,5,0,4,hungary
Zalaegerszegi,4,1,1,2,5,5,0,4,hungary
Mezokovesd,4,1,1,2,4,4,0,4,hungary
Kecskemeti TE,4,1,1,2,6,9,-3,4,hungary
Ujpest,4,0,1,3,3,9,-6,1,hungary
Nyiregyhaza,4,4,0,0,17,3,14,12,hungary2
Szeged,4,3,1,0,5,0,5,10,hungary2
Gyori ETO,4,3,0,1,4,6,-2,9,hungary2
Vasas,4,2,2,0,13,4,9,8,hungary2
Kozarmisleny,4,2,1,1,10,6,4,7,hungary2
Pecsi MFC,4,2,1,1,2,1,1,7,hungary2
Honved,4,1,3,0,5,4,1,6,hungary2
Ajka,4,2,0,2,4,3,1,6,hungary2
Soroksar,4,1,2,1,4,4,0,5,hungary2
Gyirmot,4,1,2,1,5,6,-1,5,hungary2
MTE,4,1,1,2,5,5,0,4,hungary2
Budafoki,4,1,1,2,4,4,0,4,hungary2
Haladas,4,0,3,1,7,9,-2,3,hungary2
Kazincbarcika,4,1,0,3,3,8,-5,3,hungary2
Csakvari,4,0,3,1,5,11,-6,3,hungary2
Tiszakecske,4,0,2,2,1,3,-2,2,hungary2
BVSC,4,0,2,2,1,4,-3,2,hungary2
Siofok,4,0,1,3,2,13,-11,1,hungary2
Stjarnan,4,4,0,0,10,2,8,12,iceland
KA Akureyri,4,3,0,1,7,4,3,9,iceland
Fylkir,4,2,1,1,12,8,4,7,iceland
Valur,4,2,1,1,11,10,1,7,iceland
Fram,4,2,1,1,7,8,-1,7,iceland
Vikingur R.,4,2,0,2,9,8,1,6,iceland
IBV,4,1,2,1,5,5,0,5,iceland
KR Reykjavik,4,1,1,2,7,10,-3,4,iceland
Keflavik,4,1,1,2,5,8,-3,4,iceland
Breidablik,4,1,0,3,8,11,-3,3,iceland
Hafnarfjordur,4,1,0,3,6,10,-4,3,iceland
HK Kopavogur,4,0,1,3,3,6,-3,1,iceland
Vestri,4,4,0,0,12,3,9,12,iceland2
IA Akranes,4,4,0,0,12,5,7,12,iceland2
Leiknir R.,4,3,0,1,12,4,8,9,iceland2
Fjolnir,4,3,0,1,11,6,5,9,iceland2
Throttur R.,4,2,1,1,10,5,5,7,iceland2
Grindavik,4,2,0,2,9,11,-2,6,iceland2
Grotta,4,1,1,2,4,7,-3,4,iceland2
Afturelding,4,1,0,3,8,8,0,3,iceland2
Thor Akureyri,4,1,0,3,5,7,-2,3,iceland2
Selfoss,4,1,0,3,3,5,-2,3,iceland2
Njardvík,4,1,0,3,7,12,-5,3,iceland2
AEggir,4,0,0,4,2,22,-20,0,iceland2
IR Reykjavik,4,3,1,0,12,3,9,10,iceland3
Dalvik / Reynir,4,3,1,0,10,3,7,10,iceland3
Fjardabyggd,4,3,0,1,11,6,5,9,iceland3
Throttur Vogar,4,3,0,1,10,5,5,9,iceland3
V. Olafsvik,4,2,1,1,10,10,0,7,iceland3
Fjallabyggd,4,2,0,2,9,10,-1,6,iceland3
Haukar,4,2,0,2,6,7,-1,6,iceland3
Hottur / Huginn,4,2,0,2,5,9,-4,6,iceland3
KFG,4,1,0,3,8,9,-1,3,iceland3
Volsungur,4,1,0,3,6,8,-2,3,iceland3
Sindri,4,0,1,3,5,13,-8,1,iceland3
KV Reykjavik,4,0,0,4,3,12,-9,0,iceland3
Mumbai City,4,3,1,0,9,3,6,10,india
ATK Mohun Bagan,4,3,1,0,10,5,5,10,india
Goa,4,3,1,0,5,0,5,10,india
Odisha FC,4,3,1,0,7,4,3,10,india
Kerala Blasters,4,2,1,1,6,5,1,7,india
East Bengal,4,1,2,1,7,3,4,5,india
Punjab,4,0,3,1,5,6,-1,3,india
Chennaiyin,4,0,3,1,6,9,-3,3,india
Bengaluru,4,0,3,1,5,9,-4,3,india
Hyderabad,4,0,2,2,2,5,-3,2,india
NorthEast Utd,4,0,2,2,2,8,-6,2,india
Jamshedpur,4,0,1,3,4,7,-3,1,india
Mohammedan,4,3,1,0,7,3,4,10,india2
Real Kashmir,4,2,2,0,8,0,8,8,india2
Aizawl,4,2,2,0,10,3,7,8,india2
Sreenidi Deccan,4,2,1,1,5,3,2,7,india2
Shillong Lajong,4,2,1,1,5,5,0,7,india2
Delhi FC,4,2,0,2,8,8,0,6,india2
Churchill B.,4,1,1,2,6,6,0,4,india2
Inter Kashi,4,1,1,2,5,10,-5,4,india2
Rajasthan,4,0,3,1,6,7,-1,3,india2
Gokulam,4,0,3,1,5,7,-2,3,india2
TRAU,4,1,0,3,5,11,-6,3,india2
Neroca,4,1,0,3,6,14,-8,3,india2
Namdhari,4,0,1,3,3,9,-6,1,india2
Persik Kediri,4,3,1,0,7,0,7,10,indonesia
Borneo,4,3,1,0,5,1,4,10,indonesia
PSIS Semarang,4,2,1,1,6,3,3,7,indonesia
Bali Utd,4,2,1,1,7,6,1,7,indonesia
PSS Sleman,4,2,1,1,4,3,1,7,indonesia
Persita,4,2,1,1,6,6,0,7,indonesia
Persija,4,1,3,0,8,4,4,6,indonesia
PSM,4,1,3,0,5,3,2,6,indonesia
Persib,4,1,2,1,7,5,2,5,indonesia
Arema,4,1,1,2,7,7,0,4,indonesia
Bhayangkara S.,4,0,4,0,6,6,0,4,indonesia
Barito Putera,4,1,1,2,4,6,-2,4,indonesia
Persis Solo,4,1,1,2,4,6,-2,4,indonesia
Madura Utd,4,1,0,3,5,8,-3,3,indonesia
Dewa Utd,4,0,3,1,3,7,-4,3,indonesia
R. Nusantara,4,0,2,2,1,5,-4,2,indonesia
Persebaya S.,4,0,2,2,1,7,-6,2,indonesia
TIRA Persikabo,4,0,1,3,4,11,-7,1,indonesia
Sepahan,4,3,0,1,10,5,5,9,iran
Tractor Sazi,4,3,0,1,6,2,4,9,iran
Malavan,4,2,1,1,5,5,0,7,iran
Shams A. Qazvin,4,1,3,0,6,4,2,6,iran
Esteghlal,4,1,3,0,5,3,2,6,iran
Zob Ahan,4,1,3,0,4,3,1,6,iran
Gol Gohar,4,1,2,1,4,3,1,5,iran
Aluminium Arak,4,1,2,1,4,4,0,5,iran
Persepolis,4,1,2,1,3,3,0,5,iran
Havadar,4,1,1,2,2,2,0,4,iran
Paykan,4,0,4,0,2,2,0,4,iran
Sanat Naft,4,1,1,2,5,6,-1,4,iran
N. Mazandaran,4,1,1,2,3,6,-3,4,iran
Foolad,4,1,1,2,1,5,-4,4,iran
Mes Rafsanjan,4,1,0,3,4,8,-4,3,iran
E. Khuzestan,4,0,2,2,3,6,-3,2,iran
Naft Maysan,4,3,1,0,8,0,8,10,iraq
Al Zawraa,4,3,1,0,6,0,6,10,iraq
Al Quwa Al J.,4,3,1,0,9,4,5,10,iraq
Al Talaba,4,3,0,1,6,2,4,9,iraq
Al Minaa Basra,4,3,0,1,4,4,0,9,iraq
Newroz SC,4,2,1,1,6,2,4,7,iraq
Al Shorta,4,2,1,1,6,4,2,7,iraq
Al Naft,4,2,1,1,5,3,2,7,iraq
Zakho,4,2,1,1,3,2,1,7,iraq
Al Hudod,4,1,2,1,6,6,0,5,iraq
Al Karkh,4,1,2,1,6,6,0,5,iraq
Naft Al-Janoob,4,1,1,2,2,4,-2,4,iraq
Karbala,4,1,1,2,3,7,-4,4,iraq
Al Kahrabaa,4,0,3,1,5,7,-2,3,iraq
Baghdad,4,1,0,3,3,6,-3,3,iraq
Duhok,4,1,0,3,2,7,-5,3,iraq
Erbil,4,1,0,3,2,7,-5,3,iraq
Al Najaf,4,0,2,2,1,3,-2,2,iraq
Naft Al-Wasat,4,0,2,2,0,3,-3,2,iraq
Al-Qasim,4,0,2,2,3,7,-4,2,iraq
Shamrock Rovers,4,3,1,0,11,2,9,10,ireland
Shelbourne,4,3,1,0,8,4,4,10,ireland
Dundalk,4,3,0,1,9,2,7,9,ireland
Derry City,4,2,2,0,4,0,4,8,ireland
Bohemians,4,2,0,2,6,5,1,6,ireland
St. Patricks,4,2,0,2,3,5,-2,6,ireland
Cork City,4,1,1,2,2,5,-3,4,ireland
Drogheda Utd,4,0,2,2,2,9,-7,2,ireland
Sligo Rovers,4,0,1,3,2,7,-5,1,ireland
UC Dublin,4,0,0,4,4,12,-8,0,ireland
Galway Utd,4,4,0,0,15,2,13,12,ireland2
Bray Wanderers,4,2,2,0,6,4,2,8,ireland2
Finn Harps,4,2,1,1,7,5,2,7,ireland2
Treaty Utd,4,2,0,2,6,8,-2,6,ireland2
Cobh Ramblers,4,1,2,1,7,6,1,5,ireland2
Waterford,4,1,2,1,4,4,0,5,ireland2
Wexford,4,1,2,1,5,6,-1,5,ireland2
Kerry,4,0,2,2,4,6,-2,2,ireland2
Longford Town,4,0,2,2,4,7,-3,2,ireland2
Athlone Town,4,0,1,3,1,11,-10,1,ireland2
M. Tel Aviv,4,4,0,0,12,3,9,12,israel
M. Bnei Raina,4,3,1,0,7,1,6,10,israel
Maccabi Haifa,4,3,1,0,7,4,3,10,israel
Hapoel Hadera,4,2,1,1,5,3,2,7,israel
Hapoel Haifa,4,2,1,1,4,3,1,7,israel
M. Petah Tikva,4,2,0,2,6,7,-1,6,israel
H. Petah Tikva,4,1,2,1,4,4,0,5,israel
Ashdod,4,1,2,1,3,3,0,5,israel
Hapoel Tel Aviv,4,1,1,2,5,4,1,4,israel
B. Jerusalem,4,1,1,2,2,5,-3,4,israel
Bnei Sakhnin,4,1,1,2,6,10,-4,4,israel
H. Beer Sheva,4,1,0,3,4,4,0,3,israel
Maccabi Netanya,4,0,2,2,4,6,-2,2,israel
H. Jerusalem,4,0,0,4,1,7,-6,0,israel
Bnei Yehuda,4,4,0,0,10,2,8,12,israel2
Kiryat Shmona,4,4,0,0,6,0,6,12,israel2
Ironi Tiberias,4,3,1,0,13,2,11,10,israel2
M. Herziliya,4,3,1,0,5,2,3,10,israel2
Hapoel Afula,4,2,1,1,6,4,2,7,israel2
H. Nof Hagalil,4,2,0,2,9,6,3,6,israel2
Maccabi Jaffa,4,1,3,0,5,3,2,6,israel2
H. Ironi Rishon,4,1,2,1,7,9,-2,5,israel2
Nes Tziona,4,1,1,2,4,7,-3,4,israel2
H. Kfar Saba,4,1,1,2,2,6,-4,4,israel2
Ihud B. Shfaram,4,1,0,3,3,8,-5,3,israel2
Hapoel Akko,4,0,2,2,4,7,-3,2,israel2
H. Umm al-Fahm,4,0,2,2,5,9,-4,2,israel2
Kafr Qasim,4,0,2,2,1,6,-5,2,israel2
H. Ramat Gan,4,0,1,3,1,5,-4,1,israel2
Ramat Hasharon,4,0,1,3,4,9,-5,1,israel2
Inter Milan,4,3,1,0,10,1,9,10,italy
Juventus,4,3,1,0,6,3,3,10,italy
AS Roma,4,2,2,0,6,3,3,8,italy
Fiorentina,4,2,1,1,6,3,3,7,italy
AC Milan,4,2,1,1,8,6,2,7,italy
Bologna,4,2,1,1,6,4,2,7,italy
Torino,4,1,2,1,4,3,1,5,italy
Monza,4,1,2,1,4,4,0,5,italy
Lazio,4,1,2,1,3,3,0,5,italy
Sassuolo,4,1,1,2,8,9,-1,4,italy
Empoli,4,1,1,2,6,7,-1,4,italy
Cagliari,4,1,1,2,4,5,-1,4,italy
Genoa,4,1,1,2,3,4,-1,4,italy
Atalanta,4,1,1,2,5,8,-3,4,italy
Salernitana,4,1,1,2,5,8,-3,4,italy
Frosinone,4,1,1,2,3,6,-3,4,italy
Hellas Verona,4,0,3,1,6,7,-1,3,italy
Lecce,4,0,3,1,6,7,-1,3,italy
Napoli,4,1,0,3,2,6,-4,3,italy
Udinese,4,0,2,2,5,11,-6,2,italy
Cittadella,4,4,0,0,6,1,5,12,italy2
Cremonese,4,3,1,0,5,0,5,10,italy2
Como,4,3,1,0,5,2,3,10,italy2
Venezia,4,3,0,1,8,3,5,9,italy2
Catanzaro,4,3,0,1,7,3,4,9,italy2
Sampdoria,4,3,0,1,7,4,3,9,italy2
Ternana,4,2,2,0,8,5,3,8,italy2
Brescia,4,1,3,0,6,4,2,6,italy2
Parma,4,1,2,1,7,7,0,5,italy2
Pisa,4,1,2,1,3,4,-1,5,italy2
Spezia,4,1,1,2,5,6,-1,4,italy2
Modena,4,1,1,2,4,6,-2,4,italy2
Lecco,4,1,1,2,1,3,-2,4,italy2
Bari,4,1,1,2,5,8,-3,4,italy2
Cosenza,4,1,0,3,3,7,-4,3,italy2
Palermo,4,0,2,2,5,7,-2,2,italy2
Reggiana,4,0,2,2,3,6,-3,2,italy2
FeralpiSalo,4,0,1,3,5,8,-3,1,italy2
Sudtirol,4,0,1,3,3,6,-3,1,italy2
Ascoli,4,0,1,3,3,7,-4,1,italy2
Arnett Gardens,4,3,1,0,7,2,5,10,jamaica
Mount Pleasant,4,3,1,0,5,1,4,10,jamaica
Cavalier,4,2,2,0,8,4,4,8,jamaica
Dunbeholden,4,2,2,0,6,4,2,8,jamaica
Treasure Beach,4,2,1,1,5,4,1,7,jamaica
Vere Utd,4,2,0,2,7,7,0,6,jamaica
Humble Lions,4,2,0,2,6,8,-2,6,jamaica
Tivoli Gardens,4,1,2,1,5,5,0,5,jamaica
Portmore Utd,4,0,3,1,4,5,-1,3,jamaica
Montego Bay,4,1,0,3,7,10,-3,3,jamaica
Waterhouse,4,0,2,2,1,3,-2,2,jamaica
Harbour View,4,0,2,2,4,8,-4,2,jamaica
Lime Hall Acade,4,0,2,2,3,7,-4,2,jamaica
Molynes Utd,4,0,1,3,2,6,-4,1,jamaica
S. Hiroshima,4,3,1,0,6,1,5,10,japan
Vissel Kobe,4,3,1,0,6,3,3,10,japan
K. Frontale,4,2,2,0,8,4,4,8,japan
Albirex Niigata,4,2,2,0,2,0,2,8,japan
Yokohama M.,4,2,1,1,7,3,4,7,japan
Kyoto Sanga,4,2,1,1,7,5,2,7,japan
C. Sapporo,4,2,1,1,5,4,1,7,japan
Shonan Bellmare,4,2,1,1,4,3,1,7,japan
Avispa Fukuoka,4,2,0,2,5,8,-3,6,japan
Kashima Antlers,4,1,2,1,3,5,-2,5,japan
Kashiwa Reysol,4,0,4,0,5,5,0,4,japan
Urawa RD,4,1,1,2,5,5,0,4,japan
FC Tokyo,4,1,1,2,3,5,-2,4,japan
Yokohama FC,4,1,0,3,5,6,-1,3,japan
Cerezo Osaka,4,1,0,3,1,4,-3,3,japan
Nagoya G.,4,0,2,2,4,6,-2,2,japan
Sagan Tosu,4,0,2,2,4,7,-3,2,japan
Gamba Osaka,4,0,0,4,1,7,-6,0,japan
Machida Zelvia,4,4,0,0,9,1,8,12,japan2
M. Yamagata,4,4,0,0,8,3,5,12,japan2
Jubilo Iwata,4,3,1,0,11,2,9,10,japan2
Tokyo Verdy,4,3,1,0,7,3,4,10,japan2
Oita Trinita,4,2,2,0,7,5,2,8,japan2
Shimizu S-Pulse,4,2,1,1,13,5,8,7,japan2
Ventforet Kofu,4,2,1,1,6,3,3,7,japan2
V-V. Nagasaki,4,2,1,1,7,5,2,7,japan2
JEF Utd Chiba,4,2,0,2,6,7,-1,6,japan2
R. Kumamoto,4,2,0,2,6,7,-1,6,japan2
Tokushima V.,4,1,2,1,3,5,-2,5,japan2
Blaublitz Akita,4,1,1,2,4,4,0,4,japan2
Fujieda MYFC,4,1,1,2,5,7,-2,4,japan2
Vegalta Sendai,4,1,1,2,4,6,-2,4,japan2
Kusatsu,4,1,0,3,5,7,-2,3,japan2
Fagiano Okayama,4,0,3,1,4,6,-2,3,japan2
Iwaki,4,1,0,3,6,13,-7,3,japan2
Omiya Ardija,4,1,0,3,3,10,-7,3,japan2
Tochigi SC,4,0,2,2,3,5,-2,2,japan2
Z. Kanazawa,4,0,2,2,3,5,-2,2,japan2
R. Yamaguchi,4,0,2,2,4,8,-4,2,japan2
Mito Hollyhock,4,0,1,3,2,9,-7,1,japan2
Al Hussein,4,4,0,0,9,0,9,12,jordan
Al Wihdat,4,4,0,0,7,2,5,12,jordan
Al Faysali,4,2,1,1,8,4,4,7,jordan
Maan,4,2,1,1,6,4,2,7,jordan
Al Ramtha,4,2,0,2,7,3,4,6,jordan
Aqaba,4,2,0,2,3,6,-3,6,jordan
Moghayer Al S.,4,1,1,2,3,5,-2,4,jordan
Shabab Al Ordon,4,1,1,2,3,5,-2,4,jordan
Al Jalil,4,1,1,2,4,8,-4,4,jordan
Al Ahli,4,1,0,3,1,4,-3,3,jordan
Sahab,4,0,2,2,4,10,-6,2,jordan
Al Salt,4,0,1,3,2,6,-4,1,jordan
Ordabasy,4,3,0,1,6,3,3,9,kazakhstan
Kaisar K.,4,3,0,1,5,3,2,9,kazakhstan
FC Astana,4,2,1,1,8,6,2,7,kazakhstan
Kairat Almaty,4,1,3,0,5,2,3,6,kazakhstan
Aktobe,4,1,3,0,5,3,2,6,kazakhstan
Tobol,4,1,2,1,6,4,2,5,kazakhstan
Atyrau,4,1,2,1,2,1,1,5,kazakhstan
Kaspiy Aktau,4,1,2,1,4,5,-1,5,kazakhstan
Maqtaaral,4,1,2,1,4,5,-1,5,kazakhstan
S. Karagandy,4,1,2,1,4,5,-1,5,kazakhstan
Okzhetpes,4,1,2,1,6,8,-2,5,kazakhstan
Zhetysu,4,1,1,2,6,7,-1,4,kazakhstan
Aksu,4,1,0,3,3,9,-6,3,kazakhstan
Kyzylzhar,4,0,1,3,3,6,-3,1,kazakhstan
Llapi,4,3,0,1,8,4,4,9,kosovo
Ballkani,4,3,0,1,10,7,3,9,kosovo
Drita,4,3,0,1,5,2,3,9,kosovo
Malisheva,4,3,0,1,3,2,1,9,kosovo
Prishtina,4,2,2,0,4,2,2,8,kosovo
Feronikeli,4,2,0,2,4,5,-1,6,kosovo
Dukagjini,4,1,1,2,4,4,0,4,kosovo
Gjilani,4,1,0,3,4,4,0,3,kosovo
Liria,4,0,1,3,3,9,-6,1,kosovo
Fushe Kosova,4,0,0,4,1,7,-6,0,kosovo
Al Arabi SC,4,3,0,1,11,5,6,9,kuwait
Al Qadsia,4,2,2,0,8,2,6,8,kuwait
Al Salmiyah,4,2,2,0,6,3,3,8,kuwait
Al Kuwait,4,2,1,1,7,6,1,7,kuwait
Al Nasar,4,2,0,2,9,7,2,6,kuwait
Al Shabab,4,2,0,2,7,7,0,6,kuwait
Kazma,4,2,0,2,7,9,-2,6,kuwait
Al Fahaheel,4,1,1,2,8,10,-2,4,kuwait
Al Jahra,4,0,1,3,2,8,-6,1,kuwait
Khaitan,4,0,1,3,2,10,-8,1,kuwait
RFS,4,4,0,0,13,5,8,12,latvia
Auda,4,3,1,0,5,1,4,10,latvia
Riga FC,4,2,2,0,7,3,4,8,latvia
Liepaja,4,2,1,1,5,3,2,7,latvia
Valmiera,4,2,1,1,5,5,0,7,latvia
FS Jelgava,4,1,1,2,1,3,-2,4,latvia
Metta / LU,4,1,0,3,5,6,-1,3,latvia
Daugavpils,4,1,0,3,3,7,-4,3,latvia
Tukums,4,0,1,3,4,7,-3,1,latvia
Super Nova,4,0,1,3,1,9,-8,1,latvia
Kauno Zalgiris,4,3,1,0,12,4,8,10,lithuania
Riteriai,4,2,0,2,8,7,1,6,lithuania
Panevezys,4,1,3,0,4,3,1,6,lithuania
Suduva,4,2,0,2,4,5,-1,6,lithuania
FA Siauliai,4,1,2,1,7,6,1,5,lithuania
Zalgiris,4,1,1,2,3,6,-3,4,lithuania
Hegelmann L.,4,1,1,2,4,8,-4,4,lithuania
Dziugas Telsiai,4,0,3,1,3,5,-2,3,lithuania
Banga,4,1,0,3,3,8,-5,3,lithuania
Dainava,4,0,1,3,2,5,-3,1,lithuania
Kauno Z. B,4,3,0,1,12,7,5,9,lithuania2
Be1 NFA,4,3,0,1,8,3,5,9,lithuania2
TransINVEST,4,3,0,1,9,5,4,9,lithuania2
FA Siauliai B,4,3,0,1,10,7,3,9,lithuania2
Zalgiris B,4,2,2,0,14,8,6,8,lithuania2
Garliava,4,2,1,1,6,3,3,7,lithuania2
Neptuna K.,4,2,1,1,10,8,2,7,lithuania2
Babrungas,4,2,0,2,9,8,1,6,lithuania2
Riteriai B,4,2,0,2,7,6,1,6,lithuania2
BFA Vilnius,4,2,0,2,7,8,-1,6,lithuania2
Panevezys B,4,1,1,2,7,6,1,4,lithuania2
Nevezis,4,1,1,2,5,7,-2,4,lithuania2
Minija,4,1,0,3,5,7,-2,3,lithuania2
Ekranas,4,1,0,3,4,11,-7,3,lithuania2
Jonava,4,0,1,3,3,13,-10,1,lithuania2
Marijampole C.,4,0,0,4,0,12,-12,0,lithuania2
Differdange,4,3,1,0,7,2,5,10,luxembourg
Racing,4,3,0,1,8,3,5,9,luxembourg
Dudelange,4,3,0,1,5,1,4,9,luxembourg
Hesperang,4,2,1,1,6,4,2,7,luxembourg
UN Käerjéng,4,2,1,1,6,4,2,7,luxembourg
Fola Esch,4,2,1,1,7,6,1,7,luxembourg
Mondorf,4,2,0,2,6,6,0,6,luxembourg
Niedercorn,4,2,0,2,5,5,0,6,luxembourg
Wiltz,4,1,2,1,5,5,0,5,luxembourg
UNA Strassen,4,1,2,1,3,3,0,5,luxembourg
Petange,4,1,1,2,4,4,0,4,luxembourg
Marisca Mersch,4,1,1,2,8,9,-1,4,luxembourg
Schifflange,4,1,1,2,6,7,-1,4,luxembourg
Jeunesse Esch,4,0,2,2,4,9,-5,2,luxembourg
Mondercange,4,0,2,2,3,9,-6,2,luxembourg
V. Rosport,4,0,0,4,1,10,-9,0,luxembourg
Selangor,4,4,0,0,20,2,18,12,malaysia
Sabah,4,4,0,0,15,1,14,12,malaysia
Johor Darul,4,4,0,0,10,0,10,12,malaysia
Kedah,4,3,0,1,10,2,8,9,malaysia
PDRM,4,3,0,1,12,6,6,9,malaysia
Perak,4,2,0,2,9,5,4,6,malaysia
Negeri Sembilan,4,2,0,2,6,4,2,6,malaysia
Kuala Lumpur,4,2,0,2,6,5,1,6,malaysia
Pulau Pinang,4,1,2,1,4,4,0,5,malaysia
Kelantan United,4,1,0,3,1,9,-8,3,malaysia
Kuching,4,0,2,2,3,6,-3,2,malaysia
Terengganu,4,0,2,2,3,11,-8,2,malaysia
Pahang,4,0,1,3,6,10,-4,1,malaysia
Kelantan,4,0,0,4,3,28,-25,0,malaysia
Floriana,4,4,0,0,9,0,9,12,malta
Naxxar Lions,4,3,1,0,7,3,4,10,malta
Marsaxlokk,4,3,0,1,9,3,6,9,malta
Hibernians,4,3,0,1,5,2,3,9,malta
Sliema W.,4,3,0,1,3,2,1,9,malta
Hamrun Spartans,4,2,1,1,4,5,-1,7,malta
Birkirkara,4,2,0,2,6,4,2,6,malta
Balzan,4,1,1,2,6,5,1,4,malta
Gzira Utd,4,1,1,2,6,6,0,4,malta
Santa Lucia,4,1,1,2,2,5,-3,4,malta
Gudja Utd,4,0,2,2,4,6,-2,2,malta
Valletta,4,0,2,2,2,5,-3,2,malta
Sirens,4,0,1,3,2,9,-7,1,malta
Mosta,4,0,1,3,1,8,-7,1,malta
Monterrey,4,3,1,0,8,0,8,10,mexico
CF America,4,3,1,0,7,0,7,10,mexico
Puebla,4,3,1,0,9,6,3,10,mexico
Mazatlan,4,3,0,1,7,5,2,9,mexico
Pumas UNAM,4,2,1,1,5,2,3,7,mexico
Necaxa,4,2,1,1,5,3,2,7,mexico
Pachuca,4,2,1,1,6,5,1,7,mexico
Cruz Azul,4,2,0,2,4,3,1,6,mexico
Tijuana,4,2,0,2,6,6,0,6,mexico
Santos Laguna,4,2,0,2,6,7,-1,6,mexico
Guadalajara,4,2,0,2,3,6,-3,6,mexico
Tigres,4,1,2,1,6,4,2,5,mexico
Club Leon,4,1,1,2,7,8,-1,4,mexico
Queretaro,4,1,1,2,4,5,-1,4,mexico
Toluca,4,1,0,3,4,6,-2,3,mexico
A. San Luis,4,0,1,3,3,8,-5,1,mexico
Atlas,4,0,1,3,0,7,-7,1,mexico
Juarez,4,0,0,4,2,12,-10,0,mexico
Guadalajara,4,4,0,0,9,2,7,12,mexico2
CF America,4,3,1,0,7,3,4,10,mexico2
Pachuca,4,3,0,1,8,6,2,9,mexico2
Atlas,4,2,2,0,8,3,5,8,mexico2
Toluca,4,2,1,1,7,5,2,7,mexico2
Queretaro,4,2,1,1,4,2,2,7,mexico2
Pumas UNAM,4,2,1,1,8,7,1,7,mexico2
Monterrey,4,2,0,2,8,5,3,6,mexico2
Club Leon,4,1,2,1,3,2,1,5,mexico2
Puebla,4,1,1,2,7,6,1,4,mexico2
A. San Luis,4,1,1,2,4,5,-1,4,mexico2
Cruz Azul,4,1,1,2,5,7,-2,4,mexico2
Tijuana,4,1,1,2,5,8,-3,4,mexico2
Tigres,4,1,1,2,2,5,-3,4,mexico2
Santos Laguna,4,1,0,3,5,10,-5,3,mexico2
Mazatlan,4,1,0,3,4,9,-5,3,mexico2
Juarez,4,0,2,2,2,5,-3,2,mexico2
Necaxa,4,0,1,3,2,8,-6,1,mexico2
Deren,4,4,0,0,17,4,13,12,mongolia
Tuv Buganuud,4,4,0,0,20,9,11,12,mongolia
SP Falcons,4,4,0,0,9,0,9,12,mongolia
Khangarid,4,2,0,2,15,7,8,6,mongolia
FC Ulaanbaatar,4,2,0,2,8,3,5,6,mongolia
Khoromkhon,4,2,0,2,8,11,-3,6,mongolia
Erchim,4,1,1,2,7,12,-5,4,mongolia
Bavarians,4,0,1,3,6,17,-11,1,mongolia
Khovd,4,0,0,4,4,15,-11,0,mongolia
Bayanzurkh S.,4,0,0,4,3,19,-16,0,mongolia
Buducnost,4,3,1,0,12,8,4,10,montenegro
Mladost DG,4,2,1,1,6,4,2,7,montenegro
Mornar,4,2,1,1,7,6,1,7,montenegro
Sutjeska,4,1,3,0,4,3,1,6,montenegro
Jezero,4,1,2,1,5,3,2,5,montenegro
Decic,4,1,2,1,4,3,1,5,montenegro
Petrovac,4,0,4,0,4,4,0,4,montenegro
Arsenal Tivat,4,1,1,2,2,5,-3,4,montenegro
Rudar,4,1,0,3,5,8,-3,3,montenegro
Jedinstvo,4,0,1,3,4,9,-5,1,montenegro
Raja Casablanca,4,3,1,0,5,1,4,10,morocco
FAR Rabat,4,3,0,1,10,4,6,9,morocco
Wydad,4,3,0,1,10,5,5,9,morocco
R. Zemamra,4,2,1,1,5,3,2,7,morocco
Olympic Safi,4,2,1,1,5,5,0,7,morocco
Moghreb Tetouan,4,1,3,0,7,3,4,6,morocco
Berkane,4,1,3,0,4,1,3,6,morocco
Youssoufia B.,4,2,0,2,5,8,-3,6,morocco
Salmi,4,1,2,1,3,3,0,5,morocco
Ittihad Tanger,4,0,4,0,4,4,0,4,morocco
Union Touarga,4,1,1,2,2,3,-1,4,morocco
C. Mohammedia,4,1,1,2,3,5,-2,4,morocco
Mouloudia Oujda,4,1,1,2,3,5,-2,4,morocco
Hassania Agadir,4,0,3,1,3,4,-1,3,morocco
FUS Rabat,4,0,3,1,1,3,-2,3,morocco
Maghreb de Fes,4,0,1,3,3,7,-4,1,morocco
Meknes,4,3,1,0,5,1,4,10,morocco2
R. Beni Mellal,4,2,2,0,6,1,5,8,morocco2
Stade Marocain,4,2,1,1,6,4,2,7,morocco2
Kawkab M.,4,2,1,1,3,2,1,7,morocco2
Chabab Atlas K.,4,1,3,0,2,1,1,6,morocco2
Difaa El Jadida,4,2,0,2,4,6,-2,6,morocco2
USM Oujda,4,1,2,1,4,2,2,5,morocco2
RAC Casablanca,4,1,2,1,5,4,1,5,morocco2
Khouribga,4,1,2,1,3,3,0,5,morocco2
C. Benguerir,4,1,2,1,2,2,0,5,morocco2
Wydad Fès,4,1,2,1,2,2,0,5,morocco2
Rapide Oued Z.,4,0,4,0,3,3,0,4,morocco2
El Massira,4,1,0,3,6,7,-1,3,morocco2
Dcheira,4,0,3,1,1,4,-3,3,morocco2
AS Salé,4,1,0,3,4,9,-5,3,morocco2
Ittifaq M.,4,0,1,3,1,6,-5,1,morocco2
Shan Utd,4,4,0,0,13,6,7,12,myanmar
Yangon Utd,4,3,0,1,10,3,7,9,myanmar
Myawady,4,3,0,1,9,4,5,9,myanmar
Dagon,4,3,0,1,6,4,2,9,myanmar
Ayeyawady,4,2,1,1,4,3,1,7,myanmar
Hantharwady,4,2,0,2,7,3,4,6,myanmar
Rakhine Utd,4,2,0,2,6,7,-1,6,myanmar
Ispe FC,4,1,1,2,6,6,0,4,myanmar
Yadanarbon,4,1,1,2,4,9,-5,4,myanmar
Sagaing Utd,4,1,0,3,4,11,-7,3,myanmar
Chinland,4,0,1,3,4,12,-8,1,myanmar
Kachin Utd,4,0,0,4,3,8,-5,0,myanmar
PSV Eindhoven,4,4,0,0,11,1,10,12,netherlands
Ajax Amsterdam,4,4,0,0,12,4,8,12,netherlands
Heerenveen,4,3,0,1,9,3,6,9,netherlands
Feyenoord,4,3,0,1,9,5,4,9,netherlands
Fortuna Sittard,4,3,0,1,8,5,3,9,netherlands
FC Utrecht,4,2,2,0,7,4,3,8,netherlands
AZ Alkmaar,4,2,1,1,9,4,5,7,netherlands
NEC Nijmegen,4,2,1,1,7,5,2,7,netherlands
FC Twente,4,2,1,1,10,9,1,7,netherlands
Sparta,4,2,0,2,7,5,2,6,netherlands
RKC Waalwijk,4,1,1,2,6,7,-1,4,netherlands
Go Ahead Eagles,4,1,1,2,3,6,-3,4,netherlands
Heracles Almelo,4,1,0,3,6,7,-1,3,netherlands
PEC Zwolle,4,1,0,3,7,9,-2,3,netherlands
Vitesse Arnhem,4,1,0,3,4,11,-7,3,netherlands
Excelsior,4,0,2,2,8,12,-4,2,netherlands
Almere City,4,0,1,3,3,14,-11,1,netherlands
FC Volendam,4,0,0,4,2,15,-13,0,netherlands
NAC Breda,4,4,0,0,12,1,11,12,netherlands2
FC Groningen,4,4,0,0,11,2,9,12,netherlands2
Willem II,4,3,1,0,12,3,9,10,netherlands2
Jong Ajax,4,2,2,0,9,5,4,8,netherlands2
Cambuur,4,2,2,0,8,6,2,8,netherlands2
Roda JC,4,2,1,1,4,4,0,7,netherlands2
MVV Maastricht,4,2,0,2,7,6,1,6,netherlands2
FC Emmen,4,2,0,2,5,7,-2,6,netherlands2
Jong AZ,4,2,0,2,4,11,-7,6,netherlands2
ADO Den Haag,4,1,2,1,11,6,5,5,netherlands2
FC Dordrecht,4,1,2,1,6,6,0,5,netherlands2
FC Eindhoven,4,1,2,1,6,6,0,5,netherlands2
Jong Utrecht,4,1,2,1,2,6,-4,5,netherlands2
De Graafschap,4,1,1,2,4,6,-2,4,netherlands2
Telstar,4,1,1,2,5,8,-3,4,netherlands2
VVV,4,1,0,3,6,8,-2,3,netherlands2
Helmond Sport,4,1,0,3,6,10,-4,3,netherlands2
TOP Oss,4,0,1,3,0,4,-4,1,netherlands2
FC Den Bosch,4,0,1,3,4,9,-5,1,netherlands2
Jong PSV,4,0,1,3,1,8,-7,1,netherlands2
Real Esteli,4,3,1,0,7,1,6,10,nicaragua
Diriangen,4,3,0,1,5,3,2,9,nicaragua
O. Masachapa,4,2,1,1,6,5,1,7,nicaragua
Export Sebaco,4,2,0,2,9,6,3,6,nicaragua
D. Ocotal,4,1,2,1,3,3,0,5,nicaragua
UNAN Managua,4,1,2,1,4,7,-3,5,nicaragua
Matagalpa,4,1,1,2,5,6,-1,4,nicaragua
Managua FC,4,1,1,2,3,7,-4,4,nicaragua
Jalapa,4,0,2,2,3,5,-2,2,nicaragua
Walter Ferreti,4,0,2,2,1,3,-2,2,nicaragua
Remo Stars,4,3,1,0,8,2,6,10,nigeria
Akwa Utd,4,3,0,1,6,2,4,9,nigeria
Enyimba,4,2,2,0,7,1,6,8,nigeria
Rivers Utd,4,2,2,0,5,2,3,8,nigeria
Wikki Tourist,4,2,1,1,7,4,3,7,nigeria
Sunshine Stars,4,2,0,2,6,3,3,6,nigeria
Enugu Rangers,4,1,3,0,5,2,3,6,nigeria
Bayelsa Utd,4,2,0,2,6,5,1,6,nigeria
Bendel,4,1,3,0,4,3,1,6,nigeria
Abia Warriors,4,2,0,2,5,7,-2,6,nigeria
Shooting Stars,4,1,2,1,4,2,2,5,nigeria
Plateau Utd,4,1,2,1,5,5,0,5,nigeria
Nasarawa Utd,4,1,1,2,2,3,-1,4,nigeria
Lobi Stars,4,1,1,2,2,4,-2,4,nigeria
Doma Utd,4,1,1,2,2,5,-3,4,nigeria
Kwara Utd,4,1,1,2,3,8,-5,4,nigeria
Niger Tornadoes,4,1,0,3,3,5,-2,3,nigeria
Dakkada,4,0,2,2,2,8,-6,2,nigeria
El Kanemi,4,0,1,3,3,7,-4,1,nigeria
Gombe Utd,4,0,1,3,0,9,-9,1,nigeria
Cliftonville,4,3,1,0,12,3,9,10,northernireland
Larne,4,3,1,0,8,2,6,10,northernireland
Glentoran,4,2,1,1,12,4,8,7,northernireland
Glenavon,4,2,1,1,7,5,2,7,northernireland
Crusaders,4,2,1,1,4,5,-1,7,northernireland
Dungannon,4,2,0,2,10,10,0,6,northernireland
Linfield,4,2,0,2,9,9,0,6,northernireland
Coleraine,4,1,2,1,5,6,-1,5,northernireland
Carrick Rangers,4,0,2,2,3,7,-4,2,northernireland
Newry City,4,0,2,2,2,8,-6,2,northernireland
Ballymena Utd,4,0,2,2,0,9,-9,2,northernireland
Loughgall,4,0,1,3,5,9,-4,1,northernireland
Newington Youth,4,3,0,1,9,8,1,9,northernireland2
Portadown,4,2,1,1,11,6,5,7,northernireland2
Bangor,4,2,1,1,10,6,4,7,northernireland2
Dundela,4,2,1,1,5,6,-1,7,northernireland2
Ballyclare,4,2,0,2,9,7,2,6,northernireland2
H&W Welders,4,2,0,2,7,7,0,6,northernireland2
Institute,4,1,2,1,5,6,-1,5,northernireland2
Ballinamallard,4,1,1,2,5,5,0,4,northernireland2
Ards,4,1,1,2,7,9,-2,4,northernireland2
Knockbreda,4,1,1,2,4,7,-3,4,northernireland2
Annagh Utd,4,1,1,2,4,8,-4,4,northernireland2
Dergview,4,0,1,3,5,11,-6,1,northernireland2
Struga,4,4,0,0,9,4,5,12,northmacedonia
Shkupi,4,3,1,0,3,0,3,10,northmacedonia
Skendija,4,2,1,1,7,4,3,7,northmacedonia
Tikves,4,2,0,2,6,5,1,6,northmacedonia
Gostivar,4,1,3,0,2,1,1,6,northmacedonia
Vardar,4,2,0,2,6,6,0,6,northmacedonia
Sileks,4,1,1,2,5,7,-2,4,northmacedonia
Rabotnicki,4,1,1,2,3,5,-2,4,northmacedonia
Voska Sport,4,1,1,2,5,8,-3,4,northmacedonia
Bregalnica Stip,4,0,3,1,6,7,-1,3,northmacedonia
Makedonija,4,1,0,3,1,3,-2,3,northmacedonia
A. Pandev,4,0,1,3,1,4,-3,1,northmacedonia
Bodo / Glimt,4,3,0,1,9,4,5,9,norway
Stromsgodset,4,3,0,1,7,2,5,9,norway
Sandefjord,4,3,0,1,8,4,4,9,norway
Brann,4,3,0,1,8,6,2,9,norway
Molde,4,2,1,1,9,5,4,7,norway
HamKam,4,2,1,1,5,3,2,7,norway
Tromso,4,2,1,1,5,4,1,7,norway
Rosenborg,4,2,0,2,11,8,3,6,norway
Viking,4,2,0,2,7,9,-2,6,norway
Valerenga,4,1,2,1,5,4,1,5,norway
Odd,4,1,1,2,10,9,1,4,norway
Lillestrom,4,1,1,2,5,9,-4,4,norway
Stabaek,4,1,1,2,2,8,-6,4,norway
Haugesund,4,1,0,3,4,5,-1,3,norway
Sarpsborg 08,4,1,0,3,5,9,-4,3,norway
Aalesund,4,0,0,4,1,12,-11,0,norway
Kristiansund,4,3,0,1,12,3,9,9,norway2
Kongsvinger,4,3,0,1,10,4,6,9,norway2
Bryne,4,3,0,1,4,3,1,9,norway2
KFUM Oslo,4,2,2,0,5,1,4,8,norway2
Hodd,4,2,2,0,5,3,2,8,norway2
Mjondalen,4,2,1,1,7,5,2,7,norway2
Fredrikstad,4,2,1,1,7,6,1,7,norway2
Asane,4,2,1,1,5,5,0,7,norway2
Moss,4,1,1,2,5,6,-1,4,norway2
Start,4,1,1,2,4,5,-1,4,norway2
Raufoss,4,1,1,2,2,3,-1,4,norway2
Ranheim,4,1,1,2,3,5,-2,4,norway2
Jerv,4,1,1,2,1,3,-2,4,norway2
Sandnes Ulf,4,1,0,3,5,11,-6,3,norway2
Sogndal,4,0,2,2,4,8,-4,2,norway2
Skeid,4,0,0,4,0,8,-8,0,norway2
Ibri,4,4,0,0,8,0,8,12,oman
Al Seeb,4,3,1,0,7,0,7,10,oman
Al Nasr,4,3,1,0,9,3,6,10,oman
Al-Nahda,4,2,2,0,8,5,3,8,oman
Oman Club,4,2,1,1,5,2,3,7,oman
Sohar,4,2,1,1,5,4,1,7,oman
Dhofar,4,2,0,2,6,6,0,6,oman
Al Wehda,4,1,0,3,3,8,-5,3,oman
Al-Shabab Club,4,0,2,2,3,5,-2,2,oman
Al-Rustaq,4,0,2,2,2,6,-4,2,oman
Sur,4,0,1,3,2,7,-5,1,oman
Bahla,4,0,1,3,1,9,-8,1,oman
UMECIT,4,3,1,0,5,1,4,10,panama
San Miguelito,4,3,0,1,4,1,3,9,panama
Plaza Amador,4,2,1,1,5,3,2,7,panama
Costa del Este,4,2,1,1,6,5,1,7,panama
Independiente,4,2,0,2,9,5,4,6,panama
Herrera,4,1,2,1,4,2,2,5,panama
Universitario,4,1,2,1,2,2,0,5,panama
San Francisco,4,1,2,1,1,3,-2,5,panama
Arabe Unido,4,1,1,2,4,3,1,4,panama
Alianza,4,1,1,2,2,5,-3,4,panama
Tauro,4,1,0,3,1,5,-4,3,panama
A. Chiriqui,4,0,1,3,2,10,-8,1,panama
Independiente,4,4,0,0,16,5,11,12,panama2
San Francisco,4,3,0,1,11,4,7,9,panama2
Arabe Unido,4,2,2,0,7,4,3,8,panama2
Alianza,4,2,2,0,5,2,3,8,panama2
San Miguelito,4,2,2,0,4,1,3,8,panama2
Herrera,4,2,1,1,14,5,9,7,panama2
Tauro,4,1,2,1,4,5,-1,5,panama2
Universitario,4,1,1,2,5,8,-3,4,panama2
UMECIT,4,1,0,3,9,10,-1,3,panama2
Costa del Este,4,0,1,3,6,10,-4,1,panama2
Plaza Amador,4,0,1,3,2,6,-4,1,panama2
A. Chiriqui,4,0,0,4,2,25,-23,0,panama2
S. Trinidense,4,3,1,0,8,3,5,10,paraguay
Nacional,4,3,0,1,6,3,3,9,paraguay
Libertad,4,2,1,1,4,3,1,7,paraguay
G. Caballero,4,2,1,1,3,3,0,7,paraguay
Olimpia,4,2,0,2,7,6,1,6,paraguay
S. Ameliano,4,1,2,1,5,4,1,5,paraguay
Guairena,4,1,2,1,5,5,0,5,paraguay
Cerro Porteno,4,1,1,2,6,6,0,4,paraguay
S. Luqueno,4,1,1,2,5,6,-1,4,paraguay
Tacuary,4,1,1,2,5,6,-1,4,paraguay
Resistencia,4,1,0,3,2,8,-6,3,paraguay
Guarani,4,0,2,2,3,6,-3,2,paraguay
S. Cristal,4,3,1,0,9,5,4,10,peru
FBC Melgar,4,3,1,0,8,5,3,10,peru
Sport Boys,4,3,0,1,6,4,2,9,peru
Atletico Grau,4,2,1,1,11,5,6,7,peru
Alianza Lima,4,2,0,2,11,7,4,6,peru
Universitario,4,2,0,2,5,2,3,6,peru
Binacional,4,2,0,2,10,8,2,6,peru
Cusco,4,2,0,2,6,5,1,6,peru
D. Municipal,4,2,0,2,4,4,0,6,peru
Sport Huancayo,4,2,0,2,4,4,0,6,peru
Cajamarca,4,2,0,2,5,6,-1,6,peru
D. Garcilaso,4,1,2,1,8,8,0,5,peru
ADT,4,1,2,1,7,7,0,5,peru
Union Comercio,4,1,2,1,8,12,-4,5,peru
Alianza A.,4,1,1,2,6,7,-1,4,peru
Cesar Vallejo,4,1,1,2,5,9,-4,4,peru
Cienciano,4,1,0,3,3,9,-6,3,peru
AD Cantolao,4,0,2,2,2,6,-4,2,peru
Carlos Manucci,4,0,1,3,2,7,-5,1,peru
Universitario,4,3,1,0,7,1,6,10,peru2
FBC Melgar,4,3,1,0,7,3,4,10,peru2
ADT,4,2,2,0,4,0,4,8,peru2
Alianza Lima,4,2,2,0,3,1,2,8,peru2
Cesar Vallejo,4,2,1,1,6,3,3,7,peru2
Sport Boys,4,2,1,1,5,4,1,7,peru2
D. Municipal,4,2,0,2,7,6,1,6,peru2
S. Cristal,4,2,0,2,6,5,1,6,peru2
Cienciano,4,2,0,2,5,6,-1,6,peru2
Sport Huancayo,4,2,0,2,3,4,-1,6,peru2
Atletico Grau,4,1,1,2,5,4,1,4,peru2
Cusco,4,1,1,2,7,7,0,4,peru2
Carlos Manucci,4,1,1,2,5,6,-1,4,peru2
Alianza A.,4,1,1,2,4,6,-2,4,peru2
D. Garcilaso,4,1,1,2,2,4,-2,4,peru2
Union Comercio,4,1,1,2,4,7,-3,4,peru2
AD Cantolao,4,1,1,2,2,6,-4,4,peru2
Cajamarca,4,0,3,1,3,6,-3,3,peru2
Binacional,4,0,1,3,6,9,-3,1,peru2
D. Coopsol,4,3,1,0,9,2,7,10,peru3
Comerciantes U.,4,3,1,0,9,3,6,10,peru3
Santa Rosa,4,3,0,1,20,4,16,9,peru3
Llacuabamba,4,2,2,0,10,2,8,8,peru3
A. Huanuco,4,2,1,1,3,2,1,7,peru3
Comerciantes,4,2,1,1,5,7,-2,7,peru3
Ayacucho,4,1,3,0,6,5,1,6,peru3
Santos FC,4,1,2,1,6,5,1,5,peru3
U. San Martin,4,1,1,2,3,4,-1,4,peru3
Alfonso Ugarte,4,0,3,1,1,4,-3,3,peru3
Carlos Stein,4,1,0,3,5,13,-8,3,peru3
Juan Aurich,4,0,2,2,1,4,-3,2,peru3
Huaral,4,0,1,3,3,7,-4,1,peru3
M. El Pirata,4,0,0,4,1,20,-19,0,peru3
Kaya,4,3,1,0,15,4,11,10,philippines
Mendiola,4,3,0,1,8,3,5,9,philippines
Stallion,4,3,0,1,8,3,5,9,philippines
Cebu FC,4,2,2,0,5,1,4,8,philippines
United City,4,1,2,1,7,7,0,5,philippines
Maharlika,4,1,0,3,5,8,-3,3,philippines
Azkals,4,0,0,4,0,12,-12,0,philippines
Znicz Pruszkow,4,4,0,0,5,1,4,12,poland2
Arka Gdynia,4,3,1,0,6,2,4,10,poland2
Chrobry Glogow,4,3,0,1,5,1,4,9,poland2
Stal Rzeszow,4,2,2,0,8,4,4,8,poland2
Motor Lublin,4,2,1,1,9,5,4,7,poland2
Wisla Krakow,4,2,1,1,8,4,4,7,poland2
Wisla Plock,4,2,1,1,6,4,2,7,poland2
Lechia Gdansk,4,2,1,1,3,1,2,7,poland2
Tychy,4,2,0,2,5,6,-1,6,poland2
Katowice,4,1,2,1,6,6,0,5,poland2
Odra Opole,4,1,1,2,4,4,0,4,poland2
T. Nieciecza,4,1,1,2,6,7,-1,4,poland2
Miedz Legnica,4,1,1,2,3,4,-1,4,poland2
Gornik Leczna,4,1,1,2,3,7,-4,4,poland2
Resovia Rzeszow,4,1,0,3,5,7,-2,3,poland2
Polonia Warszaw,4,0,2,2,2,6,-4,2,poland2
Podbeskidzie,4,0,1,3,1,6,-5,1,poland2
Z. Sosnowiec,4,0,1,3,1,9,-8,1,poland2
Zaglebie L. B,4,3,0,1,9,4,5,9,poland3
Hutnik Krakow,4,3,0,1,7,4,3,9,poland3
Lech Poznan B,4,3,0,1,5,3,2,9,poland3
Kalisz,4,2,1,1,10,8,2,7,poland3
K. Kolobrzeg,4,2,1,1,9,8,1,7,poland3
Chojniczanka,4,2,1,1,7,6,1,7,poland3
Pogon Siedlce,4,2,1,1,7,6,1,7,poland3
Polonia Bytom,4,2,1,1,7,6,1,7,poland3
Olimpia Elblag,4,2,0,2,9,7,2,6,poland3
Stalowa Wola,4,2,0,2,6,8,-2,6,poland3
Radunia Stezyca,4,2,0,2,5,8,-3,6,poland3
Sandecja Nowy,4,1,2,1,4,4,0,5,poland3
SKRA Czestochow,4,1,1,2,8,7,1,4,poland3
Jastrzebie,4,1,1,2,6,9,-3,4,poland3
Wisla Pulawy,4,0,3,1,6,7,-1,3,poland3
Stomil Olsztyn,4,1,0,3,3,4,-1,3,poland3
LKS Lodz B,4,1,0,3,7,9,-2,3,poland3
O. Grudziadz,4,0,1,3,3,7,-4,1,poland3
Sporting Braga,4,4,0,0,13,3,10,12,portugal
Moreirense,4,3,1,0,3,0,3,10,portugal
Estoril,4,3,0,1,10,3,7,9,portugal
FC Porto,4,3,0,1,8,3,5,9,portugal
Benfica,4,2,2,0,5,2,3,8,portugal
Farense,4,2,1,1,7,4,3,7,portugal
Rio Ave,4,1,3,0,6,4,2,6,portugal
Sporting CP,4,2,0,2,9,8,1,6,portugal
Guimaraes,4,2,0,2,6,6,0,6,portugal
Famalicao,4,1,2,1,4,5,-1,5,portugal
Arouca,4,1,1,2,6,5,1,4,portugal
Estrela Amadora,4,1,1,2,6,6,0,4,portugal
Vizela,4,1,1,2,3,5,-2,4,portugal
Portimonense,4,1,1,2,4,9,-5,4,portugal
Chaves,4,1,0,3,3,9,-6,3,portugal
Casa Pia,4,1,0,3,2,8,-6,3,portugal
Gil Vicente,4,0,2,2,6,10,-4,2,portugal
Boavista,4,0,0,4,2,12,-10,0,portugal
Santa Clara,4,4,0,0,9,4,5,12,portugal2
Tondela,4,3,0,1,8,4,4,9,portugal2
Nacional,4,3,0,1,6,3,3,9,portugal2
Academico Viseu,4,2,1,1,5,5,0,7,portugal2
Feirense,4,2,1,1,4,4,0,7,portugal2
FC Porto B,4,2,0,2,10,7,3,6,portugal2
Maritimo,4,2,0,2,7,4,3,6,portugal2
AVS,4,2,0,2,5,5,0,6,portugal2
Os Belenense,4,2,0,2,4,4,0,6,portugal2
Mafra,4,1,2,1,4,4,0,5,portugal2
Torreense,4,1,2,1,2,2,0,5,portugal2
Benfica B,4,1,1,2,3,4,-1,4,portugal2
Pacos Ferreira,4,1,1,2,3,5,-2,4,portugal2
Uniao de Leiria,4,1,1,2,1,3,-2,4,portugal2
Leixoes,4,0,3,1,0,1,-1,3,portugal2
Penafiel,4,1,0,3,4,8,-4,3,portugal2
Vilaverdense,4,1,0,3,2,7,-5,3,portugal2
Oliveirense,4,0,2,2,2,5,-3,2,portugal2
Al Sadd,4,4,0,0,15,0,15,12,qatar
Al Gharafa,4,2,2,0,9,7,2,8,qatar
Al Arabi,4,2,1,1,12,8,4,7,qatar
Umm Salal,4,2,1,1,6,4,2,7,qatar
Al Duhail,4,2,1,1,6,5,1,7,qatar
Al Wakrah,4,2,1,1,6,5,1,7,qatar
Al Shamal,4,2,1,1,5,6,-1,7,qatar
Al Rayyan,4,1,1,2,6,7,-1,4,qatar
Qatar SC,4,1,1,2,4,6,-2,4,qatar
Al Ahli Doha,4,1,0,3,5,9,-4,3,qatar
Al Muaidar,4,0,2,2,5,8,-3,2,qatar
Al Markhiya,4,0,1,3,1,12,-11,1,qatar
Univ. Craiova,4,3,0,1,6,3,3,9,romania
Voluntari,4,2,2,0,9,6,3,8,romania
Otelul,4,2,1,1,8,6,2,7,romania
Farul Constanta,4,2,1,1,9,8,1,7,romania
U. Cluj,4,2,1,1,6,5,1,7,romania
FCSB,4,2,1,1,4,4,0,7,romania
P. Iasi,4,1,2,1,6,6,0,5,romania
Sepsi OSK,4,1,2,1,3,3,0,5,romania
Hermannstadt,4,1,2,1,3,4,-1,5,romania
Petrolul,4,1,2,1,3,4,-1,5,romania
U Craiova 1948,4,1,1,2,5,6,-1,4,romania
UTA Arad,4,1,1,2,4,5,-1,4,romania
Botosani,4,0,3,1,5,6,-1,3,romania
CFR Cluj,4,0,3,1,4,5,-1,3,romania
Rapid Bucharest,4,0,2,2,3,5,-2,2,romania
Din. Bucharest,4,0,0,4,2,6,-4,0,romania
Lokomotiv M.,4,3,1,0,10,5,5,10,russia
Dinamo Moscow,4,3,1,0,7,3,4,10,russia
Spartak Moscow,4,3,0,1,8,3,5,9,russia
Rubin Kazan,4,3,0,1,4,1,3,9,russia
Zenit,4,2,1,1,6,4,2,7,russia
Krylya Sovetov,4,2,1,1,8,7,1,7,russia
FC Krasnodar,4,2,1,1,5,5,0,7,russia
Akhmat Grozny,4,1,2,1,4,4,0,5,russia
CSKA Moscow,4,1,1,2,5,5,0,4,russia
Nizhny Novgorod,4,1,1,2,1,2,-1,4,russia
Rostov,4,1,1,2,2,4,-2,4,russia
Fakel Voronezh,4,0,3,1,2,3,-1,3,russia
Ural,4,1,0,3,4,7,-3,3,russia
Orenburg,4,0,2,2,3,6,-3,2,russia
Baltika,4,0,2,2,0,3,-3,2,russia
PFC Sochi,4,0,1,3,1,8,-7,1,russia
Arsenal Tula,4,4,0,0,8,0,8,12,russia2
Makhachkala,4,3,0,1,6,3,3,9,russia2
Leningradets,4,3,0,1,4,2,2,9,russia2
Khimki,4,2,2,0,9,4,5,8,russia2
Rodina Moskva,4,2,1,1,7,3,4,7,russia2
V. Astrakhan,4,2,1,1,5,2,3,7,russia2
Urozhay,4,2,1,1,5,5,0,7,russia2
Tyumen,4,2,0,2,6,4,2,6,russia2
Akron,4,1,2,1,6,5,1,5,russia2
Neftekhimik,4,1,2,1,1,1,0,5,russia2
Kamaz,4,1,2,1,4,5,-1,5,russia2
Torpedo Moscow,4,1,2,1,3,4,-1,5,russia2
Yenisey,4,1,0,3,6,8,-2,3,russia2
A. Vladikavkaz,4,0,3,1,6,9,-3,3,russia2
Shinnik,4,0,3,1,6,9,-3,3,russia2
SKA Khabarovsk,4,0,2,2,1,4,-3,2,russia2
Sokol Saratov,4,0,1,3,1,8,-7,1,russia2
Chernomorets,4,0,0,4,1,9,-8,0,russia2
Al Hilal,4,4,0,0,16,1,15,12,saudiarabia
Damak,4,3,1,0,13,7,6,10,saudiarabia
Al Nassr,4,3,0,1,10,5,5,9,saudiarabia
Al Ittihad,4,2,1,1,10,8,2,7,saudiarabia
Al Raed,4,2,1,1,7,5,2,7,saudiarabia
Al Ahli Jeddah,4,1,3,0,8,2,6,6,saudiarabia
Al Taawon,4,2,0,2,7,6,1,6,saudiarabia
Al Khaleej,4,2,0,2,9,9,0,6,saudiarabia
Al Wahda,4,2,0,2,6,6,0,6,saudiarabia
Al Tai,4,2,0,2,7,8,-1,6,saudiarabia
Al Akhdoud,4,2,0,2,3,6,-3,6,saudiarabia
Al Riyadh,4,1,2,1,4,6,-2,5,saudiarabia
Al Feiha,4,1,1,2,4,8,-4,4,saudiarabia
Al Hazm,4,1,1,2,3,11,-8,4,saudiarabia
Al Ittifaq,4,0,3,1,1,2,-1,3,saudiarabia
Al Shabab,4,0,2,2,2,4,-2,2,saudiarabia
Al Fateh,4,0,1,3,1,5,-4,1,saudiarabia
Abha,4,0,0,4,5,17,-12,0,saudiarabia
Al Kholood,4,3,0,1,7,4,3,9,saudiarabia2
Al Batin,4,2,2,0,2,0,2,8,saudiarabia2
Al Najma,4,2,1,1,10,8,2,7,saudiarabia2
Jeddah,4,2,1,1,10,8,2,7,saudiarabia2
Al Adalh,4,2,1,1,7,5,2,7,saudiarabia2
Al Jabalain,4,2,1,1,5,3,2,7,saudiarabia2
Ohod,4,2,1,1,4,2,2,7,saudiarabia2
Al Quadisiya,4,2,1,1,7,6,1,7,saudiarabia2
Al Safa,4,2,0,2,5,4,1,6,saudiarabia2
Al Orubah,4,2,0,2,6,7,-1,6,saudiarabia2
Al Faisaly,4,2,0,2,4,5,-1,6,saudiarabia2
Al-Jndal,4,1,2,1,2,3,-1,5,saudiarabia2
Al Arabi,4,1,1,2,6,5,1,4,saudiarabia2
Hajer,4,0,4,0,2,2,0,4,saudiarabia2
Al Bukayriyah,4,0,3,1,4,5,-1,3,saudiarabia2
Al Qaisoma,4,1,0,3,7,11,-4,3,saudiarabia2
Al-Ain,4,0,2,2,2,5,-3,2,saudiarabia2
Al Taraji,4,0,0,4,2,9,-7,0,saudiarabia2
Rangers,4,3,1,0,7,2,5,10,scotland
Hibernian,4,3,0,1,6,5,1,9,scotland
Celtic,4,2,1,1,9,5,4,7,scotland
Ross County,4,2,1,1,4,2,2,7,scotland
Kilmarnock,4,2,1,1,3,2,1,7,scotland
Hearts,4,2,0,2,3,3,0,6,scotland
Dundee FC,4,1,1,2,9,8,1,4,scotland
Aberdeen,4,1,1,2,3,5,-2,4,scotland
St. Johnstone,4,1,1,2,3,5,-2,4,scotland
St. Mirren,4,1,0,3,2,4,-2,3,scotland
Motherwell,4,0,3,1,5,8,-3,3,scotland
Livingston,4,0,0,4,0,5,-5,0,scotland
Dundee Utd,4,3,1,0,6,2,4,10,scotland2
Raith Rovers,4,3,1,0,10,7,3,10,scotland2
Partick Thistle,4,3,0,1,10,7,3,9,scotland2
Inverness,4,2,1,1,9,5,4,7,scotland2
Dunfermline,4,2,1,1,7,4,3,7,scotland2
Airdrieonians,4,1,1,2,5,5,0,4,scotland2
Greenock Morton,4,1,0,3,5,7,-2,3,scotland2
Ayr Utd,4,0,2,2,5,8,-3,2,scotland2
Queen`s Park,4,0,2,2,7,11,-4,2,scotland2
Arbroath,4,0,0,4,2,10,-8,0,scotland2
Cove Rangers,4,4,0,0,8,2,6,12,scotland3
Hamilton,4,3,1,0,12,1,11,10,scotland3
Falkirk,4,2,2,0,5,3,2,8,scotland3
Alloa Athletic,4,2,1,1,3,3,0,7,scotland3
Kelty Hearts,4,1,1,2,6,6,0,4,scotland3
Edinburgh City,4,1,0,3,6,10,-4,3,scotland3
Queen of South,4,1,0,3,5,10,-5,3,scotland3
Stirling Albion,4,1,0,3,4,11,-7,3,scotland3
Annan Athletic,4,0,2,2,5,8,-3,2,scotland3
Montrose,4,0,2,2,2,6,-4,2,scotland3
Stenhousemuir,4,4,0,0,7,0,7,12,scotland4
Dumbarton,4,3,0,1,6,1,5,9,scotland4
Peterhead,4,2,1,1,6,6,0,7,scotland4
East Fife,4,2,0,2,10,5,5,6,scotland4
Spartans,4,2,0,2,6,6,0,6,scotland4
Elgin City,4,2,0,2,3,5,-2,6,scotland4
Forfar Athletic,4,1,1,2,3,3,0,4,scotland4
Bonnyrigg Rose,4,1,1,2,5,6,-1,4,scotland4
Stranraer,4,0,2,2,5,9,-4,2,scotland4
Clyde,4,0,2,2,4,9,-5,2,scotland4
Red Star,4,4,0,0,8,3,5,12,serbia
Novi Pazar,4,3,0,1,7,1,6,9,serbia
Cukaricki,4,3,0,1,8,3,5,9,serbia
Partizan,4,3,0,1,6,6,0,9,serbia
Backa Topola,4,2,1,1,6,2,4,7,serbia
Mladost Lucani,4,2,1,1,4,4,0,7,serbia
Javor Ivanjica,4,2,0,2,7,4,3,6,serbia
Z. Pancevo,4,2,0,2,5,5,0,6,serbia
Napredak,4,2,0,2,4,4,0,6,serbia
S. Subotica,4,2,0,2,3,4,-1,6,serbia
Vojvodina,4,1,1,2,6,8,-2,4,serbia
Vozdovac,4,1,1,2,5,8,-3,4,serbia
Radnicki 1923,4,1,1,2,4,8,-4,4,serbia
IMT N. Beograd,4,1,0,3,1,6,-5,3,serbia
R. Surdulica,4,0,2,2,3,5,-2,2,serbia
Radnicki Nis,4,0,1,3,1,5,-4,1,serbia
OFK Beograd,4,4,0,0,8,1,7,12,serbia2
Indija,4,4,0,0,6,1,5,12,serbia2
Metalac GM,4,2,1,1,6,5,1,7,serbia2
S. Mitrovica,4,2,1,1,4,3,1,7,serbia2
Graficar,4,2,0,2,7,7,0,6,serbia2
Macva Sabac,4,2,0,2,4,4,0,6,serbia2
Dubocica,4,1,2,1,3,3,0,5,serbia2
Jedinstvo Ub,4,1,2,1,5,6,-1,5,serbia2
OFK Vrac,4,1,1,2,4,4,0,4,serbia2
Tekstilac Odzac,4,1,1,2,4,5,-1,4,serbia2
Smederevo,4,1,1,2,3,4,-1,4,serbia2
Mladost Novi S.,4,1,1,2,3,6,-3,4,serbia2
Sloboda Uzice,4,0,2,2,0,2,-2,2,serbia2
Radnicki B.,4,0,2,2,6,9,-3,2,serbia2
Kolubara,4,0,2,2,3,6,-3,2,serbia2
Novi Sad,4,0,2,2,3,6,-3,2,serbia2
A. Niigata (S),4,4,0,0,19,4,15,12,singapore
Lion City,4,4,0,0,21,7,14,12,singapore
DPMM FC,4,1,2,1,5,4,1,5,singapore
Tanjong Pagar,4,1,2,1,9,9,0,5,singapore
Tampines Rovers,4,1,1,2,10,14,-4,4,singapore
Hougang,4,1,1,2,6,16,-10,4,singapore
Khalsa,4,1,0,3,10,15,-5,3,singapore
Geylang,4,1,0,3,7,15,-8,3,singapore
Young Lions,4,0,0,4,4,14,-10,0,singapore
S. Bratislava,4,3,1,0,11,2,9,10,slovakia
Zilina,4,3,1,0,4,1,3,10,slovakia
Spartak Trnava,4,3,0,1,6,2,4,9,slovakia
Ruzomberok,4,2,2,0,6,4,2,8,slovakia
Banska Bystrica,4,2,1,1,7,3,4,7,slovakia
DAC Streda,4,1,3,0,4,1,3,6,slovakia
Podbrezova,4,2,0,2,5,9,-4,6,slovakia
FC Kosice,4,1,1,2,3,5,-2,4,slovakia
Trencin,4,0,2,2,1,3,-2,2,slovakia
Z. Michalovce,4,0,1,3,3,8,-5,1,slovakia
Zlate Moravce,4,0,1,3,2,8,-6,1,slovakia
Skalica,4,0,1,3,1,7,-6,1,slovakia
Petrzalka,4,4,0,0,13,4,9,12,slovakia2
P. Bystrica,4,3,1,0,10,3,7,10,slovakia2
Tatran Presov,4,3,1,0,7,0,7,10,slovakia2
OFK Malzenice,4,2,1,1,9,5,4,7,slovakia2
Zilina B,4,2,1,1,6,3,3,7,slovakia2
Komarno,4,2,1,1,4,4,0,7,slovakia2
Samorin,4,2,0,2,13,11,2,6,slovakia2
Pohronie,4,2,0,2,12,12,0,6,slovakia2
L. Mikulas,4,2,0,2,7,9,-2,6,slovakia2
Futura Humenne,4,1,2,1,5,3,2,5,slovakia2
Spartak Myjava,4,1,1,2,6,8,-2,4,slovakia2
Puchov,4,1,0,3,5,15,-10,3,slovakia2
Slavoj Trebisov,4,0,2,2,4,7,-3,2,slovakia2
S. Bratislava B,4,0,1,3,4,12,-8,1,slovakia2
Spisska Nova V.,4,0,0,4,2,8,-6,0,slovakia2
Dolny Kubin,4,0,0,4,1,11,-10,0,slovakia2
NK Celje,4,4,0,0,10,1,9,12,slovenia
Domzale,4,3,0,1,10,2,8,9,slovenia
NK Olimpija,4,2,1,1,8,6,2,7,slovenia
Bravo,4,2,1,1,6,5,1,7,slovenia
Mura,4,2,1,1,4,3,1,7,slovenia
Maribor,4,1,2,1,6,5,1,5,slovenia
Aluminij,4,1,1,2,5,11,-6,4,slovenia
Rogaska,4,1,0,3,7,9,-2,3,slovenia
Koper,4,0,1,3,7,11,-4,1,slovenia
Radomlje,4,0,0,4,1,12,-11,0,slovenia
Mamelodi S.,4,4,0,0,7,1,6,12,southafrica
Stellenbosch,4,3,1,0,5,0,5,10,southafrica
Orlando Pirates,4,3,1,0,4,0,4,10,southafrica
Cape Town City,4,3,0,1,5,2,3,9,southafrica
Kaizer Chiefs,4,3,0,1,5,3,2,9,southafrica
Royal AM,4,3,0,1,6,5,1,9,southafrica
Sekhukhune,4,2,0,2,4,4,0,6,southafrica
AmaZulu,4,1,1,2,4,4,0,4,southafrica
Richards Bay,4,1,1,2,4,5,-1,4,southafrica
Chippa Utd,4,1,1,2,3,4,-1,4,southafrica
SuperSport Utd,4,1,1,2,5,7,-2,4,southafrica
Moroka Swallows,4,1,1,2,1,3,-2,4,southafrica
TS Galaxy,4,1,0,3,5,5,0,3,southafrica
Polokwane,4,0,2,2,1,5,-4,2,southafrica
Cape Town Spurs,4,0,0,4,3,9,-6,0,southafrica
Golden Arrows,4,0,0,4,1,7,-6,0,southafrica
Pretoria U.,4,3,1,0,7,2,5,10,southafrica2
Upington City,4,3,1,0,7,2,5,10,southafrica2
Casric Stars,4,2,2,0,13,6,7,8,southafrica2
Baroka,4,2,1,1,7,4,3,7,southafrica2
NB La Masia,4,2,1,1,6,4,2,7,southafrica2
Black Leopards,4,2,1,1,6,6,0,7,southafrica2
Pretoria C.,4,2,0,2,7,7,0,6,southafrica2
Magesi,4,1,2,1,6,6,0,5,southafrica2
Tshakhuma,4,1,1,2,9,10,-1,4,southafrica2
Platinum City,4,1,1,2,3,4,-1,4,southafrica2
Hungry Lions,4,1,1,2,5,7,-2,4,southafrica2
Venda FC,4,1,1,2,4,6,-2,4,southafrica2
Milford,4,1,1,2,2,5,-3,4,southafrica2
Orbit College,4,1,1,2,4,9,-5,4,southafrica2
Maritzburg Utd,4,0,2,2,4,8,-4,2,southafrica2
JDR Stars,4,0,1,3,5,9,-4,1,southafrica2
Ulsan,4,3,0,1,7,5,2,9,southkorea
Gangwon,4,2,2,0,4,1,3,8,southkorea
Suwon Bluewings,4,2,2,0,6,4,2,8,southkorea
Incheon Utd,4,2,1,1,7,4,3,7,southkorea
Daejeon Citizen,4,1,2,1,6,5,1,5,southkorea
Jeonbuk Motors,4,1,2,1,4,3,1,5,southkorea
Seoul,4,1,2,1,6,6,0,5,southkorea
Pohang Steelers,4,1,2,1,4,4,0,5,southkorea
Daegu,4,1,1,2,3,5,-2,4,southkorea
Jeju Utd,4,0,3,1,2,4,-2,3,southkorea
Gwangju,4,0,2,2,1,5,-4,2,southkorea
Suwon City,4,0,1,3,6,10,-4,1,southkorea
Gimcheon Sangmu,4,3,1,0,11,4,7,10,southkorea2
Anyang,4,3,1,0,9,4,5,10,southkorea2
Gyeongnam,4,2,2,0,7,4,3,8,southkorea2
Busan IPark,4,2,1,1,5,6,-1,7,southkorea2
Jeonnam Dragons,4,2,0,2,8,6,2,6,southkorea2
Chungnam Asan,4,2,0,2,6,5,1,6,southkorea2
Seongnam,4,2,0,2,5,5,0,6,southkorea2
Cheongju,4,1,2,1,3,5,-2,5,southkorea2
Bucheon FC,4,1,1,2,7,7,0,4,southkorea2
Cheonan City,4,1,1,2,4,5,-1,4,southkorea2
Gimpo,4,1,1,2,2,4,-2,4,southkorea2
Ansan Greeners,4,1,0,3,9,14,-5,3,southkorea2
Seoul E-Land,4,0,0,4,1,9,-8,0,southkorea2
Real Madrid,4,3,1,0,11,2,9,10,spain
Athletic Bilbao,4,3,1,0,12,6,6,10,spain
Real Sociedad,4,3,1,0,9,3,6,10,spain
Girona,4,3,1,0,9,5,4,10,spain
Atletico Madrid,4,3,0,1,6,3,3,9,spain
Las Palmas,4,2,1,1,4,2,2,7,spain
FC Barcelona,4,2,1,1,6,6,0,7,spain
Getafe,4,2,1,1,4,4,0,7,spain
Real Betis,4,1,3,0,3,2,1,6,spain
Mallorca,4,1,2,1,2,2,0,5,spain
Alaves,4,1,1,2,4,4,0,4,spain
Villarreal,4,1,1,2,5,8,-3,4,spain
Celta Vigo,4,0,3,1,5,6,-1,3,spain
Osasuna,4,0,3,1,4,6,-2,3,spain
Cadiz,4,0,3,1,3,6,-3,3,spain
Sevilla FC,4,0,2,2,3,5,-2,2,spain
Rayo Vallecano,4,0,2,2,2,7,-5,2,spain
Almeria,4,0,1,3,3,7,-4,1,spain
Granada,4,0,1,3,2,7,-5,1,spain
Valencia,4,0,1,3,2,8,-6,1,spain
Racing,4,2,2,0,8,4,4,8,spain2
Cartagena,4,2,2,0,5,3,2,8,spain2
Albacete,4,2,1,1,8,6,2,7,spain2
Real Oviedo,4,2,1,1,7,5,2,7,spain2
Espanyol,4,2,1,1,5,3,2,7,spain2
Valladolid,4,2,1,1,5,4,1,7,spain2
Elche,4,2,0,2,5,4,1,6,spain2
Mirandes,4,1,3,0,4,3,1,6,spain2
FC Andorra,4,1,3,0,3,2,1,6,spain2
Huesca,4,2,0,2,3,2,1,6,spain2
Burgos,4,1,3,0,2,1,1,6,spain2
Sporting Gijon,4,1,2,1,2,1,1,5,spain2
Racing Ferrol,4,1,2,1,8,8,0,5,spain2
Eibar,4,1,1,2,6,6,0,4,spain2
Tenerife,4,1,1,2,4,4,0,4,spain2
Real Zaragoza,4,1,1,2,2,4,-2,4,spain2
Levante,4,1,1,2,5,8,-3,4,spain2
Villarreal B,4,1,1,2,1,4,-3,4,spain2
Leganes,4,0,3,1,4,5,-1,3,spain2
Amorebieta,4,1,0,3,3,5,-2,3,spain2
Eldense,4,0,2,2,3,8,-5,2,spain2
Alcorcon,4,0,1,3,2,8,-6,1,spain2
Sirius,4,3,1,0,11,6,5,10,sweden
Malmo FF,4,3,0,1,9,4,5,9,sweden
Elfsborg,4,2,1,1,7,4,3,7,sweden
Varnamo,4,2,1,1,7,5,2,7,sweden
Mjallby,4,2,1,1,6,5,1,7,sweden
Hacken,4,2,0,2,10,7,3,6,sweden
Halmstad,4,1,3,0,7,4,3,6,sweden
Brommapojkarna,4,2,0,2,7,7,0,6,sweden
Kalmar,4,2,0,2,6,8,-2,6,sweden
AIK,4,1,2,1,5,6,-1,5,sweden
Hammarby,4,0,4,0,4,4,0,4,sweden
Djurgarden,4,1,1,2,5,7,-2,4,sweden
IFK Goteborg,4,1,1,2,5,7,-2,4,sweden
Norrkoping,4,1,0,3,5,10,-5,3,sweden
Degerfors,4,0,2,2,5,8,-3,2,sweden
Varberg BoIS,4,0,1,3,5,12,-7,1,sweden
Oster,4,3,0,1,8,3,5,9,sweden2
Skovde AIK,4,2,2,0,7,4,3,8,sweden2
Utsikten,4,2,1,1,3,3,0,7,sweden2
GIF Sundsvall,4,2,1,1,3,5,-2,7,sweden2
Brage,4,2,0,2,8,3,5,6,sweden2
Trelleborg,4,1,3,0,5,3,2,6,sweden2
Ostersunds,4,2,0,2,8,7,1,6,sweden2
GAIS,4,2,0,2,5,4,1,6,sweden2
Orgryte,4,2,0,2,3,4,-1,6,sweden2
Vasteras,4,2,0,2,3,4,-1,6,sweden2
Helsingborg,4,1,2,1,2,1,1,5,sweden2
AFC Eskilstuna,4,1,2,1,6,7,-1,5,sweden2
Gefle,4,0,4,0,4,4,0,4,sweden2
Orebro,4,1,0,3,7,8,-1,3,sweden2
Jonkopings,4,0,2,2,4,10,-6,2,sweden2
Landskrona,4,0,1,3,4,10,-6,1,sweden2
Grasshopper,4,3,0,1,11,4,7,9,switzerland
Lugano,4,3,0,1,9,4,5,9,switzerland
Servette,4,2,2,0,8,3,5,8,switzerland
FC Zurich,4,2,1,1,7,4,3,7,switzerland
FC Basel,4,2,1,1,6,3,3,7,switzerland
BSC Young Boys,4,2,1,1,6,4,2,7,switzerland
St. Gallen,4,2,0,2,8,7,1,6,switzerland
Lausanne Sport,4,1,2,1,4,8,-4,5,switzerland
Luzern,4,1,1,2,5,9,-4,4,switzerland
Yverdon,4,1,1,2,4,12,-8,4,switzerland
Lausanne Ouchy,4,0,1,3,2,5,-3,1,switzerland
Winterthur,4,0,0,4,5,13,-8,0,switzerland
Foutoua,4,3,1,0,8,3,5,10,syria
Taliya,4,3,0,1,5,4,1,9,syria
Al Jaish,4,2,1,1,7,4,3,7,syria
Jabala,4,2,1,1,5,2,3,7,syria
Hottin,4,2,0,2,7,5,2,6,syria
Teshrin,4,1,2,1,4,4,0,5,syria
Karama,4,1,2,1,3,3,0,5,syria
Al Ittihad,4,1,2,1,5,7,-2,5,syria
Wathbah,4,1,1,2,5,5,0,4,syria
Al Sahel,4,1,1,2,3,3,0,4,syria
Al Wahda,4,1,1,2,2,4,-2,4,syria
Horriya,4,0,0,4,1,11,-10,0,syria
Azam,4,4,0,0,16,1,15,12,tanzania
Young Africans,4,4,0,0,11,3,8,12,tanzania
Singida,4,3,1,0,9,5,4,10,tanzania
Coastal Union,4,3,0,1,6,3,3,9,tanzania
Namungo,4,3,0,1,4,1,3,9,tanzania
T. Prisons,4,2,1,1,3,1,2,7,tanzania
Geita Gold,4,2,1,1,3,3,0,7,tanzania
Simba,4,2,1,1,6,8,-2,7,tanzania
JKT Tanzania,4,1,2,1,5,5,0,5,tanzania
Tabora,4,1,2,1,4,4,0,5,tanzania
Kagera Sugar,4,1,2,1,3,3,0,5,tanzania
Ihefu,4,1,2,1,3,4,-1,5,tanzania
KMC,4,1,1,2,5,10,-5,4,tanzania
Dodoma Jiji,4,1,0,3,3,5,-2,3,tanzania
Mashujaa,4,0,1,3,4,9,-5,1,tanzania
Mtibwa Sugar,4,0,0,4,2,10,-8,0,tanzania
Bangkok Utd,4,3,1,0,8,1,7,10,thailand
Pathum Utd,4,3,1,0,8,4,4,10,thailand
Lamphun Warrior,4,2,2,0,9,6,3,8,thailand
Sukhothai,4,2,2,0,7,4,3,8,thailand
Buriram Utd,4,1,3,0,6,3,3,6,thailand
Uthai Thani,4,1,2,1,5,5,0,5,thailand
Nakhon Pathom,4,1,2,1,5,7,-2,5,thailand
Ratchaburi,4,1,1,2,5,4,1,4,thailand
Trat,4,1,1,2,7,7,0,4,thailand
Port FC,4,1,1,2,5,6,-1,4,thailand
Muang Thong Utd,4,1,1,2,6,9,-3,4,thailand
Police Tero,4,1,1,2,5,8,-3,4,thailand
Chiangrai Utd,4,0,3,1,2,5,-3,3,thailand
Khon Kaen Utd,4,0,3,1,6,10,-4,3,thailand
Prachuap,4,0,0,4,1,6,-5,0,thailand
Chonburi,4,0,0,4,3,9,-6,0,thailand
N. Bua Pitchaya,4,3,1,0,10,3,7,10,thailand2
Chiangmai FC,4,3,0,1,9,3,6,9,thailand2
Nakhon Si Thamm,4,2,2,0,10,3,7,8,thailand2
Pattaya United,4,2,2,0,9,4,5,8,thailand2
Rayong,4,2,2,0,7,3,4,8,thailand2
N. Ratchasima,4,2,1,1,8,6,2,7,thailand2
Kanchanaburi,4,1,3,0,6,4,2,6,thailand2
Samut Prakan,4,2,0,2,8,9,-1,6,thailand2
Chainat,4,2,0,2,6,7,-1,6,thailand2
Chanthaburi,4,1,2,1,3,3,0,5,thailand2
Krabi,4,1,2,1,1,2,-1,5,thailand2
Chiangmai Utd,4,1,1,2,4,8,-4,4,thailand2
Phrae Utd,4,1,1,2,3,8,-5,4,thailand2
Ayutthaya Utd,4,0,3,1,3,5,-2,3,thailand2
Kasetsart,4,1,0,3,3,7,-4,3,thailand2
Lampang,4,1,0,3,2,6,-4,3,thailand2
Customs Utd,4,0,1,3,3,8,-5,1,thailand2
Suphanburi,4,0,1,3,2,8,-6,1,thailand2
Fenerbahce,4,3,1,0,9,3,6,10,turkey
Kayserispor,4,3,1,0,8,4,4,10,turkey
Galatasaray,4,3,0,1,10,3,7,9,turkey
Antalyaspor,4,2,2,0,9,4,5,8,turkey
Trabzonspor,4,2,1,1,8,6,2,7,turkey
Besiktas,4,2,1,1,5,5,0,7,turkey
Rizespor,4,2,1,1,4,4,0,7,turkey
F. Karagumruk,4,2,0,2,8,4,4,6,turkey
Basaksehir,4,2,0,2,7,5,2,6,turkey
Samsunspor,4,2,0,2,8,7,1,6,turkey
Konyaspor,4,1,2,1,6,5,1,5,turkey
Ankaragucu,4,1,2,1,5,8,-3,5,turkey
Hatayspor,4,1,1,2,6,7,-1,4,turkey
Alanyaspor,4,1,1,2,3,9,-6,4,turkey
Gaziantep,4,1,0,3,6,8,-2,3,turkey
Kasimpasa,4,1,0,3,9,12,-3,3,turkey
Istanbulspor,4,1,0,3,2,6,-4,3,turkey
Pendikspor,4,1,0,3,2,8,-6,3,turkey
Adana Demirspor,4,0,2,2,4,7,-3,2,turkey
Sivasspor,4,0,2,2,5,11,-6,2,turkey
Eyupspor,4,4,0,0,16,2,14,12,turkey2
Sakaryaspor,4,3,1,0,11,6,5,10,turkey2
Corum,4,3,0,1,11,3,8,9,turkey2
Goztepe,4,3,0,1,10,3,7,9,turkey2
Umraniyespor,4,3,0,1,7,2,5,9,turkey2
Kocaelispor,4,3,0,1,9,5,4,9,turkey2
Bodrumspor,4,1,2,1,4,3,1,5,turkey2
Tuzlaspor,4,1,2,1,5,5,0,5,turkey2
Genclerbirligi,4,1,2,1,4,5,-1,5,turkey2
Erzurum BB,4,1,2,1,7,9,-2,5,turkey2
Manisa BB,4,1,1,2,5,5,0,4,turkey2
Bandirmaspor,4,1,1,2,3,5,-2,4,turkey2
Boluspor,4,1,1,2,4,7,-3,4,turkey2
Adanaspor,4,1,1,2,2,6,-4,4,turkey2
Sanliurfaspor,4,1,0,3,1,7,-6,3,turkey2
Keciorengucu,4,0,2,2,3,7,-4,2,turkey2
Giresunspor,4,0,0,4,3,13,-10,0,turkey2
Altay,4,0,0,4,1,15,-14,0,turkey2
Al Wasl,4,3,1,0,13,6,7,10,uae
Al Sharjah,4,2,2,0,13,5,8,8,uae
Al Wahda,4,2,2,0,8,4,4,8,uae
Shabab Al Ahli,4,2,1,1,13,7,6,7,uae
Ajman,4,2,1,1,8,4,4,7,uae
Al Ain,4,2,1,1,9,6,3,7,uae
Al Bataeh,4,2,1,1,8,8,0,7,uae
Al Khaleej,4,2,0,2,8,6,2,6,uae
Bani Yas,4,2,0,2,4,6,-2,6,uae
Ittihad Kalba,4,1,2,1,7,7,0,5,uae
Hatta,4,1,1,2,6,8,-2,4,uae
Al Jazira,4,1,1,2,8,11,-3,4,uae
Al Nasr,4,0,2,2,2,6,-4,2,uae
Emirates,4,0,0,4,5,19,-14,0,uae
Dynamo Kyiv,4,3,0,1,8,3,5,9,ukraine
LNZ Cherkasy,4,2,2,0,6,3,3,8,ukraine
Vorskla Poltava,4,2,2,0,4,2,2,8,ukraine
Dnipro-1,4,2,1,1,10,6,4,7,ukraine
Shakhtar,4,2,1,1,5,3,2,7,ukraine
Kryvbas KR,4,2,1,1,5,5,0,7,ukraine
Polessya,4,1,3,0,4,3,1,6,ukraine
Kolos Kovalivka,4,1,2,1,3,2,1,5,ukraine
Rukh Lviv,4,1,2,1,4,5,-1,5,ukraine
Oleksandria,4,1,1,2,2,3,-1,4,ukraine
Veres,4,1,1,2,5,7,-2,4,ukraine
Zorya Luhansk,4,0,3,1,5,6,-1,3,ukraine
Chornomorets,4,1,0,3,6,11,-5,3,ukraine
FC Minaj,4,0,2,2,0,3,-3,2,ukraine
Obolon,4,0,2,2,2,6,-4,2,ukraine
Metalist 1925,4,0,0,4,6,12,-6,0,ukraine
Nacional,4,3,1,0,10,2,8,10,uruguay
Penarol,4,3,1,0,7,2,5,10,uruguay
Liverpool M.,4,2,1,1,8,6,2,7,uruguay
La Luz,4,2,1,1,7,6,1,7,uruguay
Defensor S.,4,1,3,0,8,4,4,6,uruguay
Cerro Largo,4,1,3,0,4,3,1,6,uruguay
Cerro,4,1,3,0,3,2,1,6,uruguay
Fenix,4,2,0,2,5,5,0,6,uruguay
D. Maldonado,4,1,2,1,6,7,-1,5,uruguay
River Plate,4,1,2,1,5,7,-2,5,uruguay
Wanderers,4,1,1,2,3,5,-2,4,uruguay
Plaza Colonia,4,0,3,1,4,5,-1,3,uruguay
Boston River,4,0,3,1,5,7,-2,3,uruguay
Montevideo City,4,0,2,2,4,9,-5,2,uruguay
Racing CM,4,0,1,3,2,6,-4,1,uruguay
Danubio,4,0,1,3,3,8,-5,1,uruguay
AMGK,4,3,1,0,5,2,3,10,uzbekistan
Termez Surkhon,4,3,0,1,5,2,3,9,uzbekistan
Bunyodkor,4,3,0,1,6,6,0,9,uzbekistan
Neftchi,4,2,1,1,5,2,3,7,uzbekistan
Qizilqum,4,2,1,1,4,1,3,7,uzbekistan
Pakhtakor,4,2,1,1,6,5,1,7,uzbekistan
Nasaf Qarshi,4,1,3,0,3,2,1,6,uzbekistan
FK Olympic,4,2,0,2,4,4,0,6,uzbekistan
Andijan,4,2,0,2,4,5,-1,6,uzbekistan
Navbahor,4,1,1,2,5,4,1,4,uzbekistan
Sogdiana,4,1,1,2,1,3,-2,4,uzbekistan
Metallurg,4,1,0,3,2,5,-3,3,uzbekistan
Buxoro,4,0,0,4,0,4,-4,0,uzbekistan
Turan,4,0,0,4,2,9,-7,0,uzbekistan
D. Tachira,4,4,0,0,7,2,5,12,venezuela
Puerto Cabello,4,3,0,1,8,4,4,9,venezuela
Zamora,4,2,1,1,8,5,3,7,venezuela
Rayo Zuliano,4,2,1,1,3,2,1,7,venezuela
Portuguesa,4,2,1,1,6,6,0,7,venezuela
Angostura,4,2,0,2,6,5,1,6,venezuela
M. de Guayana,4,2,0,2,4,5,-1,6,venezuela
Carabobo,4,1,2,1,4,3,1,5,venezuela
UCV,4,1,2,1,5,5,0,5,venezuela
D. La Guaira,4,0,4,0,6,6,0,4,venezuela
Caracas,4,0,4,0,1,1,0,4,venezuela
E. Merida,4,1,1,2,5,7,-2,4,venezuela
Metropolitanos,4,1,1,2,7,10,-3,4,venezuela
H. Colmenares,4,0,2,2,2,5,-3,2,venezuela
Monagas,4,0,1,3,4,8,-4,1,venezuela
Thanh Hoa,4,3,1,0,9,4,5,10,vietnam
Nam Dinh,4,3,1,0,11,7,4,10,vietnam
Hai Phong,4,2,1,1,9,6,3,7,vietnam
Cong An Nhan,4,2,1,1,8,5,3,7,vietnam
Binh Duong,4,2,1,1,4,2,2,7,vietnam
Viettel,4,2,1,1,4,4,0,7,vietnam
Binh Dinh,4,2,0,2,6,6,0,6,vietnam
Ha Noi,4,2,0,2,3,3,0,6,vietnam
Ho Chi Minh,4,1,2,1,5,4,1,5,vietnam
Quang Nam,4,1,2,1,6,6,0,5,vietnam
S. Khanh Hoa,4,1,0,3,3,7,-4,3,vietnam
Song Lam Nghe,4,0,2,2,6,10,-4,2,vietnam
Hong Linh Ha T.,4,0,1,3,3,7,-4,1,vietnam
Gia Lai,4,0,1,3,3,9,-6,1,vietnam
Hue,4,3,1,0,6,1,5,10,vietnam2
Da Nang,4,2,2,0,8,2,6,8,vietnam2
Long An,4,2,1,1,9,4,5,7,vietnam2
Ba Ria Vung Tau,4,2,0,2,8,4,4,6,vietnam2
PVF-CAND,4,1,3,0,3,2,1,6,vietnam2
Hoa Binh,4,2,0,2,3,5,-2,6,vietnam2
Binh Phuoc,4,1,2,1,6,6,0,5,vietnam2
Phu Dong,4,1,2,1,4,4,0,5,vietnam2
Dong Thap,4,1,1,2,2,4,-2,4,vietnam2
Dong Nai,4,1,1,2,2,6,-4,4,vietnam2
Phu Tho,4,0,1,3,0,8,-8,1,vietnam2
Binh Thuan,0,0,0,0,0,0,0,0,vietnam2
The New Saints,4,4,0,0,13,2,11,12,wales
Cardiff MU,4,3,1,0,11,5,6,10,wales
Newtown,4,3,1,0,9,4,5,10,wales
Haverfordwest,4,2,2,0,9,3,6,8,wales
Bala Town,4,2,2,0,6,3,3,8,wales
Connah`s Quay,4,2,0,2,12,7,5,6,wales
Colwyn Bay,4,2,0,2,9,8,1,6,wales
Caernarfon Town,4,1,1,2,7,9,-2,4,wales
Barry Town,4,1,1,2,4,11,-7,4,wales
Penybont,4,0,2,2,3,6,-3,2,wales
Pontypridd Town,4,0,1,3,2,8,-6,1,wales
Aberystwyth,4,0,0,4,5,11,-6,0,wales
