Equipe,GP,W,D,L,GF,GA,GD,Pts,albania2
Apolonia Fier,5,3,1,1,9,3,6,10,albania2
Bylis,3,3,0,0,6,3,3,9,albania2
Flamurtari,4,2,2,0,7,2,5,8,albania2
AF Elbasani,5,2,1,2,5,5,0,7,albania2
Vora,4,2,0,2,7,7,0,6,albania2
Lushnja,4,1,1,2,5,5,0,4,albania2
Korabi Peshkopi,4,0,2,2,0,2,-2,2,albania2
Besa Kavaje,5,0,2,3,6,13,-7,2,albania2
Kastrioti Kruje,3,0,1,2,1,4,-3,1,albania2
Tomori Berat,3,0,1,2,3,10,-7,1,albania2
Luzi 2008,3,0,0,3,1,4,-3,0,albania2
Burreli,5,0,0,5,1,10,-9,0,albania2
Paradou AC,2,1,1,0,5,0,5,4,algeria
CR Belouizdad,1,1,0,0,3,0,3,3,algeria
JS Kabylie,2,1,0,1,2,2,0,3,algeria
US Souf,2,1,0,1,2,3,-1,3,algeria
Khenchela,2,1,0,1,3,5,-2,3,algeria
ASO Chlef,2,0,1,1,2,3,-1,1,algeria
NC Magra,2,0,1,1,0,1,-1,1,algeria
MC Oran,2,0,1,1,0,2,-2,1,algeria
JS Saoura,2,0,1,1,1,4,-3,1,algeria
MC Alger,1,0,0,1,1,2,-1,0,algeria
US Biskra,2,0,0,2,1,3,-2,0,algeria
CS Constantine,2,0,0,2,0,2,-2,0,algeria
USM Alger,2,0,0,2,0,2,-2,0,algeria
ES Setif,2,0,0,2,3,6,-3,0,algeria
El Bayadh,2,0,0,2,1,4,-3,0,algeria
Ben Aknoun,2,0,0,2,0,5,-5,0,algeria
Mostaganem,2,2,0,0,5,1,4,6,algeria2
Hussein Dey,2,1,1,0,2,1,1,4,algeria2
MSP Batna,2,1,1,0,2,1,1,4,algeria2
Khemis El K.,2,1,1,0,1,0,1,4,algeria2
GC Mascara,1,1,0,0,3,1,2,3,algeria2
ASM Oran,1,1,0,0,2,1,1,3,algeria2
RC Kouba,1,1,0,0,1,0,1,3,algeria2
Oued Akbou,2,1,0,1,4,4,0,3,algeria2
Koléa,2,1,0,1,1,1,0,3,algeria2
Tiaret,2,1,0,1,2,5,-3,3,algeria2
Mechria,2,0,2,0,1,1,0,2,algeria2
Bordj Menaïel,1,0,1,0,1,1,0,1,algeria2
MO Constantine,1,0,1,0,1,1,0,1,algeria2
CA Batna,1,0,1,0,0,0,0,1,algeria2
El Eulma,1,0,1,0,0,0,0,1,algeria2
Temouchent,1,0,1,0,0,0,0,1,algeria2
Khroub,2,0,1,1,1,2,-1,1,algeria2
WA Boufarik,2,0,1,1,1,2,-1,1,algeria2
Mlila,2,0,1,1,0,1,-1,1,algeria2
Chelghoum,2,0,1,1,1,3,-2,1,algeria2
El Ghozlane,2,0,1,1,1,3,-2,1,algeria2
Teleghma,0,0,0,0,0,0,0,0,algeria2
Oued Magrane,1,0,0,1,1,2,-1,0,algeria2
WA Mostaganem,1,0,0,1,0,1,-1,0,algeria2
Khemis Melina,2,0,0,2,3,5,-2,0,algeria2
El Harrach,2,0,0,2,2,4,-2,0,algeria2
Ghir Abadla,1,0,0,1,0,2,-2,0,algeria2
Oued Sly,1,0,0,1,0,2,-2,0,algeria2
RB Ouargla,1,0,0,1,0,2,-2,0,algeria2
FC Santa Coloma,3,2,0,1,7,2,5,6,andorra
UE Santa Coloma,2,2,0,0,3,0,3,6,andorra
Inter Escaldes,3,1,1,1,9,5,4,4,andorra
Penya Encarnada,2,1,1,0,2,1,1,4,andorra
Pas de la Casa,3,1,1,1,4,4,0,4,andorra
Carroi,2,1,0,1,1,4,-3,3,andorra
A. America,2,0,1,1,2,4,-2,1,andorra
Esperanca,2,0,0,2,2,4,-2,0,andorra
A. Escaldes,3,0,0,3,1,4,-3,0,andorra
Ordino,3,0,0,3,1,5,-4,0,andorra
T. de Cordoba,8,4,2,2,12,8,4,14,argentina
Argentinos Jrs,8,3,3,2,5,3,2,12,argentina
Estudiantes,8,3,3,2,8,8,0,12,argentina
A. Tucuman,8,3,2,3,8,8,0,11,argentina
Boca Juniors,8,3,2,3,8,9,-1,11,argentina
River Plate,8,2,4,2,13,11,2,10,argentina
Union Santa Fe,8,2,4,2,4,4,0,10,argentina
San Lorenzo,8,2,4,2,5,6,-1,10,argentina
Barracas C.,8,2,4,2,7,9,-2,10,argentina
Gimnasia,8,2,3,3,9,12,-3,9,argentina
Lanus,8,1,5,2,11,12,-1,8,argentina
Tigre,8,2,2,4,6,7,-1,8,argentina
Defensa y J.,8,2,2,4,8,11,-3,8,argentina
Racing Club,8,1,4,3,9,11,-2,7,argentina
Central Cordoba,8,1,4,3,8,11,-3,7,argentina
Godoy Cruz,8,1,4,3,6,9,-3,7,argentina
Sarmiento,8,2,1,5,4,10,-6,7,argentina
Newells,8,1,3,4,6,9,-3,6,argentina
Banfield,8,1,3,4,6,12,-6,6,argentina
Rosario Central,8,0,5,3,4,9,-5,5,argentina
Platense,8,1,2,5,5,11,-6,5,argentina
Independiente,8,1,2,5,6,13,-7,5,argentina
Huracan,8,1,1,6,1,7,-6,4,argentina
Velez Sarsfield,8,1,1,6,5,12,-7,4,argentina
Belgrano,8,1,1,6,2,12,-10,4,argentina
Instituto,8,1,1,6,6,17,-11,4,argentina
Colon Santa Fe,8,0,3,5,1,9,-8,3,argentina
Arsenal Sarandi,8,0,2,6,1,8,-7,2,argentina
Chacarita J.,8,5,1,2,8,6,2,16,argentina3
Quilmes,8,4,3,1,11,5,6,15,argentina3
A. Rafaela,8,4,2,2,14,10,4,14,argentina3
E. Rio Cuarto,8,4,1,3,6,4,2,13,argentina3
I. Rivadavia,8,3,3,2,8,6,2,12,argentina3
D. Riestra,8,3,3,2,6,5,1,12,argentina3
Deportivo Moron,8,3,2,3,9,10,-1,11,argentina3
CA Guemes,8,3,2,3,9,11,-2,11,argentina3
Almirante Brown,8,3,2,3,6,10,-4,11,argentina3
D. de Belgrano,8,3,1,4,10,10,0,10,argentina3
Nueva Chicago,8,3,1,4,7,7,0,10,argentina3
Temperley,8,2,4,2,8,9,-1,10,argentina3
Chaco For Ever,8,3,1,4,6,10,-4,10,argentina3
Agropecuario,8,2,3,3,6,8,-2,9,argentina3
Atletico Mitre,8,3,0,5,9,14,-5,9,argentina3
Alvarado,8,2,2,4,10,11,-1,8,argentina3
Deportivo Maipu,8,2,2,4,9,11,-2,8,argentina3
SM San Juan,8,2,2,4,8,11,-3,8,argentina3
Brown de A.,8,2,2,4,5,9,-4,8,argentina3
E. Caseros,8,1,4,3,8,11,-3,7,argentina3
SM Tucuman,8,1,4,3,5,8,-3,7,argentina3
San Telmo,8,2,1,5,5,9,-4,7,argentina3
D. Madryn,8,0,6,2,2,5,-3,6,argentina3
Tristan Suarez,8,1,3,4,9,14,-5,6,argentina3
Aldosivi,8,1,3,4,2,10,-8,6,argentina3
Racing Cordoba,8,1,2,5,8,13,-5,5,argentina3
Ferro Carril,8,1,2,5,7,13,-6,5,argentina3
All Boys,8,0,4,4,4,9,-5,4,argentina3
Atlanta,8,1,1,6,4,10,-6,4,argentina3
Pyunik,6,5,1,0,16,2,14,16,armenia
Urartu,8,4,1,3,15,14,1,13,armenia
Ararat-Armenia,6,3,2,1,13,7,6,11,armenia
Alashkert,6,3,0,3,14,11,3,9,armenia
Noah,7,3,0,4,12,11,1,9,armenia
BKMA,7,3,0,4,6,10,-4,9,armenia
Ararat Yerevan,6,2,1,3,7,9,-2,7,armenia
Shirak,6,2,0,4,8,11,-3,6,armenia
West Armenia,6,1,1,4,4,10,-6,4,armenia
Van,7,0,1,6,2,13,-11,1,armenia
Melbourne V.,1,1,0,0,2,0,2,3,australia
Western United,1,1,0,0,2,1,1,3,australia
Newcastle Jets,1,0,1,0,2,2,0,1,australia
Brisbane Roar,1,0,1,0,1,1,0,1,australia
Wellington,1,0,1,0,0,0,0,1,australia
Adelaide Utd,0,0,0,0,0,0,0,0,australia
Macarthur FC,0,0,0,0,0,0,0,0,australia
Melbourne City,0,0,0,0,0,0,0,0,australia
Western Sydney,0,0,0,0,0,0,0,0,australia
Perth Glory,1,0,0,1,1,2,-1,0,australia
Central Coast,1,0,0,1,0,3,-3,0,australia
Sydney FC,1,0,0,1,0,3,-3,0,australia
Salzburg,6,4,2,0,17,6,11,14,austria
Sturm Graz,5,4,1,0,9,3,6,13,austria
A. Klagenfurt,6,3,3,0,11,5,6,12,austria
Rapid Wien,5,2,2,1,11,3,8,8,austria
Hartberg,5,2,2,1,8,5,3,8,austria
Wolfsberger AC,5,1,4,0,8,7,1,7,austria
LASK Linz,5,2,1,2,6,6,0,7,austria
Austria Wien,6,2,0,4,6,8,-2,6,austria
Altach,6,1,3,2,5,7,-2,6,austria
BW Linz,6,2,0,4,7,14,-7,6,austria
Tirol,6,1,1,4,4,11,-7,4,austria
A. Lustenau,5,0,3,2,3,6,-3,3,austria
Grazer AK,7,5,1,1,12,9,3,16,austria2
Bregenz,6,4,0,2,12,5,7,12,austria2
Kapfenberger,7,3,2,2,11,11,0,11,austria2
St. Polten,5,3,1,1,11,7,4,10,austria2
Stripfing,6,3,1,2,9,5,4,10,austria2
Floridsdorfer,6,2,3,1,11,8,3,9,austria2
First Vienna,6,3,0,3,7,11,-4,9,austria2
Leoben,5,2,1,2,9,8,1,7,austria2
Ried,6,1,3,2,5,6,-1,6,austria2
Sturm Graz B,6,1,2,3,8,15,-7,5,austria2
Dornbirn,5,1,1,3,3,7,-4,4,austria2
Lafnitz,5,1,1,3,4,9,-5,4,austria2
Liefering,5,1,1,3,4,9,-5,4,austria2
Admira Wacker,6,0,3,3,8,11,-3,3,austria2
Amstetten,6,0,1,5,3,11,-8,1,austria2
SV Horn,6,0,0,6,4,17,-13,0,austria2
Neftci,7,3,2,2,8,6,2,11,azerbaijan
Sebail,4,3,1,0,8,2,6,10,azerbaijan
Turan,6,3,1,2,9,5,4,10,azerbaijan
Araz,5,2,1,2,8,6,2,7,azerbaijan
Qarabag,4,2,1,1,7,5,2,7,azerbaijan
Zira,5,2,1,2,3,3,0,7,azerbaijan
Sumqayit,6,2,1,3,8,12,-4,7,azerbaijan
Qabala,5,1,1,3,3,11,-8,4,azerbaijan
Kapaz,4,0,2,2,3,5,-2,2,azerbaijan
Sabah,4,0,1,3,2,6,-4,1,azerbaijan
Bashundhara K.,8,6,1,1,21,9,12,19,bangladesh
Mohammedan,8,6,0,2,18,6,12,18,bangladesh
B. Police,8,4,2,2,16,9,7,14,bangladesh
Abahani,8,3,2,3,16,9,7,11,bangladesh
Sheikh Russel,8,3,2,3,9,10,-1,11,bangladesh
Sheikh Jamal,8,2,4,2,7,10,-3,10,bangladesh
Fortis,8,2,3,3,12,15,-3,9,bangladesh
Rahmatgonj,8,2,3,3,9,15,-6,9,bangladesh
Chittagong,8,1,5,2,9,11,-2,8,bangladesh
Muktijoddha S.,8,2,1,5,7,18,-11,7,bangladesh
A. Uttara,8,0,2,6,4,21,-17,2,bangladesh
Neman Grodno,8,6,1,1,21,7,14,19,belarus
Dinamo Minsk,8,5,2,1,18,8,10,17,belarus
Isloch,8,5,1,2,9,7,2,16,belarus
T. Zhodino,8,4,3,1,9,4,5,15,belarus
BATE Borisov,8,4,2,2,10,5,5,14,belarus
Gomel,8,3,2,3,15,15,0,11,belarus
Slavia Mozyr,8,2,3,3,10,10,0,9,belarus
Dinamo Brest,8,3,0,5,9,15,-6,9,belarus
S. Soligorsk,8,1,4,3,12,14,-2,7,belarus
Energetik-BGU,8,1,4,3,7,11,-4,7,belarus
Naftan,8,2,1,5,11,16,-5,7,belarus
FC Minsk,8,2,1,5,4,10,-6,7,belarus
Slutsk,8,1,3,4,6,9,-3,6,belarus
Smorgon,8,1,2,5,11,16,-5,5,belarus
Belshina,8,0,2,6,9,26,-17,2,belarus
Arsenal D.,8,7,0,1,15,6,9,21,belarus2
Dnepr Mogilev,8,6,2,0,26,3,23,20,belarus2
Vitebsk,8,5,2,1,17,7,10,17,belarus2
FC Ostrovets,8,4,2,2,20,12,8,14,belarus2
Lokomotiv Gomel,8,4,2,2,9,9,0,14,belarus2
Lida,8,4,1,3,13,14,-1,13,belarus2
Maxline,8,4,0,4,22,18,4,12,belarus2
Zhodino Yuzhnoe,8,4,0,4,14,13,1,12,belarus2
Orsha,8,3,2,3,17,15,2,11,belarus2
Volna Pinsk,8,2,3,3,10,10,0,9,belarus2
Molodechno-DYuS,8,2,3,3,13,16,-3,9,belarus2
Niva,8,2,1,5,13,20,-7,7,belarus2
S.Petrikov,8,2,0,6,5,19,-14,6,belarus2
Baranovichi,8,1,2,5,5,14,-9,5,belarus2
Bumprom,8,1,1,6,5,18,-13,4,belarus2
Slonim,8,0,3,5,7,17,-10,3,belarus2
Osipovichy,8,0,1,7,5,22,-17,1,belarus2
Royale Union SG,5,4,0,1,10,6,4,12,belgium
KRC Genk,5,3,2,0,9,2,7,11,belgium
Gent,6,2,3,1,6,5,1,9,belgium
Standard Liege,5,2,2,1,7,5,2,8,belgium
Anderlecht,6,2,2,2,9,9,0,8,belgium
Club Brugge,6,2,1,3,9,6,3,7,belgium
Sint-Truiden,6,1,4,1,8,11,-3,7,belgium
Antwerp,6,1,3,2,8,7,1,6,belgium
Cercle Brugge,5,2,0,3,5,5,0,6,belgium
Eupen,6,2,0,4,7,12,-5,6,belgium
RWDM,6,1,2,3,6,13,-7,5,belgium
Westerlo,6,0,4,2,8,10,-2,4,belgium
OH Leuven,5,1,1,3,7,13,-6,4,belgium
KV Mechelen,6,1,1,4,5,13,-8,4,belgium
Charleroi,5,0,1,4,4,11,-7,1,belgium
Kortrijk,5,0,0,5,2,14,-12,0,belgium
I. Petrolero,8,5,0,3,8,6,2,15,bolivia
U. de Vinto,8,3,4,1,7,3,4,13,bolivia
Real Tomayapo,8,4,1,3,9,8,1,13,bolivia
Aurora,8,2,4,2,10,11,-1,10,bolivia
Always Ready,8,3,1,4,7,15,-8,10,bolivia
Oriente P.,8,2,2,4,14,15,-1,8,bolivia
The Strongest,8,2,2,4,10,15,-5,8,bolivia
Royal Pari,8,1,4,3,10,13,-3,7,bolivia
Wilstermann,8,1,3,4,7,9,-2,6,bolivia
Nacional Potosi,8,1,3,4,11,15,-4,6,bolivia
Santa Cruz,8,2,0,6,5,13,-8,6,bolivia
Vaca Diez,8,1,2,5,9,20,-11,5,bolivia
Bolivar,8,0,4,4,8,13,-5,4,bolivia
A. Palmaflor,8,1,1,6,4,19,-15,4,bolivia
Libertad,8,0,3,5,7,18,-11,3,bolivia
Blooming,8,0,1,7,3,15,-12,1,bolivia
Guabira,8,0,0,8,2,21,-19,0,bolivia
Atletico MG,8,4,2,2,9,4,5,14,brazil
Bragantino,8,4,2,2,10,8,2,14,brazil
Flamengo,8,4,2,2,12,11,1,14,brazil
Athletico PR,8,3,3,2,10,7,3,12,brazil
Botafogo,8,3,3,2,8,5,3,12,brazil
Palmeiras,8,3,2,3,10,6,4,11,brazil
Cruzeiro,8,3,2,3,8,8,0,11,brazil
Corinthians,8,2,4,2,10,10,0,10,brazil
Goias,8,2,3,3,11,13,-2,9,brazil
Cuiaba,8,3,0,5,6,9,-3,9,brazil
Bahia,8,2,1,5,10,16,-6,7,brazil
Internacional,8,1,3,4,4,9,-5,6,brazil
Fortaleza,8,2,0,6,4,11,-7,6,brazil
Santos,8,2,0,6,6,22,-16,6,brazil
Vasco da Gama,8,1,2,5,5,13,-8,5,brazil
America MG,8,0,4,4,11,17,-6,4,brazil
Coritiba,8,1,1,6,8,20,-12,4,brazil
Gremio,8,0,3,5,9,17,-8,3,brazil
Sao Paulo,8,0,3,5,4,14,-10,3,brazil
Fluminense,8,0,2,6,7,17,-10,2,brazil
CSKA Sofia,7,5,1,1,11,5,6,16,bulgaria
Lok. Plovdiv,7,4,3,0,14,9,5,15,bulgaria
Cherno More,8,3,4,1,14,8,6,13,bulgaria
CSKA 1948 Sofia,7,3,2,2,6,5,1,11,bulgaria
Ludogorets,6,3,1,2,10,5,5,10,bulgaria
Arda,7,3,1,3,7,4,3,10,bulgaria
Botev Plovdiv,8,2,3,3,10,10,0,9,bulgaria
Levski Sofia,6,2,2,2,10,8,2,8,bulgaria
Hebar,6,2,1,3,8,8,0,7,bulgaria
Beroe,8,2,1,5,7,17,-10,7,bulgaria
Pirin Blag.,7,2,0,5,5,14,-9,6,bulgaria
Lokomotiv Sofia,7,2,0,5,3,18,-15,6,bulgaria
Slavia Sofia,8,1,2,5,4,13,-9,5,bulgaria
Etar,7,1,1,5,4,13,-9,4,bulgaria
L. Krumovgrad,7,1,1,5,2,11,-9,4,bulgaria
Botev Vratsa,8,1,1,6,3,14,-11,4,bulgaria
Forge,8,5,1,2,15,8,7,16,canada
Cavalry,8,5,1,2,14,8,6,16,canada
York Utd,8,4,2,2,16,14,2,14,canada
A. Ottawa,8,4,0,4,10,8,2,12,canada
HFX Wanderers,8,2,3,3,9,9,0,9,canada
Valour,8,2,2,4,7,11,-4,8,canada
Pacific,8,2,1,5,10,14,-4,7,canada
Vancouver FC,8,2,0,6,6,14,-8,6,canada
Everton,8,5,1,2,12,8,4,16,chile
Union La Calera,8,4,2,2,14,10,4,14,chile
Palestino,8,4,2,2,13,10,3,14,chile
Nublense,8,4,1,3,12,9,3,13,chile
Huachipato,8,4,1,3,11,11,0,13,chile
O`Higgins,8,4,0,4,11,10,1,12,chile
Cobresal,8,3,3,2,10,12,-2,12,chile
Colo-Colo,8,1,6,1,6,6,0,9,chile
Audax Italiano,8,3,0,5,11,13,-2,9,chile
Curico Unido,8,2,3,3,7,12,-5,9,chile
U. Catolica,8,2,2,4,12,15,-3,8,chile
U. de Chile,8,2,1,5,9,15,-6,7,chile
Copiapo,8,1,3,4,6,9,-3,6,chile
Coquimbo Unido,8,1,3,4,9,13,-4,6,chile
Union Espanola,8,1,2,5,7,12,-5,5,chile
Magallanes,8,1,1,6,6,13,-7,4,chile
D. Iquique,8,4,4,0,13,7,6,16,chile2
S. Wanderers,8,4,2,2,9,8,1,14,chile2
S. Morning,8,3,3,2,11,8,3,12,chile2
San Luis,8,3,2,3,8,7,1,11,chile2
Barnechea,8,3,2,3,11,11,0,11,chile2
U. Concepcion,8,3,2,3,12,14,-2,11,chile2
Deportes Temuco,8,2,4,2,9,9,0,10,chile2
Antofagasta,8,3,1,4,12,13,-1,10,chile2
Cobreloa,8,2,3,3,12,14,-2,9,chile2
Puerto Montt,8,2,3,3,7,9,-2,9,chile2
La Serena,8,3,0,5,10,14,-4,9,chile2
Recoleta,8,2,2,4,9,11,-2,8,chile2
U. San Felipe,8,2,2,4,7,10,-3,8,chile2
Rangers,8,2,2,4,10,16,-6,8,chile2
CD Santa Cruz,8,2,1,5,8,10,-2,7,chile2
San Marcos,8,1,3,4,11,18,-7,6,chile2
Shanghai Port,8,5,1,2,20,8,12,16,china
Zhejiang,8,4,3,1,18,11,7,15,china
S. Taishan,8,4,3,1,10,5,5,15,china
Beijing Guoan,8,4,2,2,11,9,2,14,china
Wuhan Three T.,8,3,2,3,12,11,1,11,china
Tianjin T.,8,3,1,4,10,9,1,10,china
S. Shenhua,8,3,1,4,7,12,-5,10,china
Chengdu,8,2,2,4,10,12,-2,8,china
Nantong Zhiyun,8,1,4,3,8,12,-4,7,china
Changchun Yatai,8,1,2,5,5,13,-8,5,china
Meizhou Hakka,8,1,2,5,8,19,-11,5,china
Henan SL,8,1,1,6,7,17,-10,4,china
Cangzhou,8,1,1,6,4,22,-18,4,china
Qingdao Jonoon,8,0,2,6,5,13,-8,2,china
Dalian P.,8,0,2,6,5,16,-11,2,china
Shenzhen,8,0,1,7,6,26,-20,1,china
Sichuan Jiuniu,8,8,0,0,19,3,16,24,china2
Hebei Kungfu,8,4,2,2,10,5,5,14,china2
Jinan Xingzhou,8,3,4,1,10,7,3,13,china2
Dongguan United,8,4,0,4,10,12,-2,12,china2
Qingdao Y. I.,8,2,5,1,11,9,2,11,china2
Nanjing,8,1,6,1,4,6,-2,9,china2
Jiangxi L.,8,2,3,3,7,10,-3,9,china2
Guangxi Baoyun,8,1,5,2,5,7,-2,8,china2
Wuxi Wugou,8,2,2,4,11,18,-7,8,china2
Shanghai Jiadin,8,1,3,4,4,10,-6,6,china2
Guangzhou FC,8,2,0,6,9,16,-7,6,china2
Shenyang Urban,8,1,3,4,5,15,-10,6,china2
Dantong Hantong,8,1,2,5,3,9,-6,5,china2
Suzhou Dongwu,8,0,4,4,5,14,-9,4,china2
Heilongjiang L.,8,0,2,6,7,14,-7,2,china2
Yanbian Longdin,8,0,2,6,5,14,-9,2,china2
America de Cali,8,3,5,0,11,7,4,14,colombia2
Deportes Tolima,8,4,1,3,5,7,-2,13,colombia2
R. Aguilas,8,2,6,0,12,6,6,12,colombia2
I. Medelin,8,2,6,0,12,9,3,12,colombia2
Junior,8,3,2,3,10,6,4,11,colombia2
Millonarios,8,2,3,3,6,9,-3,9,colombia2
Union Magdalena,8,2,2,4,8,16,-8,8,colombia2
Santa Fe,8,1,4,3,10,14,-4,7,colombia2
A. Nacional,8,2,1,5,7,12,-5,7,colombia2
D. Pereira,8,2,1,5,7,12,-5,7,colombia2
A. Petrolera,8,2,1,5,3,10,-7,7,colombia2
La Equidad,8,1,3,4,6,13,-7,6,colombia2
A. Bucaramanga,8,1,2,5,4,11,-7,5,colombia2
Boyaca Chico,8,0,5,3,4,12,-8,5,colombia2
Once Caldas,8,1,1,6,7,12,-5,4,colombia2
Atletico Huila,8,1,1,6,4,10,-6,4,colombia2
Deportivo Pasto,8,1,1,6,3,13,-10,4,colombia2
Deportivo Cali,8,1,1,6,7,19,-12,4,colombia2
Envigado,8,0,2,6,5,17,-12,2,colombia2
Jaguares de C.,8,0,2,6,0,12,-12,2,colombia2
Alajuelense,8,5,2,1,14,10,4,17,costarica
Saprissa,8,5,1,2,16,10,6,16,costarica
Herediano,7,4,2,1,17,9,8,14,costarica
Guanacasteca,8,4,1,3,6,8,-2,13,costarica
Sporting SJ,8,3,2,3,10,11,-1,11,costarica
Cartagines,8,3,1,4,13,12,1,10,costarica
M. Liberia,8,2,2,4,15,18,-3,8,costarica
Santos DG,8,0,5,3,4,11,-7,5,costarica
Puntarenas,8,1,1,6,9,15,-6,4,costarica
Zeledon,8,1,1,6,4,20,-16,4,costarica
San Carlos,8,0,2,6,6,14,-8,2,costarica
AD Grecia,7,0,1,6,3,22,-19,1,costarica
Sparta Prague,6,4,2,0,13,4,9,14,czechrepublic
Slavia Prague,6,4,2,0,9,4,5,14,czechrepublic
Mlada Boleslav,6,3,1,2,15,15,0,10,czechrepublic
Bohemians,6,3,0,3,4,7,-3,9,czechrepublic
Sigma Olomouc,6,2,1,3,9,9,0,7,czechrepublic
Banik Ostrava,6,2,1,3,7,8,-1,7,czechrepublic
Teplice,6,2,1,3,8,10,-2,7,czechrepublic
Slovacko,6,2,1,3,2,9,-7,7,czechrepublic
Viktoria Plzen,5,2,0,3,13,10,3,6,czechrepublic
Pardubice,5,1,1,3,6,13,-7,4,czechrepublic
Slovan Liberec,5,0,3,2,6,11,-5,3,czechrepublic
Jablonec,7,0,3,4,5,10,-5,3,czechrepublic
Hradec Kralove,7,0,2,5,4,14,-10,2,czechrepublic
Zlin,6,0,1,5,3,14,-11,1,czechrepublic
C. Budejovice,6,0,1,5,4,18,-14,1,czechrepublic
Karvina,6,0,0,6,4,16,-12,0,czechrepublic
Brondby IF,7,5,1,1,13,6,7,16,denmark
FC Kobenhavn,6,4,2,0,13,8,5,14,denmark
Nordsjaelland,6,3,2,1,11,4,7,11,denmark
Silkeborg,6,3,1,2,10,7,3,10,denmark
FC Midtjylland,6,3,1,2,9,11,-2,10,denmark
Odense BK,5,3,0,2,10,6,4,9,denmark
AGF Aarhus,6,2,3,1,8,5,3,9,denmark
Lyngby,7,2,1,4,6,14,-8,7,denmark
Randers FC,6,1,2,3,7,13,-6,5,denmark
Vejle BK,6,1,1,4,6,9,-3,4,denmark
Hvidovre,6,0,3,3,3,7,-4,3,denmark
Viborg,6,1,0,5,3,11,-8,3,denmark
SonderjyskE,8,6,2,0,22,10,12,20,denmark2
Hobro,6,5,0,1,10,3,7,15,denmark2
Aalborg BK,6,4,2,0,14,5,9,14,denmark2
Fredericia,7,4,2,1,13,7,6,14,denmark2
Hillerod,7,3,1,3,17,12,5,10,denmark2
B 93,7,3,1,3,10,9,1,10,denmark2
Kolding IF,7,3,1,3,9,13,-4,10,denmark2
Vendsyssel,6,3,0,3,9,8,1,9,denmark2
HB Koge,7,1,1,5,9,16,-7,4,denmark2
AC Horsens,7,1,1,5,3,12,-9,4,denmark2
Naestved,7,0,2,5,8,17,-9,2,denmark2
Helsingor,6,0,1,5,2,11,-9,1,denmark2
I. del Valle,7,5,1,1,12,7,5,16,ecuador
El Nacional,8,5,0,3,14,14,0,15,ecuador
LDU Quito,8,4,2,2,15,10,5,14,ecuador
U. Catolica,8,3,2,3,9,13,-4,11,ecuador
Barcelona SC,7,2,2,3,9,12,-3,8,ecuador
Aucas,7,1,3,3,5,12,-7,6,ecuador
Emelec,8,1,2,5,11,14,-3,5,ecuador
Gualaceo,7,1,1,5,4,12,-8,4,ecuador
Delfin,7,1,1,5,3,18,-15,4,ecuador
Cumbaya,7,0,3,4,3,9,-6,3,ecuador
D. Cuenca,7,1,0,6,5,14,-9,3,ecuador
Orense,8,0,3,5,5,14,-9,3,ecuador
Libertad,8,0,2,6,10,19,-9,2,ecuador
Tecnico U.,7,0,1,6,5,11,-6,1,ecuador
Mushuc Runa,8,0,1,7,5,19,-14,1,ecuador
Guayaquil City,8,0,1,7,4,20,-16,1,ecuador
Imbabura,8,3,4,1,11,8,3,13,ecuador3
Cuniburo,8,3,2,3,12,12,0,11,ecuador3
I. Juniors,8,3,2,3,7,8,-1,11,ecuador3
Macara,8,3,2,3,8,10,-2,11,ecuador3
Chacaritas,8,3,1,4,7,10,-3,10,ecuador3
Manta,8,2,3,3,10,13,-3,9,ecuador3
Vargas Torres,8,2,1,5,6,15,-9,7,ecuador3
America de Q.,8,1,3,4,8,15,-7,6,ecuador3
Nueve Octubre,8,2,0,6,6,14,-8,6,ecuador3
Guayaquil,8,0,3,5,5,19,-14,3,ecuador3
Future FC,2,2,0,0,4,0,4,6,egypt
Pyramids FC,2,2,0,0,2,0,2,6,egypt
Baladiyyat,2,1,1,0,5,3,2,4,egypt
ZED FC,2,1,1,0,4,3,1,4,egypt
Zamalek,3,1,1,1,5,5,0,4,egypt
Pharco,2,1,0,1,1,1,0,3,egypt
Smouha,2,1,0,1,3,5,-2,3,egypt
Al Masry,3,1,0,2,5,8,-3,3,egypt
El Gouna,2,0,2,0,3,3,0,2,egypt
Al Mokawloon,2,0,1,1,2,3,-1,1,egypt
Ceramica C.,2,0,1,1,2,3,-1,1,egypt
El Geish,2,0,1,1,0,1,-1,1,egypt
Al Ittihad,2,0,1,1,3,5,-2,1,egypt
Al Ahly,0,0,0,0,0,0,0,0,egypt
ENPPI,2,0,0,2,0,2,-2,0,egypt
Ismaily,2,0,0,2,1,4,-3,0,egypt
National Bank,2,0,0,2,1,5,-4,0,egypt
El Daklyeh,2,0,0,2,1,6,-5,0,egypt
Tottenham,6,4,2,0,14,7,7,14,england
Arsenal,4,3,1,0,8,2,6,10,england
Manchester City,5,3,0,2,9,5,4,9,england
Liverpool,5,2,2,1,9,7,2,8,england
Chelsea,4,2,1,1,7,4,3,7,england
Wolverhampton,5,2,1,2,6,6,0,7,england
West Ham Utd,5,2,1,2,8,10,-2,7,england
Aston Villa,5,2,1,2,6,10,-4,7,england
Crystal Palace,5,2,1,2,4,8,-4,7,england
Brighton,4,2,0,2,9,10,-1,6,england
Manchester Utd,4,2,0,2,4,6,-2,6,england
Fulham,5,1,2,2,4,9,-5,5,england
Newcastle Utd,4,1,1,2,11,6,5,4,england
Brentford,4,1,1,2,5,4,1,4,england
Nottm Forest,5,1,1,3,4,7,-3,4,england
Everton,4,1,1,2,5,9,-4,4,england
Burnley,4,1,1,2,3,7,-4,4,england
Luton Town,5,1,1,3,5,11,-6,4,england
Bournemouth,4,0,1,3,4,11,-7,1,england
Sheffield Utd,4,0,0,4,3,9,-6,0,england
Leicester City,6,6,0,0,16,4,12,18,england2
Ipswich Town,6,5,1,0,7,2,5,16,england2
Hull City,7,4,1,2,11,9,2,13,england2
Southampton,7,4,1,2,10,12,-2,13,england2
Sunderland,7,3,1,3,11,7,4,10,england2
Blackburn,7,3,1,3,12,11,1,10,england2
Leeds Utd,7,3,1,3,11,10,1,10,england2
Bristol City,6,3,1,2,7,6,1,10,england2
Middlesbrough,7,3,1,3,13,13,0,10,england2
Millwall,6,2,3,1,6,5,1,9,england2
Preston,6,2,2,2,7,9,-2,8,england2
Swansea City,6,2,1,3,10,9,1,7,england2
Cardiff City,7,2,1,4,10,10,0,7,england2
QP Rangers,8,2,1,5,6,12,-6,7,england2
West Brom,6,1,3,2,9,8,1,6,england2
Huddersfield,6,1,3,2,6,10,-4,6,england2
Norwich City,6,1,2,3,13,15,-2,5,england2
Coventry City,7,1,2,4,8,11,-3,5,england2
Watford,6,1,2,3,5,10,-5,5,england2
Birmingham City,6,1,1,4,4,8,-4,4,england2
Stoke City,6,1,1,4,5,10,-5,4,england2
Plymouth,6,0,3,3,4,9,-5,3,england2
Rotherham,6,0,1,5,3,14,-11,1,england2
Sheffield Wed,7,0,1,6,3,14,-11,1,england2
Barnsley,7,5,2,0,13,3,10,17,england3
Derby County,7,4,1,2,14,7,7,13,england3
Stevenage,8,4,1,3,12,10,2,13,england3
Portsmouth,6,3,3,0,10,4,6,12,england3
Oxford Utd,6,4,0,2,11,7,4,12,england3
Peterborough,7,3,2,2,8,7,1,11,england3
Bolton,5,3,1,1,10,5,5,10,england3
Wigan Athletic,8,3,1,4,12,11,1,10,england3
Wycombe,7,3,1,3,11,12,-1,10,england3
Leyton Orient,8,2,3,3,8,9,-1,9,england3
Exeter City,7,3,0,4,7,10,-3,9,england3
Port Vale,8,2,3,3,6,16,-10,9,england3
Fleetwood,7,2,2,3,8,9,-1,8,england3
Burton Albion,8,2,2,4,6,10,-4,8,england3
Lincoln City,7,2,2,3,6,10,-4,8,england3
Bristol Rovers,7,2,1,4,7,12,-5,7,england3
Northampton,6,2,0,4,5,6,-1,6,england3
Blackpool,6,1,3,2,4,8,-4,6,england3
Carlisle Utd,7,1,2,4,6,9,-3,5,england3
Cambridge Utd,6,1,1,4,4,7,-3,4,england3
Shrewsbury,7,1,1,5,2,12,-10,4,england3
Charlton,5,0,2,3,3,7,-4,2,england3
Cheltenham,7,0,1,6,2,11,-9,1,england3
Reading,7,0,0,7,4,17,-13,0,england3
AFC Wimbledon,8,4,4,0,11,3,8,16,england4
Stockport,7,5,0,2,15,9,6,15,england4
Mansfield,8,3,5,0,18,9,9,14,england4
Harrogate,8,4,1,3,8,9,-1,13,england4
Salford City,8,4,0,4,15,12,3,12,england4
Notts County,8,3,3,2,14,14,0,12,england4
Gillingham,8,4,0,4,6,10,-4,12,england4
Accrington,7,3,1,3,10,10,0,10,england4
Wrexham,7,2,4,1,5,8,-3,10,england4
Crewe Alexandra,7,2,3,2,17,15,2,9,england4
Barrow,8,2,3,3,8,8,0,9,england4
Morecambe,6,3,0,3,9,11,-2,9,england4
Milton Keynes,8,2,2,4,12,14,-2,8,england4
Bradford,8,2,2,4,8,12,-4,8,england4
Walsall,8,2,2,4,13,19,-6,8,england4
Swindon Town,7,1,4,2,12,14,-2,7,england4
Forest Green,6,2,1,3,7,9,-2,7,england4
Colchester Utd,7,2,0,5,9,14,-5,6,england4
Doncaster,7,2,0,5,8,14,-6,6,england4
Crawley Town,6,1,3,2,8,15,-7,6,england4
Grimsby,7,0,3,4,9,15,-6,3,england4
Newport,7,1,0,6,7,18,-11,3,england4
Tranmere,7,0,0,7,4,15,-11,0,england4
Sutton Utd,7,0,0,7,8,23,-15,0,england4
Chesterfield,8,6,1,1,17,10,7,19,england5
Barnet,8,5,1,2,17,13,4,16,england5
Altrincham,8,4,3,1,13,11,2,15,england5
Solihull Moors,8,4,3,1,11,10,1,15,england5
Halifax Town,8,4,2,2,10,8,2,14,england5
Woking,8,4,1,3,9,6,3,13,england5
Gateshead FC,8,3,3,2,19,10,9,12,england5
Rochdale,8,3,3,2,12,11,1,12,england5
Bromley,8,2,4,2,8,10,-2,10,england5
Boreham Wood,8,2,4,2,11,14,-3,10,england5
Dorking,8,3,1,4,8,11,-3,10,england5
Oldham,8,2,4,2,10,14,-4,10,england5
Southend Utd,8,2,3,3,10,11,-1,9,england5
Aldershot Town,8,3,0,5,8,15,-7,9,england5
Eastleigh,8,2,2,4,7,12,-5,8,england5
York City,8,2,2,4,9,18,-9,8,england5
Dagenham & R.,8,1,4,3,7,9,-2,7,england5
Hartlepool,8,2,1,5,12,17,-5,7,england5
AFC Fylde,8,1,1,6,10,19,-9,4,england5
Kidderminster,8,1,1,6,6,15,-9,4,england5
Oxford City,8,0,4,4,8,18,-10,4,england5
Wealdstone,8,0,2,6,7,15,-8,2,england5
Maidenhead Utd,8,0,2,6,7,20,-13,2,england5
Ebbsfleet Utd,8,0,2,6,9,25,-16,2,england5
Flora,8,4,4,0,12,5,7,16,estonia
Levadia,8,4,3,1,11,5,6,15,estonia
Paide,8,4,2,2,10,5,5,14,estonia
Vaprus,8,2,4,2,11,7,4,10,estonia
Tallinna Kalev,8,2,3,3,14,11,3,9,estonia
Nomme Kalju,8,1,3,4,7,12,-5,6,estonia
Harju Jalgpalli,8,1,3,4,6,12,-6,6,estonia
Narva Trans,8,2,0,6,8,20,-12,6,estonia
Kuressaare,8,1,0,7,5,22,-17,3,estonia
Tammeka,8,0,2,6,8,22,-14,2,estonia
Nomme Utd,8,7,0,1,29,4,25,21,estonia2
Viimsi,8,6,2,0,12,2,10,20,estonia2
Flora B,8,6,1,1,23,7,16,19,estonia2
Paide B,8,4,2,2,16,14,2,14,estonia2
Levadia B,8,4,2,2,9,8,1,14,estonia2
Tabasalu,8,4,0,4,17,18,-1,12,estonia2
FC Tallinn,8,3,1,4,17,16,1,10,estonia2
Elva,8,2,0,6,6,22,-16,6,estonia2
Alliance,8,1,1,6,9,23,-14,4,estonia2
Legion,8,0,3,5,10,18,-8,3,estonia2
Vikingur,8,6,0,2,23,7,16,18,faroeislands
Klaksvik,8,5,2,1,20,7,13,17,faroeislands
HB Torshavn,8,5,1,2,20,9,11,16,faroeislands
B36 Torshavn,8,4,1,3,13,11,2,13,faroeislands
07 Vestur,8,3,1,4,11,14,-3,10,faroeislands
Streymur,8,2,3,3,10,18,-8,9,faroeislands
B68 Toftir,8,1,3,4,8,14,-6,6,faroeislands
TB Tvoroyri,8,1,1,6,2,13,-11,4,faroeislands
IF Fuglafjordur,8,1,0,7,5,22,-17,3,faroeislands
AB Argir,8,0,1,7,8,26,-18,1,faroeislands
Skala,8,5,1,2,24,10,14,16,faroeislands2
NSI Runavik,8,5,1,2,22,10,12,16,faroeislands2
Klaksvik B,8,4,0,4,18,13,5,12,faroeislands2
Hoyvik,8,3,2,3,17,14,3,11,faroeislands2
Vikingur B,8,3,0,5,13,12,1,9,faroeislands2
HB B,8,2,1,5,9,20,-11,7,faroeislands2
B36 Torshavn B,8,1,1,6,14,22,-8,4,faroeislands2
B71 Sandur,8,0,4,4,5,20,-15,4,faroeislands2
B68 Toftir B,8,0,0,8,5,29,-24,0,faroeislands2
Streymur B,8,0,0,8,5,40,-35,0,faroeislands2
VPS,8,8,0,0,16,1,15,24,finland
KuPS,8,5,3,0,17,9,8,18,finland
HJK Helsinki,8,5,2,1,17,11,6,17,finland
Ilves,8,3,2,3,15,9,6,11,finland
Inter Turku,8,3,2,3,11,11,0,11,finland
Honka,8,3,1,4,7,11,-4,10,finland
SJK,8,2,3,3,9,12,-3,9,finland
Mariehamn,8,2,2,4,12,13,-1,8,finland
Lahti,8,1,4,3,6,10,-4,7,finland
Haka,8,2,1,5,7,16,-9,7,finland
Oulu,8,2,0,6,11,17,-6,6,finland
KTP,8,1,1,6,6,15,-9,4,finland
Ekenas IF,8,6,1,1,18,7,11,19,finland2
Gnistan,8,3,4,1,13,11,2,13,finland2
Mikkelin,8,3,2,3,12,11,1,11,finland2
JaPS,8,3,2,3,10,11,-1,11,finland2
TPS,8,3,1,4,9,12,-3,10,finland2
HIFK,8,3,0,5,13,15,-2,9,finland2
SJK Akatemia,8,2,3,3,14,17,-3,9,finland2
Jaro,8,2,3,3,10,15,-5,9,finland2
SalPa,8,1,4,3,7,10,-3,7,finland2
KPV Kokkola,8,1,2,5,10,19,-9,5,finland2
KaPa,8,1,1,6,10,15,-5,4,finland2
JJK,8,0,2,6,8,21,-13,2,finland2
Nice,5,4,1,0,7,3,4,13,france
Paris SG,4,2,2,0,8,3,5,8,france
Monaco,4,2,2,0,12,8,4,8,france
Reims,5,2,2,1,9,7,2,8,france
Montpellier,5,2,1,2,9,6,3,7,france
Brest,5,2,1,2,4,5,-1,7,france
Lille,5,1,3,1,7,8,-1,6,france
Nantes,4,2,0,2,4,6,-2,6,france
Metz,5,2,0,3,4,10,-6,6,france
Toulouse,5,1,2,2,4,6,-2,5,france
Clermont,4,1,1,2,5,7,-2,4,france
Lens,5,1,1,3,4,9,-5,4,france
Rennes,4,0,3,1,2,3,-1,3,france
Le Havre,4,0,3,1,4,7,-3,3,france
Strasbourg,4,1,0,3,1,8,-7,3,france
Lorient,4,0,2,2,6,11,-5,2,france
Marseille,5,0,2,3,5,11,-6,2,france
Lyon,4,0,1,3,1,5,-4,1,france
Auxerre,6,4,2,0,15,7,8,14,france2
Saint-Etienne,6,4,1,1,7,4,3,13,france2
Laval,5,3,1,1,6,3,3,10,france2
Grenoble,5,2,3,0,5,3,2,9,france2
Angers,5,3,0,2,7,6,1,9,france2
Caen,5,2,1,2,9,8,1,7,france2
Guingamp,5,2,1,2,7,7,0,7,france2
Concarneau,6,2,1,3,4,8,-4,7,france2
Valenciennes,6,1,3,2,4,7,-3,6,france2
Quevilly Rouen,6,1,2,3,7,9,-2,5,france2
Rodez Aveyron,5,1,2,2,6,8,-2,5,france2
Annecy,5,1,2,2,5,7,-2,5,france2
Pau FC,6,1,2,3,8,13,-5,5,france2
AC Ajaccio,5,1,2,2,1,6,-5,5,france2
Bordeaux,6,1,2,3,2,8,-6,5,france2
Troyes,6,0,4,2,6,8,-2,4,france2
Paris FC,6,1,1,4,6,11,-5,4,france2
USL Dunkerque,5,1,1,3,6,11,-5,4,france2
Amiens,5,1,1,3,2,7,-5,4,france2
SC Bastia,6,0,3,3,2,7,-5,3,france2
Le Mans,6,4,1,1,10,8,2,13,france3
Red Star,6,4,1,1,9,7,2,13,france3
Rouen,6,2,3,1,7,6,1,9,france3
Sochaux,6,2,2,2,8,7,1,8,france3
Versailles,5,2,1,2,5,3,2,7,france3
Martigues,6,1,4,1,2,3,-1,7,france3
Nimes,5,1,3,1,5,5,0,6,france3
Villefranche,6,1,3,2,6,9,-3,6,france3
G. O. A. L.,6,1,2,3,6,6,0,5,france3
Chateauroux,6,0,5,1,7,9,-2,5,france3
Marignane G.,5,1,2,2,3,6,-3,5,france3
Nancy,5,1,1,3,3,4,-1,4,france3
Niort,5,1,1,3,6,10,-4,4,france3
Orleans,5,1,1,3,5,10,-5,4,france3
Cholet,5,1,0,4,4,9,-5,3,france3
Avranches,6,0,2,4,6,14,-8,2,france3
Dijon,5,0,2,3,1,9,-8,2,france3
Epinal,5,0,1,4,5,12,-7,1,france3
Dinamo Batumi,8,5,2,1,18,5,13,17,georgia
Dinamo Tbilisi,8,4,2,2,22,14,8,14,georgia
Torpedo Kutaisi,8,3,4,1,9,6,3,13,georgia
Samtredia,8,3,3,2,11,10,1,12,georgia
Telavi,8,4,0,4,9,14,-5,12,georgia
Saburtalo,8,3,1,4,8,11,-3,10,georgia
Gagra,8,3,1,4,10,18,-8,10,georgia
Dila Gori,8,2,3,3,9,11,-2,9,georgia
Samgurali,8,1,2,5,9,20,-11,5,georgia
Shukura,8,1,1,6,10,30,-20,4,georgia
Gareji Sagarejo,8,5,1,2,16,9,7,16,georgia2
Bolnisi,8,5,1,2,15,9,6,16,georgia2
Kolkheti Poti,8,4,3,1,21,8,13,15,georgia2
WIT Georgia,8,4,2,2,13,13,0,14,georgia2
Spaeri,8,4,1,3,13,10,3,13,georgia2
D. Tbilisi B,8,3,1,4,10,13,-3,10,georgia2
L. Tbilisi,8,2,2,4,9,11,-2,8,georgia2
Kolkheti Khobi,8,1,3,4,6,14,-8,6,georgia2
Merani Martvili,8,1,2,5,10,25,-15,5,georgia2
Merani Tbilisi,8,0,2,6,6,26,-20,2,georgia2
Hoffenheim,4,4,0,0,11,5,6,12,germany
Bayern Munich,4,3,1,0,11,4,7,10,germany
Leverkusen,4,3,1,0,10,3,7,10,germany
RB Leipzig,4,3,0,1,9,4,5,9,germany
Stuttgart,4,3,0,1,9,6,3,9,germany
Dortmund,3,2,1,0,8,4,4,7,germany
Monchengladbach,4,1,2,1,11,11,0,5,germany
E. Frankfurt,4,1,2,1,5,5,0,5,germany
Freiburg,4,1,1,2,2,9,-7,4,germany
Union Berlin,4,1,0,3,7,8,-1,3,germany
FC Augsburg,4,1,0,3,6,10,-4,3,germany
Wolfsburg,4,1,0,3,4,8,-4,3,germany
Darmstadt,4,1,0,3,4,10,-6,3,germany
FSV Mainz,5,0,2,3,6,14,-8,2,germany
Bochum,5,0,2,3,3,16,-13,2,germany
FC Koln,4,0,1,3,2,7,-5,1,germany
Heidenheim,4,0,1,3,3,10,-7,1,germany
Werder Bremen,4,0,0,4,4,10,-6,0,germany
Holstein Kiel,5,4,0,1,9,6,3,12,germany2
Dusseldorf,5,3,1,1,12,3,9,10,germany2
Sankt Pauli,5,2,3,0,7,5,2,9,germany2
Elversberg,5,2,2,1,8,6,2,8,germany2
Hannover 96,5,2,2,1,9,8,1,8,germany2
Paderborn,5,2,1,2,7,10,-3,7,germany2
Wehen Wiesbaden,5,2,0,3,5,6,-1,6,germany2
Hertha Berlin,6,2,0,4,10,16,-6,6,germany2
Magdeburg,6,1,2,3,9,10,-1,5,germany2
Hamburger SV,5,1,2,2,6,7,-1,5,germany2
Kaiserslautern,5,1,2,2,8,11,-3,5,germany2
Karlsruher SC,5,1,1,3,8,11,-3,4,germany2
FC Nurnberg,5,1,1,3,7,14,-7,4,germany2
Hansa Rostock,4,1,0,3,3,7,-4,3,germany2
Greuther Furth,5,0,2,3,3,11,-8,2,germany2
Osnabruck,5,0,2,3,3,15,-12,2,germany2
Schalke 04,6,0,1,5,6,16,-10,1,germany2
Braunschweig,5,0,0,5,1,11,-10,0,germany2
Regensburg,6,4,2,0,10,5,5,14,germany3
Dynamo Dresden,6,3,1,2,7,6,1,10,germany3
Ulm,6,3,1,2,9,10,-1,10,germany3
Dortmund B,6,2,3,1,8,7,1,9,germany3
Sandhausen,6,2,2,2,6,7,-1,8,germany3
Verl,6,2,1,3,14,12,2,7,germany3
1860 Munchen,6,2,1,3,7,7,0,7,germany3
Preuss. Munster,6,2,1,3,6,7,-1,7,germany3
Bielefeld,6,2,1,3,6,9,-3,7,germany3
RW Essen,6,2,1,3,6,9,-3,7,germany3
Saarbrucken,6,1,3,2,10,9,1,6,germany3
VfB Lubeck,6,1,3,2,7,10,-3,6,germany3
Freiburg B,6,2,0,4,6,9,-3,6,germany3
Erzgebirge Aue,6,1,3,2,7,11,-4,6,germany3
Viktoria Koln,6,1,2,3,10,12,-2,5,germany3
FC Ingolstadt,6,1,1,4,7,10,-3,4,germany3
Unterhaching,6,0,4,2,3,7,-4,4,germany3
Mannheim,7,1,1,5,6,14,-8,4,germany3
MSV Duisburg,5,0,2,3,3,7,-4,2,germany3
Hallescher,5,0,1,4,6,14,-8,1,germany3
Lincoln RI,8,8,0,0,27,3,24,24,gibraltar
Europa FC,8,6,0,2,19,6,13,18,gibraltar
Magpies,8,5,2,1,18,6,12,17,gibraltar
St Josephs,8,4,1,3,15,8,7,13,gibraltar
Mons Calpe,8,4,1,3,16,13,3,13,gibraltar
Lynx,8,4,1,3,10,9,1,13,gibraltar
Manchester 62,8,4,0,4,18,12,6,12,gibraltar
Lions FC,8,3,0,5,11,15,-4,9,gibraltar
Europa Point,8,0,3,5,6,21,-15,3,gibraltar
Glacis Utd,8,1,0,7,13,29,-16,3,gibraltar
College 1975,8,0,2,6,7,23,-16,2,gibraltar
Panathinaikos,3,3,0,0,10,1,9,9,greece
AEK Athens,4,3,0,1,8,5,3,9,greece
Olympiakos,2,1,1,0,4,1,3,4,greece
PAOK,3,1,1,1,5,4,1,4,greece
Asteras T.,4,1,1,2,4,7,-3,4,greece
OFI Crete,4,0,3,1,3,6,-3,3,greece
PAS Giannina,4,0,2,2,5,7,-2,2,greece
Panserraikos,4,0,2,2,5,8,-3,2,greece
Lamia,4,0,2,2,3,9,-6,2,greece
Aris,4,0,1,3,3,8,-5,1,greece
Panaitolikos,4,0,1,3,1,8,-7,1,greece
Kifisia,4,0,1,3,2,10,-8,1,greece
Volos,4,0,1,3,1,9,-8,1,greece
Atromitos,6,0,1,5,3,16,-13,1,greece
Municipal,7,3,3,1,12,8,4,12,guatemala
Guastatoya,7,3,0,4,7,7,0,9,guatemala
Malacateco,5,2,1,2,7,5,2,7,guatemala
Antigua GFC,6,2,1,3,8,10,-2,7,guatemala
Achuapa,5,2,1,2,7,10,-3,7,guatemala
Comunicaciones,5,1,2,2,7,9,-2,5,guatemala
Zacapa Tellioz,5,1,0,4,4,9,-5,3,guatemala
Coban Imperial,6,0,3,3,5,11,-6,3,guatemala
Coatepecano IB,5,0,2,3,4,11,-7,2,guatemala
Xinabajul,5,0,2,3,4,11,-7,2,guatemala
Mixco,5,0,1,4,4,10,-6,1,guatemala
Xelaju,5,0,1,4,1,7,-6,1,guatemala
Olimpia,7,5,2,0,13,6,7,17,honduras
Génesis,8,3,1,4,9,11,-2,10,honduras
Marathon,7,3,1,3,7,9,-2,10,honduras
Olancho,7,2,2,3,5,6,-1,8,honduras
Vida,8,2,1,5,8,17,-9,7,honduras
Motagua,6,1,3,2,11,11,0,6,honduras
Victoria,6,1,2,3,7,9,-2,5,honduras
Real Sociedad,6,0,4,2,2,7,-5,4,honduras
Real Espana,7,1,0,6,8,16,-8,3,honduras
UPNFM,7,0,1,6,5,16,-11,1,honduras
North District,2,1,1,0,5,2,3,4,hongkong
LM Warriors,1,1,0,0,3,1,2,3,hongkong
Eastern,1,1,0,0,2,0,2,3,hongkong
Southern D.,3,1,0,2,6,5,1,3,hongkong
HK Rangers,4,1,0,3,7,7,0,3,hongkong
Wofoo Tai Po,2,1,0,1,1,3,-2,3,hongkong
Resources C.,3,1,0,2,2,7,-5,3,hongkong
Hong Kong FC,2,1,0,1,1,8,-7,3,hongkong
HK U23,4,0,1,3,0,12,-12,1,hongkong
Kitchee,1,0,0,1,1,4,-3,0,hongkong
Sham Shui Po,2,0,0,2,1,11,-10,0,hongkong
Puskas Akad.,6,4,1,1,13,7,6,13,hungary
Ferencvaros,4,4,0,0,19,7,12,12,hungary
Paks,6,2,3,1,11,11,0,9,hungary
Diosgyor VTK,4,2,0,2,8,7,1,6,hungary
MTK,4,2,0,2,6,6,0,6,hungary
Zalaegerszegi,4,1,1,2,6,7,-1,4,hungary
Ujpest,3,1,1,1,5,7,-2,4,hungary
Mezokovesd,6,1,1,4,6,10,-4,4,hungary
Debrecen,3,0,1,2,3,7,-4,1,hungary
MOL Fehervar,5,0,1,4,4,10,-6,1,hungary
Kisvarda,8,0,1,7,5,17,-12,1,hungary
Kecskemeti TE,5,0,0,5,4,12,-8,0,hungary
Gyori ETO,7,4,1,2,16,12,4,13,hungary2
Haladas,8,3,2,3,11,13,-2,11,hungary2
Kozarmisleny,6,3,1,2,9,6,3,10,hungary2
Szeged,6,2,4,0,6,4,2,10,hungary2
Nyiregyhaza,6,2,3,1,9,7,2,9,hungary2
Pecsi MFC,6,2,3,1,3,3,0,9,hungary2
Tiszakecske,7,2,2,3,9,10,-1,8,hungary2
Soroksar,7,2,2,3,6,7,-1,8,hungary2
Budafoki,6,2,2,2,6,9,-3,8,hungary2
Vasas,5,2,1,2,10,9,1,7,hungary2
Csakvari,5,2,1,2,5,5,0,7,hungary2
Kazincbarcika,5,1,3,1,7,5,2,6,hungary2
Honved,6,1,3,2,4,5,-1,6,hungary2
Gyirmot,5,1,2,2,4,4,0,5,hungary2
BVSC,5,1,2,2,6,11,-5,5,hungary2
Siofok,6,1,1,4,3,10,-7,4,hungary2
Ajka,5,1,0,4,3,6,-3,3,hungary2
MTE,6,0,1,5,4,15,-11,1,hungary2
Vikingur R.,8,5,1,2,20,14,6,16,iceland
Stjarnan,8,4,2,2,14,7,7,14,iceland
Valur,8,3,2,3,18,13,5,11,iceland
Fylkir,8,3,2,3,13,15,-2,11,iceland
KA Akureyri,8,3,1,4,15,15,0,10,iceland
Hafnarfjordur,8,3,1,4,11,16,-5,10,iceland
KR Reykjavik,8,1,4,3,14,19,-5,7,iceland
Breidablik,8,1,3,4,14,21,-7,6,iceland
IBV,8,1,3,4,9,18,-9,6,iceland
Fram,8,0,3,5,6,17,-11,3,iceland
Keflavik,8,0,2,6,7,19,-12,2,iceland
HK Kopavogur,8,0,2,6,6,20,-14,2,iceland
IA Akranes,8,7,1,0,23,11,12,22,iceland2
Leiknir R.,8,5,0,3,21,11,10,15,iceland2
Vestri,8,4,3,1,14,8,6,15,iceland2
Afturelding,8,4,2,2,19,13,6,14,iceland2
Fjolnir,8,3,3,2,14,14,0,12,iceland2
Njardvík,8,3,0,5,14,22,-8,9,iceland2
Thor Akureyri,8,1,3,4,8,14,-6,6,iceland2
Grindavik,8,2,0,6,7,23,-16,6,iceland2
Throttur R.,8,1,2,5,13,19,-6,5,iceland2
Grotta,8,1,2,5,9,17,-8,5,iceland2
Selfoss,8,1,0,7,10,23,-13,3,iceland2
AEggir,8,1,0,7,9,30,-21,3,iceland2
Dalvik / Reynir,8,5,2,1,15,6,9,17,iceland3
IR Reykjavik,8,5,0,3,18,11,7,15,iceland3
Haukar,8,4,1,3,14,11,3,13,iceland3
Fjardabyggd,8,3,3,2,14,9,5,12,iceland3
Throttur Vogar,8,3,1,4,15,16,-1,10,iceland3
Volsungur,8,3,0,5,14,16,-2,9,iceland3
Hottur / Huginn,8,3,0,5,12,18,-6,9,iceland3
KFG,8,2,2,4,13,15,-2,8,iceland3
V. Olafsvik,8,2,2,4,9,15,-6,8,iceland3
Fjallabyggd,8,2,1,5,14,18,-4,7,iceland3
KV Reykjavik,8,0,1,7,6,24,-18,1,iceland3
Sindri,8,0,1,7,6,32,-26,1,iceland3
Punjab,8,5,2,1,16,9,7,17,india2
Gokulam,8,3,1,4,10,9,1,10,india2
Churchill B.,8,3,1,4,12,12,0,10,india2
Sreenidi Deccan,8,3,1,4,12,12,0,10,india2
Real Kashmir,8,2,4,2,6,7,-1,10,india2
Rajasthan,8,3,1,4,7,9,-2,10,india2
TRAU,8,3,0,5,13,22,-9,9,india2
Mohammedan,8,1,3,4,8,10,-2,6,india2
Sudeva,8,2,0,6,11,26,-15,6,india2
Aizawl,8,1,2,5,9,16,-7,5,india2
Neroca,8,0,4,4,9,14,-5,4,india2
Kenkre,8,0,2,6,5,16,-11,2,india2
R. Nusantara,8,4,3,1,12,9,3,15,indonesia
Madura Utd,8,4,2,2,14,9,5,14,indonesia
Persib,8,4,2,2,14,13,1,14,indonesia
Borneo,8,3,3,2,9,7,2,12,indonesia
PSS Sleman,8,3,1,4,10,13,-3,10,indonesia
Dewa United,8,2,3,3,11,11,0,9,indonesia
Persik Kediri,8,2,3,3,10,14,-4,9,indonesia
PSIS Semarang,8,2,2,4,11,13,-2,8,indonesia
Bali Utd,7,2,2,3,9,11,-2,8,indonesia
Persija,7,2,2,3,7,9,-2,8,indonesia
PSM,8,2,2,4,6,8,-2,8,indonesia
TIRA Persikabo,8,2,1,5,9,13,-4,7,indonesia
Barito Putera,8,1,3,4,9,10,-1,6,indonesia
Persis Solo,8,1,2,5,8,14,-6,5,indonesia
Bhayangkara S.,7,1,2,4,6,14,-8,5,indonesia
Persita,7,1,2,4,4,12,-8,5,indonesia
Arema,8,1,2,5,8,17,-9,5,indonesia
Persebaya S.,8,1,2,5,4,15,-11,5,indonesia
Shams A. Qazvin,5,3,1,1,8,5,3,10,iran
Zob Ahan,4,3,1,0,7,4,3,10,iran
Persepolis,3,3,0,0,6,1,5,9,iran
Tractor Sazi,5,3,0,2,7,4,3,9,iran
Sepahan,2,2,0,0,5,1,4,6,iran
Esteghlal,3,2,0,1,4,1,3,6,iran
Aluminium Arak,5,2,0,3,3,5,-2,6,iran
Paykan,4,1,2,1,3,4,-1,5,iran
Havadar,3,1,1,1,4,4,0,4,iran
Mes Rafsanjan,3,1,1,1,2,2,0,4,iran
Gol Gohar,3,1,1,1,1,1,0,4,iran
Sanat Naft,3,1,0,2,4,8,-4,3,iran
Foolad,3,1,0,2,1,7,-6,3,iran
Malavan,3,0,2,1,2,3,-1,2,iran
N. Mazandaran,2,0,1,1,1,2,-1,1,iran
E. Khuzestan,3,0,0,3,0,3,-3,0,iran
Al Kahrabaa,1,1,0,0,3,1,2,3,iraq
Newroz SC,1,1,0,0,2,0,2,3,iraq
Al-Qasim,1,1,0,0,1,0,1,3,iraq
Naft Al-Wasat,1,0,1,0,2,2,0,1,iraq
Al Naft,1,0,1,0,1,1,0,1,iraq
Naft Maysan,1,0,1,0,0,0,0,1,iraq
Al Hudod,0,0,0,0,0,0,0,0,iraq
Al Karkh,0,0,0,0,0,0,0,0,iraq
Al Minaa Basra,0,0,0,0,0,0,0,0,iraq
Al Najaf,0,0,0,0,0,0,0,0,iraq
Al Quwa Al J.,0,0,0,0,0,0,0,0,iraq
Al Talaba,0,0,0,0,0,0,0,0,iraq
Al Zawraa,0,0,0,0,0,0,0,0,iraq
Baghdad,0,0,0,0,0,0,0,0,iraq
Duhok,0,0,0,0,0,0,0,0,iraq
Erbil,0,0,0,0,0,0,0,0,iraq
Karbala,0,0,0,0,0,0,0,0,iraq
Naft Al-Janoob,1,0,0,1,1,2,-1,0,iraq
Zakho,1,0,0,1,1,2,-1,0,iraq
Al Shorta,1,0,0,1,0,2,-2,0,iraq
St. Patricks,8,5,1,2,12,6,6,16,ireland
Derry City,8,3,3,2,12,6,6,12,ireland
Shelbourne,8,3,3,2,9,4,5,12,ireland
Shamrock Rovers,8,2,5,1,9,6,3,11,ireland
Dundalk,8,3,0,5,9,12,-3,9,ireland
Bohemians,8,1,4,3,4,10,-6,7,ireland
Drogheda Utd,8,2,1,5,11,21,-10,7,ireland
Cork City,8,1,1,6,6,18,-12,4,ireland
Sligo Rovers,8,0,2,6,6,15,-9,2,ireland
UC Dublin,8,0,1,7,3,28,-25,1,ireland
Galway Utd,8,4,3,1,18,8,10,15,ireland2
Waterford,8,4,3,1,14,7,7,15,ireland2
Wexford,8,4,2,2,12,8,4,14,ireland2
Longford Town,8,3,3,2,10,10,0,12,ireland2
Cobh Ramblers,8,3,2,3,16,17,-1,11,ireland2
Bray Wanderers,8,2,4,2,11,12,-1,10,ireland2
Treaty Utd,8,3,1,4,9,13,-4,10,ireland2
Athlone Town,8,3,1,4,13,21,-8,10,ireland2
Finn Harps,8,1,2,5,7,21,-14,5,ireland2
Kerry,8,0,1,7,7,17,-10,1,ireland2
M. Tel Aviv,2,2,0,0,8,0,8,6,israel
Hapoel Haifa,2,2,0,0,4,2,2,6,israel
Maccabi Haifa,3,2,0,1,7,6,1,6,israel
Hapoel Tel Aviv,3,1,2,0,4,1,3,5,israel
M. Bnei Raina,3,1,2,0,4,3,1,5,israel
B. Jerusalem,2,1,0,1,3,3,0,3,israel
Hapoel Hadera,3,1,0,2,1,5,-4,3,israel
M. Petah Tikva,2,0,2,0,3,3,0,2,israel
Bnei Sakhnin,3,0,2,1,3,7,-4,2,israel
H. Beer Sheva,2,0,1,1,1,2,-1,1,israel
Maccabi Netanya,2,0,1,1,1,3,-2,1,israel
H. Jerusalem,3,0,1,2,2,6,-4,1,israel
Ashdod,2,0,0,2,1,6,-5,0,israel
H. Petah Tikva,2,0,0,2,1,6,-5,0,israel
Ramat Hasharon,3,2,1,0,8,3,5,7,israel2
H. Umm al-Fahm,3,1,2,0,4,2,2,5,israel2
H. Ramat Gan,3,1,2,0,5,4,1,5,israel2
H. Ironi Rishon,4,1,2,1,3,3,0,5,israel2
Bnei Yehuda,3,1,1,1,5,5,0,4,israel2
H. Kfar Saba,3,1,1,1,2,2,0,4,israel2
Kafr Qasim,3,1,1,1,2,2,0,4,israel2
H. Nof Hagalil,4,1,1,2,4,6,-2,4,israel2
Hapoel Afula,4,1,1,2,4,10,-6,4,israel2
Kiryat Shmona,3,1,0,2,4,4,0,3,israel2
Maccabi Jaffa,3,1,0,2,6,8,-2,3,israel2
Ihud B. Shfaram,3,1,0,2,5,8,-3,3,israel2
M. Herziliya,3,1,0,2,3,7,-4,3,israel2
Hapoel Akko,4,0,2,2,0,2,-2,2,israel2
Ironi Tiberias,3,0,2,1,3,6,-3,2,israel2
Nes Tziona,4,0,1,3,4,12,-8,1,israel2
Inter Milan,4,4,0,0,10,0,10,12,italy
AC Milan,5,4,0,1,9,7,2,12,italy
Napoli,5,3,2,0,12,4,8,11,italy
Juventus,5,3,1,1,8,4,4,10,italy
Fiorentina,5,3,1,1,10,7,3,10,italy
Atalanta,5,2,0,3,8,8,0,6,italy
Lazio,5,2,0,3,6,8,-2,6,italy
Bologna,4,0,4,0,3,3,0,4,italy
AS Roma,4,1,1,2,7,8,-1,4,italy
Sassuolo,4,1,1,2,5,8,-3,4,italy
Genoa,5,1,1,3,3,6,-3,4,italy
Hellas Verona,5,1,1,3,3,6,-3,4,italy
Monza,5,1,1,3,2,7,-5,4,italy
Lecce,4,0,3,1,4,5,-1,3,italy
Udinese,4,0,3,1,2,5,-3,3,italy
Torino,4,1,0,3,4,8,-4,3,italy
Empoli,4,1,0,3,2,12,-10,3,italy
Frosinone,4,0,2,2,2,5,-3,2,italy
Cagliari,5,0,2,3,3,9,-6,2,italy
Salernitana,5,0,1,4,2,9,-7,1,italy
Palermo,5,4,1,0,9,2,7,13,italy2
Cremonese,5,4,1,0,10,5,5,13,italy2
Catanzaro,5,3,2,0,9,6,3,11,italy2
Parma,4,3,0,1,11,5,6,9,italy2
Modena,5,2,3,0,5,3,2,9,italy2
Sudtirol,5,2,2,1,7,5,2,8,italy2
Venezia,5,2,2,1,5,3,2,8,italy2
Pisa,5,2,2,1,3,2,1,8,italy2
Brescia,3,2,1,0,3,0,3,7,italy2
Como,5,2,1,2,6,6,0,7,italy2
Cosenza,5,2,1,2,4,5,-1,7,italy2
Sampdoria,5,1,3,1,5,5,0,6,italy2
Bari,5,1,3,1,4,4,0,6,italy2
Cittadella,5,1,2,2,5,7,-2,5,italy2
Spezia,5,1,2,2,7,10,-3,5,italy2
Reggiana,5,1,2,2,4,7,-3,5,italy2
Ascoli,6,1,2,3,6,10,-4,5,italy2
Lecco,4,1,1,2,3,6,-3,4,italy2
FeralpiSalo,6,1,1,4,3,13,-10,4,italy2
Ternana,4,0,1,3,4,8,-4,1,italy2
Arnett Gardens,8,5,3,0,14,5,9,18,jamaica
Portmore Utd,8,4,2,2,11,6,5,14,jamaica
Harbour View,8,4,2,2,10,6,4,14,jamaica
Waterhouse,8,4,2,2,10,8,2,14,jamaica
Cavalier,8,4,2,2,12,11,1,14,jamaica
Mount Pleasant,8,2,4,2,11,8,3,10,jamaica
Dunbeholden,8,3,1,4,12,12,0,10,jamaica
Molynes Utd,8,2,3,3,14,13,1,9,jamaica
Humble Lions,8,2,3,3,5,6,-1,9,jamaica
Tivoli Gardens,8,2,1,5,12,18,-6,7,jamaica
Faulkland,8,1,4,3,7,13,-6,7,jamaica
Vere Utd,8,1,3,4,9,11,-2,6,jamaica
Montego Bay,8,0,4,4,3,14,-11,4,jamaica
Chapelton,8,0,2,6,6,26,-20,2,jamaica
Avispa Fukuoka,8,5,0,3,11,10,1,15,japan
Vissel Kobe,8,4,2,2,10,7,3,14,japan
Yokohama M.,8,4,2,2,13,11,2,14,japan
Albirex Niigata,8,4,2,2,7,6,1,14,japan
Urawa RD,8,3,3,2,8,7,1,12,japan
Shonan Bellmare,8,3,2,3,10,13,-3,11,japan
Kashiwa Reysol,8,3,1,4,10,13,-3,10,japan
Cerezo Osaka,8,2,2,4,8,9,-1,8,japan
K. Frontale,8,2,2,4,9,13,-4,8,japan
Gamba Osaka,8,2,2,4,8,15,-7,8,japan
Sagan Tosu,8,1,4,3,14,11,3,7,japan
Kashima Antlers,8,1,4,3,8,10,-2,7,japan
Nagoya G.,8,2,0,6,6,13,-7,6,japan
Kyoto Sanga,8,1,2,5,7,12,-5,5,japan
FC Tokyo,8,1,2,5,6,11,-5,5,japan
S. Hiroshima,8,1,1,6,4,9,-5,4,japan
C. Sapporo,8,0,4,4,7,17,-10,4,japan
Yokohama FC,8,0,3,5,6,15,-9,3,japan
Machida Zelvia,8,5,2,1,19,5,14,17,japan2
Shimizu S-Pulse,8,5,2,1,18,6,12,17,japan2
JEF Utd Chiba,8,4,2,2,19,12,7,14,japan2
Tokyo Verdy,8,3,5,0,12,7,5,14,japan2
Omiya Ardija,8,4,2,2,10,8,2,14,japan2
Tokushima V.,8,3,4,1,10,8,2,13,japan2
Blaublitz Akita,8,4,1,3,10,11,-1,13,japan2
Iwaki,8,3,3,2,10,9,1,12,japan2
Fagiano Okayama,8,3,3,2,10,10,0,12,japan2
Jubilo Iwata,8,3,2,3,9,7,2,11,japan2
Kusatsu,8,3,2,3,9,9,0,11,japan2
V-V. Nagasaki,8,2,4,2,13,13,0,10,japan2
Ventforet Kofu,8,2,4,2,12,12,0,10,japan2
Mito Hollyhock,8,2,4,2,7,7,0,10,japan2
R. Kumamoto,8,3,1,4,9,10,-1,10,japan2
Tochigi SC,8,3,1,4,4,8,-4,10,japan2
M. Yamagata,8,3,1,4,6,14,-8,10,japan2
Oita Trinita,8,2,3,3,11,11,0,9,japan2
Vegalta Sendai,8,2,2,4,11,16,-5,8,japan2
Z. Kanazawa,8,1,2,5,7,12,-5,5,japan2
Fujieda MYFC,8,1,2,5,9,18,-9,5,japan2
R. Yamaguchi,8,1,2,5,3,12,-9,5,japan2
Al Hussein,3,3,0,0,8,0,8,9,jordan
Al Ramtha,4,2,0,2,7,3,4,6,jordan
Moghayer Al S.,2,1,1,0,5,3,2,4,jordan
Al Salt,4,1,1,2,5,5,0,4,jordan
Al Wihdat,1,1,0,0,1,0,1,3,jordan
Sahab,3,0,3,0,6,6,0,3,jordan
Al Faysali,2,1,0,1,3,3,0,3,jordan
Aqaba,1,0,1,0,0,0,0,1,jordan
Al Jalil,2,0,1,1,2,3,-1,1,jordan
Maan,3,0,1,2,2,8,-6,1,jordan
Al Ahli,3,0,0,3,1,4,-3,0,jordan
Shabab Al Ordon,3,0,0,3,0,9,-9,0,jordan
Ordabasy,8,5,2,1,13,6,7,17,kazakhstan
Aktobe,8,3,5,0,8,5,3,14,kazakhstan
Zhetysu,8,4,1,3,10,9,1,13,kazakhstan
Kaisar K.,8,3,3,2,11,8,3,12,kazakhstan
Maqtaaral,8,3,2,3,8,7,1,11,kazakhstan
FC Astana,8,3,2,3,5,6,-1,11,kazakhstan
Okzhetpes,8,3,0,5,7,13,-6,9,kazakhstan
Kairat Almaty,8,2,2,4,8,12,-4,8,kazakhstan
Atyrau,8,1,3,4,7,10,-3,6,kazakhstan
S. Karagandy,8,1,3,4,8,13,-5,6,kazakhstan
Tobol,8,1,3,4,8,13,-5,6,kazakhstan
Kyzylzhar,8,1,2,5,7,13,-6,5,kazakhstan
Kaspiy Aktau,8,0,3,5,8,15,-7,3,kazakhstan
Aksu,8,0,1,7,4,16,-12,1,kazakhstan
Drita,5,3,2,0,7,2,5,11,kosovo
Llapi,5,3,0,2,9,7,2,9,kosovo
Ballkani,4,2,2,0,5,2,3,8,kosovo
Dukagjini,5,1,3,1,9,11,-2,6,kosovo
Malisheva,5,2,0,3,5,7,-2,6,kosovo
Prishtina,5,0,4,1,2,5,-3,4,kosovo
Feronikeli,5,1,1,3,8,13,-5,4,kosovo
Liria,5,0,2,3,2,8,-6,2,kosovo
Gjilani,5,0,0,5,2,9,-7,0,kosovo
Fushe Kosova,5,0,0,5,2,13,-11,0,kosovo
Al Qadsia,3,3,0,0,6,1,5,9,kuwait
Al Kuwait,2,2,0,0,9,3,6,6,kuwait
Kazma,2,1,1,0,5,4,1,4,kuwait
Al Shabab,3,1,1,1,3,6,-3,4,kuwait
Al Nasar,2,1,0,1,4,3,1,3,kuwait
Al Salmiyah,3,1,0,2,4,6,-2,3,kuwait
Al Arabi SC,2,0,2,0,2,2,0,2,kuwait
Khaitan,3,0,2,1,2,6,-4,2,kuwait
Al Fahaheel,3,0,1,2,1,5,-4,1,kuwait
Al Jahra,3,0,0,3,3,7,-4,0,kuwait
Riga FC,8,6,1,1,19,3,16,19,latvia
RFS,8,5,2,1,21,10,11,17,latvia
Auda,8,4,2,2,13,8,5,14,latvia
FS Jelgava,8,3,3,2,11,11,0,12,latvia
Liepaja,8,2,3,3,11,13,-2,9,latvia
Daugavpils,8,2,3,3,4,9,-5,9,latvia
Valmiera,8,2,2,4,8,12,-4,8,latvia
Tukums,8,2,1,5,8,25,-17,7,latvia
Super Nova,8,1,2,5,5,14,-9,5,latvia
Metta / LU,8,1,1,6,10,20,-10,4,latvia
Panevezys,8,6,2,0,11,2,9,20,lithuania
Zalgiris,8,6,1,1,21,8,13,19,lithuania
Hegelmann L.,8,6,1,1,16,11,5,19,lithuania
Kauno Zalgiris,8,3,4,1,14,9,5,13,lithuania
Dziugas Telsiai,8,2,4,2,4,6,-2,10,lithuania
Banga,8,3,0,5,4,8,-4,9,lithuania
FA Siauliai,8,2,2,4,9,14,-5,8,lithuania
Suduva,8,2,2,4,9,15,-6,8,lithuania
Riteriai,8,2,1,5,7,13,-6,7,lithuania
Dainava,8,1,3,4,5,9,-4,6,lithuania
Be1 NFA,8,6,1,1,16,4,12,19,lithuania2
Riteriai B,8,5,3,0,18,8,10,18,lithuania2
TransINVEST,8,5,2,1,20,6,14,17,lithuania2
Ekranas,8,4,1,3,16,15,1,13,lithuania2
BFA Vilnius,8,3,3,2,15,8,7,12,lithuania2
Neptuna K.,8,3,3,2,14,11,3,12,lithuania2
Garliava,8,2,4,2,14,11,3,10,lithuania2
Minija,8,3,1,4,10,14,-4,10,lithuania2
Babrungas,8,3,1,4,10,18,-8,10,lithuania2
Marijampole C.,8,2,0,6,7,20,-13,6,lithuania2
Nevezis,8,1,2,5,9,16,-7,5,lithuania2
Panevezys B,8,1,2,5,14,25,-11,5,lithuania2
Zalgiris B,8,1,2,5,7,19,-12,5,lithuania2
Kauno Z. B,8,1,2,5,4,16,-12,5,lithuania2
Jonava,8,1,1,6,11,20,-9,4,lithuania2
FA Siauliai B,8,1,0,7,8,25,-17,3,lithuania2
Hesperang,6,4,0,2,15,6,9,12,luxembourg
Differdange,5,2,3,0,9,6,3,9,luxembourg
Jeunesse Esch,5,2,2,1,7,5,2,8,luxembourg
V. Rosport,5,2,2,1,9,8,1,8,luxembourg
Mondercange,5,2,1,2,5,9,-4,7,luxembourg
Niedercorn,5,1,3,1,10,10,0,6,luxembourg
Marisca Mersch,5,2,0,3,9,10,-1,6,luxembourg
Wiltz,5,1,2,2,5,8,-3,5,luxembourg
UNA Strassen,4,1,1,2,6,6,0,4,luxembourg
Racing,5,1,1,3,6,8,-2,4,luxembourg
Dudelange,5,1,1,3,5,10,-5,4,luxembourg
Petange,5,1,1,3,5,10,-5,4,luxembourg
Mondorf,5,0,3,2,7,10,-3,3,luxembourg
Schifflange,5,1,0,4,3,10,-7,3,luxembourg
UN Käerjéng,5,0,1,4,6,13,-7,1,luxembourg
Fola Esch,5,0,0,5,6,17,-11,0,luxembourg
Johor Darul,8,7,1,0,28,5,23,22,malaysia
Selangor,8,5,0,3,30,7,23,15,malaysia
Terengganu,8,4,3,1,23,11,12,15,malaysia
Pahang,8,5,0,3,15,11,4,15,malaysia
Kedah,8,5,0,3,10,12,-2,15,malaysia
Kuala Lumpur,8,3,1,4,13,16,-3,10,malaysia
PDRM,8,3,1,4,11,16,-5,10,malaysia
Perak,8,3,0,5,7,16,-9,9,malaysia
Sabah,8,2,1,5,7,12,-5,7,malaysia
Negeri Sembilan,8,1,3,4,9,15,-6,6,malaysia
Kelantan United,8,0,3,5,7,19,-12,3,malaysia
Kuching,8,0,2,6,10,17,-7,2,malaysia
Pulau Pinang,8,0,1,7,2,14,-12,1,malaysia
Kelantan,8,0,1,7,8,34,-26,1,malaysia
Kelantan,8,6,1,1,14,5,9,19,malaysia2
Johor Darul B,8,4,3,1,12,5,7,15,malaysia2
Terengganu B,8,4,2,2,17,12,5,14,malaysia2
Kelantan United,8,4,2,2,10,8,2,14,malaysia2
Kuching,8,3,3,2,13,7,6,12,malaysia2
Perak,8,4,0,4,7,8,-1,12,malaysia2
UiTM,8,3,1,4,6,10,-4,10,malaysia2
Selangor B,8,2,1,5,7,13,-6,7,malaysia2
PDRM,8,1,2,5,8,16,-8,5,malaysia2
Skuad Projek,8,1,2,5,5,14,-9,5,malaysia2
Valletta,8,6,1,1,20,8,12,19,malta
Hamrun Spartans,8,6,1,1,14,7,7,19,malta
Balzan,8,6,1,1,14,8,6,19,malta
Gzira Utd,8,5,2,1,16,3,13,17,malta
Mosta,8,5,1,2,14,8,6,16,malta
Hibernians,8,5,0,3,16,12,4,15,malta
Floriana,8,4,1,3,14,8,6,13,malta
Sirens,8,4,1,3,6,7,-1,13,malta
Birkirkara,8,3,3,2,13,8,5,12,malta
Marsaxlokk,8,2,4,2,10,9,1,10,malta
Gudja Utd,8,1,3,4,6,13,-7,6,malta
Pieta Hotspurs,8,1,2,5,9,16,-7,5,malta
Zebbug Rangers,8,1,1,6,4,19,-15,4,malta
Santa Lucia,8,1,0,7,6,17,-11,3,malta
Monterrey,7,3,2,2,8,7,1,11,mexico
CF America,4,3,1,0,8,5,3,10,mexico
Pumas UNAM,8,3,1,4,12,12,0,10,mexico
Cruz Azul,8,3,1,4,11,12,-1,10,mexico
Atlas,8,2,3,3,7,11,-4,9,mexico
Queretaro,8,3,0,5,8,20,-12,9,mexico
Tigres,6,2,2,2,9,8,1,8,mexico
Mazatlan,7,2,2,3,11,11,0,8,mexico
Guadalajara,6,2,2,2,7,9,-2,8,mexico
Puebla,6,2,2,2,7,9,-2,8,mexico
Juarez,6,2,1,3,9,13,-4,7,mexico
Toluca,6,1,3,2,6,6,0,6,mexico
A. San Luis,6,2,0,4,10,12,-2,6,mexico
Necaxa,7,1,3,3,9,13,-4,6,mexico
Pachuca,7,1,3,3,3,15,-12,6,mexico
Club Leon,6,1,2,3,5,9,-4,5,mexico
Santos Laguna,5,1,1,3,12,14,-2,4,mexico
Tijuana,7,0,1,6,3,12,-9,1,mexico
Monterrey,8,6,1,1,14,7,7,19,mexico2
CF America,8,5,3,0,19,10,9,18,mexico2
Pachuca,8,6,0,2,15,9,6,18,mexico2
Guadalajara,8,4,3,1,12,8,4,15,mexico2
Tigres,8,4,2,2,9,7,2,14,mexico2
Club Leon,8,3,4,1,9,7,2,13,mexico2
Atlas,8,2,5,1,14,9,5,11,mexico2
Toluca,8,3,2,3,14,11,3,11,mexico2
Queretaro,8,2,3,3,6,9,-3,9,mexico2
Puebla,8,2,2,4,11,13,-2,8,mexico2
Cruz Azul,8,2,2,4,10,12,-2,8,mexico2
Santos Laguna,8,1,3,4,9,16,-7,6,mexico2
Juarez,8,1,3,4,7,15,-8,6,mexico2
Pumas UNAM,8,1,2,5,7,15,-8,5,mexico2
Necaxa,8,1,1,6,6,13,-7,4,mexico2
Tijuana,8,1,1,6,9,21,-12,4,mexico2
Mazatlan,8,1,1,6,8,23,-15,4,mexico2
A. San Luis,8,0,1,7,3,14,-11,1,mexico2
SP Falcons,4,4,0,0,9,0,9,12,mongolia
Khoromkhon,4,4,0,0,9,5,4,12,mongolia
FC Ulaanbaatar,4,3,0,1,9,2,7,9,mongolia
Deren,4,2,2,0,8,1,7,8,mongolia
Erchim,4,2,2,0,15,9,6,8,mongolia
Bavarians,4,2,0,2,7,11,-4,6,mongolia
Tuv Buganuud,3,1,1,1,9,10,-1,4,mongolia
Khangarid,4,0,2,2,5,7,-2,2,mongolia
Khovd,4,0,1,3,3,11,-8,1,mongolia
Bayanzurkh S.,4,0,0,4,2,13,-11,0,mongolia
Decic,6,4,2,0,8,3,5,14,montenegro
Buducnost,7,4,1,2,14,7,7,13,montenegro
Jezero,6,3,3,0,10,7,3,12,montenegro
Sutjeska,6,2,4,0,8,3,5,10,montenegro
Mornar,7,2,4,1,6,6,0,10,montenegro
Petrovac,7,2,2,3,7,8,-1,8,montenegro
Arsenal Tivat,6,2,2,2,6,7,-1,8,montenegro
Jedinstvo,7,0,3,4,9,14,-5,3,montenegro
Mladost DG,7,0,3,4,8,14,-6,3,montenegro
Rudar,6,1,0,5,1,8,-7,3,montenegro
Wydad,3,2,1,0,6,2,4,7,morocco
FUS Rabat,4,2,1,1,6,3,3,7,morocco
Moghreb Tetouan,4,2,0,2,4,3,1,6,morocco
Raja Casablanca,3,1,2,0,5,3,2,5,morocco
Maghreb de Fes,3,1,2,0,4,2,2,5,morocco
FAR Rabat,3,1,1,1,6,4,2,4,morocco
Berkane,2,1,1,0,3,1,2,4,morocco
Olympic Safi,3,1,1,1,3,3,0,4,morocco
C. Mohammedia,4,1,1,2,1,3,-2,4,morocco
Union Touarga,2,1,0,1,3,2,1,3,morocco
Salmi,3,1,0,2,2,4,-2,3,morocco
Mouloudia Oujda,3,0,2,1,1,3,-2,2,morocco
Ittihad Tanger,2,0,1,1,3,4,-1,1,morocco
Hassania Agadir,4,0,1,3,2,7,-5,1,morocco
Youssoufia B.,3,0,0,3,2,6,-4,0,morocco
R. Zemamra,3,0,0,3,3,8,-5,0,morocco
Chabab Atlas K.,4,2,2,0,4,1,3,8,morocco2
Difaa El Jadida,4,2,2,0,3,1,2,8,morocco2
C. Benguerir,4,2,1,1,3,2,1,7,morocco2
Kawkab M.,3,2,0,1,3,1,2,6,morocco2
El Massira,3,1,2,0,5,3,2,5,morocco2
Meknes,4,1,2,1,5,5,0,5,morocco2
Ittifaq M.,4,1,1,2,1,4,-3,4,morocco2
RAC Casablanca,3,1,0,2,1,2,-1,3,morocco2
Dcheira,3,0,2,1,4,5,-1,2,morocco2
Khouribga,4,0,2,2,2,4,-2,2,morocco2
Stade Marocain,3,0,2,1,2,4,-2,2,morocco2
Wydad Fès,3,0,2,1,2,4,-2,2,morocco2
USM Oujda,4,0,2,2,3,7,-4,2,morocco2
R. Beni Mellal,2,0,1,1,2,3,-1,1,morocco2
Rapide Oued Z.,3,0,1,2,0,2,-2,1,morocco2
AS Salé,3,0,0,3,3,7,-4,0,morocco2
Yangon Utd,8,7,0,1,22,5,17,21,myanmar
Shan Utd,8,6,2,0,20,6,14,20,myanmar
Ispe FC,8,3,3,2,13,11,2,12,myanmar
Rakhine Utd,8,3,3,2,12,11,1,12,myanmar
Myawady,8,3,2,3,10,14,-4,11,myanmar
Sagaing Utd,8,3,2,3,12,17,-5,11,myanmar
Hantharwady,7,3,1,3,11,9,2,10,myanmar
Dagon,8,2,3,3,9,10,-1,9,myanmar
Ayeyawady,8,2,1,5,9,19,-10,7,myanmar
Yadanarbon,7,1,2,4,10,12,-2,5,myanmar
Kachin Utd,8,1,1,6,8,18,-10,4,myanmar
Chinland,8,0,1,7,6,31,-25,1,myanmar
PSV Eindhoven,4,4,0,0,15,1,14,12,netherlands
AZ Alkmaar,4,4,0,0,10,2,8,12,netherlands
Feyenoord,4,3,1,0,13,3,10,10,netherlands
FC Twente,5,3,1,1,11,4,7,10,netherlands
Excelsior,4,2,1,1,8,6,2,7,netherlands
PEC Zwolle,5,2,1,2,9,9,0,7,netherlands
Sparta,5,2,1,2,6,6,0,7,netherlands
Vitesse Arnhem,5,2,0,3,5,8,-3,6,netherlands
Almere City,5,1,2,2,5,9,-4,5,netherlands
RKC Waalwijk,4,1,0,3,3,7,-4,3,netherlands
FC Utrecht,5,1,0,4,3,8,-5,3,netherlands
Heerenveen,5,1,0,4,5,13,-8,3,netherlands
Ajax Amsterdam,4,0,2,2,6,9,-3,2,netherlands
NEC Nijmegen,4,0,2,2,3,8,-5,2,netherlands
Heracles Almelo,4,0,2,2,4,11,-7,2,netherlands
Fortuna Sittard,5,0,2,3,3,12,-9,2,netherlands
Go Ahead Eagles,4,0,1,3,3,12,-9,1,netherlands
FC Volendam,4,0,0,4,4,12,-8,0,netherlands
ADO Den Haag,7,4,3,0,10,4,6,15,netherlands2
FC Eindhoven,7,4,2,1,9,6,3,14,netherlands2
FC Emmen,6,3,3,0,10,6,4,12,netherlands2
VVV,6,2,3,1,8,9,-1,9,netherlands2
De Graafschap,6,3,0,3,9,12,-3,9,netherlands2
Roda JC,5,2,2,1,7,3,4,8,netherlands2
Willem II,5,2,2,1,4,2,2,8,netherlands2
FC Dordrecht,5,2,2,1,7,6,1,8,netherlands2
NAC Breda,6,2,2,2,11,11,0,8,netherlands2
MVV Maastricht,6,2,1,3,12,12,0,7,netherlands2
Helmond Sport,6,2,1,3,10,10,0,7,netherlands2
FC Groningen,5,2,0,3,7,7,0,6,netherlands2
Jong PSV,5,2,0,3,7,15,-8,6,netherlands2
Cambuur,5,1,1,3,9,13,-4,4,netherlands2
FC Den Bosch,6,1,0,5,7,16,-9,3,netherlands2
Jong AZ,5,0,1,4,4,11,-7,1,netherlands2
TOP Oss,7,0,1,6,3,12,-9,1,netherlands2
Telstar,6,0,1,5,3,13,-10,1,netherlands2
Jong Utrecht,6,0,1,5,4,16,-12,1,netherlands2
Jong Ajax,7,0,0,7,9,24,-15,0,netherlands2
Real Esteli,6,4,1,1,14,4,10,13,nicaragua
Export Sebaco,8,4,1,3,12,18,-6,13,nicaragua
Diriangen,7,3,2,2,11,7,4,11,nicaragua
UNAN Managua,6,2,2,2,9,9,0,8,nicaragua
Managua FC,7,1,4,2,8,8,0,7,nicaragua
Jalapa,6,2,1,3,8,12,-4,7,nicaragua
Matagalpa,7,1,2,4,8,12,-4,5,nicaragua
O. Masachapa,6,1,1,4,3,9,-6,4,nicaragua
D. Ocotal,7,1,0,6,9,16,-7,3,nicaragua
Walter Ferreti,7,0,2,5,4,14,-10,2,nicaragua
Bendel,8,2,6,0,8,6,2,12,nigeria
Enyimba,8,3,1,4,6,7,-1,10,nigeria
Akwa Utd,8,2,3,3,9,8,1,9,nigeria
Remo Stars,8,2,3,3,7,12,-5,9,nigeria
Rivers Utd,8,1,5,2,9,10,-1,8,nigeria
Plateau Utd,8,1,3,4,11,14,-3,6,nigeria
Lobi Stars,8,1,3,4,4,10,-6,6,nigeria
Sunshine Stars,8,1,2,5,7,10,-3,5,nigeria
Enugu Rangers,8,0,5,3,4,7,-3,5,nigeria
Bayelsa Utd,8,1,2,5,7,13,-6,5,nigeria
Shooting Stars,8,1,2,5,3,10,-7,5,nigeria
Niger Tornadoes,8,1,1,6,6,13,-7,4,nigeria
Wikki Tourist,8,1,1,6,4,13,-9,4,nigeria
Gombe Utd,8,0,4,4,1,12,-11,4,nigeria
Kwara Utd,8,1,1,6,4,16,-12,4,nigeria
Abia Warriors,8,1,1,6,6,19,-13,4,nigeria
Nasarawa Utd,8,0,3,5,4,10,-6,3,nigeria
Doma Utd,8,0,3,5,2,10,-8,3,nigeria
El Kanemi,8,1,0,7,3,16,-13,3,nigeria
Dakkada,8,0,0,8,2,15,-13,0,nigeria
Linfield,7,6,0,1,12,6,6,18,northernireland
Crusaders,7,4,2,1,17,7,10,14,northernireland
Cliftonville,6,4,0,2,10,3,7,12,northernireland
Glentoran,6,4,0,2,9,6,3,12,northernireland
Loughgall,6,3,2,1,10,10,0,11,northernireland
Coleraine,7,3,1,3,9,14,-5,10,northernireland
Larne,6,2,3,1,7,3,4,9,northernireland
Newry City,7,3,0,4,10,17,-7,9,northernireland
Ballymena Utd,6,2,0,4,3,7,-4,6,northernireland
Carrick Rangers,7,1,1,5,9,27,-18,4,northernireland
Dungannon,6,0,3,3,7,15,-8,3,northernireland
Glenavon,7,0,1,6,7,21,-14,1,northernireland
Dundela,7,5,0,2,14,12,2,15,northernireland2
Portadown,6,4,0,2,10,6,4,12,northernireland2
Bangor,7,3,1,3,12,10,2,10,northernireland2
Annagh Utd,6,3,1,2,7,9,-2,10,northernireland2
Newington Youth,6,3,0,3,11,9,2,9,northernireland2
Ards,5,2,2,1,5,4,1,8,northernireland2
Institute,4,2,1,1,5,4,1,7,northernireland2
H&W Welders,6,1,1,4,8,12,-4,4,northernireland2
Ballinamallard,6,1,1,4,7,11,-4,4,northernireland2
Dergview,6,1,1,4,11,17,-6,4,northernireland2
Ballyclare,6,1,1,4,8,14,-6,4,northernireland2
Knockbreda,6,0,0,6,2,17,-15,0,northernireland2
Skendija,6,4,1,1,10,6,4,13,northmacedonia
Struga,5,3,0,2,7,4,3,9,northmacedonia
Shkupi,6,2,3,1,6,6,0,9,northmacedonia
Sileks,6,1,3,2,7,9,-2,6,northmacedonia
Gostivar,6,2,0,4,5,10,-5,6,northmacedonia
A. Pandev,5,1,1,3,3,5,-2,4,northmacedonia
Vardar,5,1,1,3,3,5,-2,4,northmacedonia
Tikves,5,1,0,4,4,7,-3,3,northmacedonia
Voska Sport,5,0,2,3,4,10,-6,2,northmacedonia
Makedonija,6,0,1,5,4,9,-5,1,northmacedonia
Rabotnicki,5,0,1,4,1,7,-6,1,northmacedonia
Bregalnica Stip,5,0,0,5,1,8,-7,0,northmacedonia
Viking,8,6,1,1,14,8,6,19,norway
Brann,8,5,0,3,12,10,2,15,norway
Tromso,8,5,0,3,13,13,0,15,norway
Bodo / Glimt,8,4,2,2,20,14,6,14,norway
Molde,8,3,3,2,14,10,4,12,norway
Valerenga,8,2,3,3,9,11,-2,9,norway
Stromsgodset,8,3,0,5,4,8,-4,9,norway
HamKam,8,3,0,5,11,17,-6,9,norway
Lillestrom,8,2,2,4,9,13,-4,8,norway
Odd,8,2,1,5,12,18,-6,7,norway
Sarpsborg 08,8,2,1,5,13,20,-7,7,norway
Rosenborg,8,2,1,5,8,18,-10,7,norway
Haugesund,8,1,3,4,7,9,-2,6,norway
Stabaek,8,0,3,5,6,14,-8,3,norway
Sandefjord,8,1,0,7,16,27,-11,3,norway
Aalesund,8,1,0,7,8,26,-18,3,norway
Fredrikstad,8,6,1,1,17,9,8,19,norway2
KFUM Oslo,8,5,1,2,16,10,6,16,norway2
Kongsvinger,8,4,2,2,15,10,5,14,norway2
Kristiansund,8,3,3,2,15,13,2,12,norway2
Ranheim,8,4,0,4,6,13,-7,12,norway2
Sandnes Ulf,8,3,2,3,11,11,0,11,norway2
Sogndal,8,3,2,3,12,13,-1,11,norway2
Raufoss,8,3,1,4,10,14,-4,10,norway2
Bryne,8,3,0,5,11,11,0,9,norway2
Asane,8,2,2,4,12,16,-4,8,norway2
Moss,8,1,3,4,7,14,-7,6,norway2
Hodd,8,2,0,6,5,15,-10,6,norway2
Start,8,1,2,5,5,11,-6,5,norway2
Mjondalen,8,1,2,5,6,14,-8,5,norway2
Jerv,8,1,2,5,14,26,-12,5,norway2
Skeid,8,0,1,7,0,14,-14,1,norway2
Al Seeb,4,3,1,0,8,0,8,10,oman
Sohar,5,3,1,1,9,4,5,10,oman
Al-Nahda,4,2,2,0,9,6,3,8,oman
Al-Shabab Club,5,2,2,1,7,6,1,8,oman
Al Wehda,4,2,1,1,5,5,0,7,oman
Ibri,4,2,0,2,5,4,1,6,oman
Al-Rustaq,4,1,2,1,4,4,0,5,oman
Sur,3,1,1,1,2,2,0,4,oman
Al Nasr,4,1,1,2,1,2,-1,4,oman
Dhofar,4,1,1,2,6,8,-2,4,oman
Oman Club,3,1,1,1,3,5,-2,4,oman
Bahla,4,1,0,3,1,4,-3,3,oman
Independiente,8,4,2,2,15,10,5,14,panama
Plaza Amador,8,4,2,2,13,9,4,14,panama
Arabe Unido,8,3,3,2,8,5,3,12,panama
San Miguelito,8,3,3,2,7,5,2,12,panama
Tauro,8,3,3,2,7,7,0,12,panama
Herrera,8,2,4,2,8,7,1,10,panama
Alianza,8,2,2,4,5,10,-5,8,panama
UMECIT,8,1,4,3,2,7,-5,7,panama
San Francisco,8,1,4,3,3,9,-6,7,panama
Costa del Este,8,2,1,5,9,17,-8,7,panama
Universitario,8,2,1,5,7,15,-8,7,panama
A. Chiriqui,8,0,0,8,5,22,-17,0,panama
Tauro,7,4,2,1,14,5,9,14,panama2
San Francisco,8,4,1,3,10,5,5,13,panama2
Independiente,7,3,3,1,14,8,6,12,panama2
Arabe Unido,8,3,3,2,9,6,3,12,panama2
Alianza,8,3,3,2,9,11,-2,12,panama2
Costa del Este,8,3,2,3,10,11,-1,11,panama2
Universitario,7,2,3,2,7,12,-5,9,panama2
UMECIT,8,2,1,5,10,13,-3,7,panama2
Herrera,8,2,1,5,10,16,-6,7,panama2
San Miguelito,7,1,3,3,5,8,-3,6,panama2
Plaza Amador,7,1,1,5,5,9,-4,4,panama2
A. Chiriqui,7,0,2,5,1,19,-18,2,panama2
S. Ameliano,8,4,2,2,10,7,3,14,paraguay
Cerro Porteno,8,4,2,2,14,14,0,14,paraguay
Libertad,8,4,1,3,12,9,3,13,paraguay
Guarani,8,3,4,1,10,8,2,13,paraguay
Olimpia,8,3,2,3,10,8,2,11,paraguay
S. Trinidense,8,3,2,3,10,9,1,11,paraguay
Nacional,8,3,2,3,8,10,-2,11,paraguay
S. Luqueno,8,2,3,3,12,14,-2,9,paraguay
G. Caballero,8,2,2,4,6,11,-5,8,paraguay
Guairena,8,1,4,3,6,10,-4,7,paraguay
Resistencia,8,1,1,6,4,15,-11,4,paraguay
Tacuary,8,1,0,7,2,10,-8,3,paraguay
Libertad,8,6,2,0,19,4,15,20,paraguay2
Cerro Porteno,8,4,3,1,15,8,7,15,paraguay2
S. Trinidense,8,4,1,3,13,12,1,13,paraguay2
Guarani,8,3,2,3,8,12,-4,11,paraguay2
S. Ameliano,8,3,1,4,15,17,-2,10,paraguay2
Nacional,8,2,3,3,8,9,-1,9,paraguay2
Tacuary,8,2,3,3,8,11,-3,9,paraguay2
Olimpia,8,2,3,3,6,10,-4,9,paraguay2
S. Luqueno,8,2,2,4,8,10,-2,8,paraguay2
Resistencia,8,2,2,4,9,14,-5,8,paraguay2
Guairena,8,2,1,5,10,15,-5,7,paraguay2
G. Caballero,8,2,1,5,8,13,-5,7,paraguay2
Alianza Lima,8,5,0,3,12,9,3,15,peru
S. Cristal,8,3,4,1,15,10,5,13,peru
Universitario,8,3,1,4,8,9,-1,10,peru
Carlos Manucci,8,3,0,5,5,13,-8,9,peru
D. Garcilaso,8,2,2,4,12,13,-1,8,peru
FBC Melgar,8,1,5,2,7,8,-1,8,peru
D. Municipal,8,2,2,4,6,9,-3,8,peru
Sport Huancayo,8,2,2,4,10,14,-4,8,peru
Cusco,8,2,2,4,8,12,-4,8,peru
ADT,8,1,3,4,9,12,-3,6,peru
Cienciano,8,2,0,6,9,19,-10,6,peru
Sport Boys,8,1,2,5,3,11,-8,5,peru
Cajamarca,8,1,2,5,8,17,-9,5,peru
Alianza A.,8,1,1,6,12,20,-8,4,peru
Cesar Vallejo,8,0,4,4,5,15,-10,4,peru
Union Comercio,8,1,1,6,7,20,-13,4,peru
Atletico Grau,8,0,2,6,7,14,-7,2,peru
Binacional,8,0,2,6,6,18,-12,2,peru
AD Cantolao,8,0,1,7,2,21,-19,1,peru
FBC Melgar,8,5,3,0,10,4,6,18,peru2
Alianza Lima,8,4,3,1,9,5,4,15,peru2
Cesar Vallejo,8,4,1,3,12,6,6,13,peru2
Universitario,8,3,4,1,9,6,3,13,peru2
ADT,8,3,4,1,9,7,2,13,peru2
D. Garcilaso,8,2,4,2,9,9,0,10,peru2
S. Cristal,8,2,4,2,8,10,-2,10,peru2
Cienciano,8,2,2,4,10,12,-2,8,peru2
Sport Boys,8,2,2,4,5,12,-7,8,peru2
AD Cantolao,8,2,1,5,5,10,-5,7,peru2
Sport Huancayo,8,1,3,4,5,8,-3,6,peru2
Carlos Manucci,8,1,2,5,7,14,-7,5,peru2
Atletico Grau,8,1,2,5,5,14,-9,5,peru2
Cajamarca,8,0,4,4,6,14,-8,4,peru2
Union Comercio,8,0,3,5,6,18,-12,3,peru2
D. Municipal,8,1,0,7,6,22,-16,3,peru2
Alianza A.,8,0,2,6,2,13,-11,2,peru2
Cusco,8,0,1,7,4,15,-11,1,peru2
Binacional,8,0,1,7,8,20,-12,1,peru2
Comerciantes U.,8,5,1,2,12,7,5,16,peru3
A. Huanuco,8,3,3,2,10,8,2,12,peru3
Santa Rosa,8,3,2,3,13,11,2,11,peru3
Llacuabamba,8,3,2,3,14,15,-1,11,peru3
D. Coopsol,8,2,3,3,8,9,-1,9,peru3
Juan Aurich,8,2,2,4,6,9,-3,8,peru3
U. San Martin,8,1,4,3,9,10,-1,7,peru3
Ayacucho,8,1,3,4,11,17,-6,6,peru3
Santos FC,8,1,3,4,7,13,-6,6,peru3
Comerciantes,8,1,2,5,3,11,-8,5,peru3
Alfonso Ugarte,8,0,3,5,4,18,-14,3,peru3
Huaral,8,0,2,6,3,12,-9,2,peru3
Carlos Stein,8,0,2,6,10,34,-24,2,peru3
M. El Pirata,8,0,1,7,3,30,-27,1,peru3
Kaya,8,7,1,0,29,5,24,22,philippines
Cebu FC,8,6,2,0,19,8,11,20,philippines
Stallion,8,4,1,3,12,5,7,13,philippines
United City,6,3,1,2,18,10,8,10,philippines
Mendiola,8,3,0,5,9,15,-6,9,philippines
Azkals,8,2,0,6,7,20,-13,6,philippines
Maharlika,8,1,0,7,4,24,-20,3,philippines
Slask Wroclaw,6,4,1,1,10,5,5,13,poland
Pogon Szczecin,6,3,1,2,9,3,6,10,poland
Cracovia Krakow,6,2,3,1,6,5,1,9,poland
Warta Poznan,6,2,2,2,8,7,1,8,poland
Gornik Zabrze,7,2,2,3,10,10,0,8,poland
Jagiellonia,6,2,2,2,11,12,-1,8,poland
Lech Poznan,5,2,1,2,6,10,-4,7,poland
Rakow C.,5,2,0,3,10,12,-2,6,poland
Radomiak Radom,6,2,0,4,6,10,-4,6,poland
Zaglebie Lubin,6,2,0,4,7,12,-5,6,poland
Piast Gliwice,6,0,5,1,3,4,-1,5,poland
Korona Kielce,6,1,2,3,6,9,-3,5,poland
Legia Warsaw,5,1,2,2,6,11,-5,5,poland
Ruch Chorzow,6,0,3,3,5,10,-5,3,poland
Widzew Lodz,6,0,2,4,7,12,-5,2,poland
Stal Mielec,5,0,1,4,2,7,-5,1,poland
Puszcza Niepolo,7,0,1,6,8,20,-12,1,poland
LKS Lodz,7,0,0,7,2,15,-13,0,poland
Polonia Warszaw,6,4,1,1,11,6,5,13,poland2
Motor Lublin,6,4,0,2,5,4,1,12,poland2
T. Nieciecza,7,3,2,2,16,8,8,11,poland2
Odra Opole,4,3,1,0,10,4,6,10,poland2
Miedz Legnica,5,3,1,1,12,7,5,10,poland2
Gornik Leczna,5,2,3,0,4,2,2,9,poland2
Tychy,7,3,0,4,9,13,-4,9,poland2
Wisla Krakow,6,2,2,2,11,9,2,8,poland2
Stal Rzeszow,5,2,1,2,6,6,0,7,poland2
Arka Gdynia,6,2,1,3,7,9,-2,7,poland2
Z. Sosnowiec,7,1,3,3,5,7,-2,6,poland2
Lechia Gdansk,6,1,3,2,7,10,-3,6,poland2
Katowice,7,1,3,3,6,10,-4,6,poland2
Wisla Plock,7,1,3,3,4,11,-7,6,poland2
Znicz Pruszkow,7,1,1,5,5,13,-8,4,poland2
Resovia Rzeszow,7,1,0,6,4,17,-13,3,poland2
Chrobry Glogow,6,0,2,4,6,12,-6,2,poland2
Podbeskidzie,6,0,2,4,3,12,-9,2,poland2
Pogon Siedlce,7,3,3,1,11,6,5,12,poland3
Radunia Stezyca,7,3,3,1,7,8,-1,12,poland3
K. Kolobrzeg,7,3,2,2,16,12,4,11,poland3
Kalisz,6,3,2,1,7,3,4,11,poland3
SKRA Czestochow,7,2,3,2,7,7,0,9,poland3
Lech Poznan B,8,2,2,4,10,12,-2,8,poland3
LKS Lodz B,7,2,2,3,9,11,-2,8,poland3
Chojniczanka,7,2,1,4,9,12,-3,7,poland3
Zaglebie L. B,7,2,1,4,8,11,-3,7,poland3
Hutnik Krakow,6,2,1,3,4,7,-3,7,poland3
Stomil Olsztyn,5,2,0,3,8,9,-1,6,poland3
Olimpia Elblag,6,1,2,3,5,8,-3,5,poland3
Sandecja Nowy,8,1,2,5,4,10,-6,5,poland3
Stalowa Wola,8,1,2,5,3,11,-8,5,poland3
O. Grudziadz,7,1,1,5,7,16,-9,4,poland3
Wisla Pulawy,5,1,0,4,7,12,-5,3,poland3
Polonia Bytom,8,0,3,5,5,13,-8,3,poland3
Jastrzebie,6,0,2,4,3,9,-6,2,poland3
Benfica,5,4,0,1,11,7,4,12,portugal
Moreirense,5,3,1,1,7,4,3,10,portugal
Sporting Braga,4,3,0,1,12,9,3,9,portugal
FC Porto,4,3,0,1,5,3,2,9,portugal
Sporting CP,3,2,1,0,6,4,2,7,portugal
Casa Pia,4,2,1,1,5,3,2,7,portugal
Boavista,4,2,1,1,8,7,1,7,portugal
Guimaraes,4,2,1,1,4,5,-1,7,portugal
Portimonense,5,2,1,2,6,10,-4,7,portugal
Famalicao,4,1,2,1,5,5,0,5,portugal
Estrela Amadora,4,1,2,1,4,5,-1,5,portugal
Chaves,4,1,0,3,3,11,-8,3,portugal
Arouca,4,0,2,2,4,6,-2,2,portugal
Vizela,4,0,2,2,4,7,-3,2,portugal
Rio Ave,4,0,1,3,2,7,-5,1,portugal
Farense,3,0,0,3,1,4,-3,0,portugal
Estoril,4,0,0,4,9,14,-5,0,portugal
Gil Vicente,4,0,0,4,4,9,-5,0,portugal
Al Rayyan,4,3,0,1,9,6,3,9,qatar
Al Duhail,4,2,1,1,9,8,1,7,qatar
Al Sadd,2,2,0,0,6,2,4,6,qatar
Al Wakrah,2,1,1,0,3,0,3,4,qatar
Umm Salal,2,1,1,0,4,2,2,4,qatar
Qatar SC,4,1,1,2,6,6,0,4,qatar
Al Gharafa,3,1,1,1,8,9,-1,4,qatar
Al Shamal,4,0,3,1,6,7,-1,3,qatar
Al Arabi,1,0,0,1,0,1,-1,0,qatar
Al Ahli Doha,2,0,0,2,3,7,-4,0,qatar
Al Markhiya,2,0,0,2,2,7,-5,0,qatar
Al Muaidar,4,0,0,4,5,16,-11,0,qatar
FCSB,7,5,1,1,15,7,8,16,romania
U. Cluj,7,2,5,0,12,10,2,11,romania
CFR Cluj,6,3,1,2,13,10,3,10,romania
P. Iasi,8,3,1,4,10,10,0,10,romania
Rapid Bucharest,6,2,3,1,12,8,4,9,romania
Petrolul,6,2,3,1,7,4,3,9,romania
Univ. Craiova,7,2,3,2,8,8,0,9,romania
Farul Constanta,6,3,0,3,7,10,-3,9,romania
Otelul,6,1,5,0,5,3,2,8,romania
Hermannstadt,6,1,4,1,7,6,1,7,romania
Sepsi OSK,8,2,1,5,7,9,-2,7,romania
U Craiova 1948,6,2,1,3,6,8,-2,7,romania
Voluntari,7,1,3,3,7,12,-5,6,romania
UTA Arad,7,0,4,3,6,11,-5,4,romania
Din. Bucharest,6,1,1,4,5,14,-9,4,romania
Botosani,7,0,2,5,8,19,-11,2,romania
Zenit,7,4,2,1,13,6,7,14,russia
FC Krasnodar,6,3,3,0,10,4,6,12,russia
Lokomotiv M.,6,3,2,1,11,9,2,11,russia
Dinamo Moscow,7,2,4,1,11,10,1,10,russia
CSKA Moscow,7,1,4,2,11,12,-1,7,russia
Rubin Kazan,5,2,1,2,5,7,-2,7,russia
Ural,5,2,1,2,5,8,-3,7,russia
Akhmat Grozny,6,2,1,3,3,7,-4,7,russia
Krylya Sovetov,6,1,2,3,7,11,-4,5,russia
Fakel Voronezh,7,1,2,4,4,10,-6,5,russia
Orenburg,6,1,1,4,6,12,-6,4,russia
Spartak Moscow,4,1,0,3,6,10,-4,3,russia
PFC Sochi,7,1,0,6,6,14,-8,3,russia
Nizhny Novgorod,6,0,2,4,1,7,-6,2,russia
Rostov,5,0,1,4,5,15,-10,1,russia
Baltika,7,0,0,7,4,13,-9,0,russia
Makhachkala,8,4,3,1,6,3,3,15,russia2
Akron,7,4,1,2,8,4,4,13,russia2
Khimki,8,4,1,3,11,10,1,13,russia2
Tyumen,7,3,2,2,8,8,0,11,russia2
Leningradets,8,3,1,4,8,12,-4,10,russia2
A. Vladikavkaz,8,2,3,3,6,9,-3,9,russia2
Neftekhimik,8,2,2,4,6,9,-3,8,russia2
Arsenal Tula,8,1,5,2,7,11,-4,8,russia2
Rodina Moskva,7,1,4,2,9,9,0,7,russia2
Chernomorets,8,1,4,3,5,8,-3,7,russia2
Shinnik,8,2,1,5,9,16,-7,7,russia2
Sokol Saratov,8,2,1,5,9,20,-11,7,russia2
Yenisey,8,1,2,5,6,11,-5,5,russia2
Torpedo Moscow,7,1,2,4,4,9,-5,5,russia2
Kamaz,7,1,2,4,3,8,-5,5,russia2
V. Astrakhan,8,0,4,4,4,9,-5,4,russia2
SKA Khabarovsk,6,0,1,5,4,12,-8,1,russia2
Urozhay,7,0,1,6,3,13,-10,1,russia2
Al Ittihad,6,4,2,0,12,1,11,14,saudiarabia
Al Hilal,5,4,1,0,15,5,10,13,saudiarabia
Al Fateh,6,4,1,1,13,8,5,13,saudiarabia
Al Nassr,5,4,0,1,16,5,11,12,saudiarabia
Al Taawon,6,3,2,1,10,6,4,11,saudiarabia
Al Feiha,5,2,2,1,8,6,2,8,saudiarabia
Al Ittifaq,5,2,1,2,5,4,1,7,saudiarabia
Al Khaleej,5,2,1,2,6,6,0,7,saudiarabia
Al Akhdoud,5,2,1,2,4,5,-1,7,saudiarabia
Al Ahli Jeddah,5,2,0,3,9,13,-4,6,saudiarabia
Damak,6,1,1,4,7,11,-4,4,saudiarabia
Al Shabab,5,1,1,3,4,11,-7,4,saudiarabia
Al Riyadh,5,1,1,3,6,14,-8,4,saudiarabia
Al Wahda,5,1,0,4,6,13,-7,3,saudiarabia
Al Hazm,6,0,3,3,6,14,-8,3,saudiarabia
Al Raed,5,0,2,3,4,7,-3,2,saudiarabia
Abha,5,0,1,4,3,12,-9,1,saudiarabia
Al Tai,6,0,1,5,4,14,-10,1,saudiarabia
Al Quadisiya,4,3,1,0,4,0,4,10,saudiarabia2
Al Orubah,4,3,0,1,6,3,3,9,saudiarabia2
Jeddah,5,2,1,2,5,5,0,7,saudiarabia2
Al Kholood,4,2,0,2,8,4,4,6,saudiarabia2
Al Adalh,4,2,0,2,7,6,1,6,saudiarabia2
Ohod,4,2,0,2,5,5,0,6,saudiarabia2
Al Faisaly,4,1,2,1,6,6,0,5,saudiarabia2
Al Najma,4,1,1,2,10,8,2,4,saudiarabia2
Al Arabi,3,1,1,1,7,5,2,4,saudiarabia2
Al Jabalain,4,1,1,2,4,6,-2,4,saudiarabia2
Al-Ain,5,1,1,3,4,10,-6,4,saudiarabia2
Al-Jndal,5,1,1,3,3,10,-7,4,saudiarabia2
Al Batin,4,1,0,3,2,4,-2,3,saudiarabia2
Al Taraji,4,1,0,3,2,7,-5,3,saudiarabia2
Al Bukayriyah,3,0,1,2,1,3,-2,1,saudiarabia2
Al Qaisoma,4,0,1,3,4,8,-4,1,saudiarabia2
Hajer,3,0,0,3,2,9,-7,0,saudiarabia2
Al Safa,4,0,0,4,2,10,-8,0,saudiarabia2
Celtic,5,5,0,0,13,3,10,15,scotland
Rangers,4,3,0,1,7,1,6,9,scotland
St. Mirren,4,2,2,0,6,4,2,8,scotland
Hearts,4,2,0,2,3,2,1,6,scotland
Aberdeen,4,1,2,1,5,5,0,5,scotland
Hibernian,5,1,2,2,7,10,-3,5,scotland
Livingston,5,1,2,2,6,11,-5,5,scotland
Motherwell,4,1,1,2,2,4,-2,4,scotland
Ross County,4,1,1,2,3,8,-5,4,scotland
Kilmarnock,4,0,2,2,4,7,-3,2,scotland
Dundee FC,4,0,2,2,3,7,-4,2,scotland
St. Johnstone,4,0,2,2,0,4,-4,2,scotland
Dundee Utd,5,4,1,0,14,1,13,13,scotland2
Ayr Utd,5,3,0,2,10,8,2,9,scotland2
Partick Thistle,4,2,1,1,9,3,6,7,scotland2
Raith Rovers,4,2,1,1,5,4,1,7,scotland2
Queen`s Park,6,2,1,3,8,12,-4,7,scotland2
Arbroath,3,2,0,1,7,2,5,6,scotland2
Dunfermline,4,1,2,1,4,5,-1,5,scotland2
Inverness,4,1,0,3,4,6,-2,3,scotland2
Airdrieonians,4,1,0,3,2,8,-6,3,scotland2
Greenock Morton,4,0,2,2,4,7,-3,2,scotland2
Falkirk,5,4,1,0,15,5,10,13,scotland3
Hamilton,5,3,2,0,9,3,6,11,scotland3
Queen of South,5,3,0,2,6,6,0,9,scotland3
Kelty Hearts,5,2,1,2,9,7,2,7,scotland3
Montrose,4,2,0,2,8,7,1,6,scotland3
Stirling Albion,5,2,0,3,2,7,-5,6,scotland3
Cove Rangers,5,1,2,2,7,6,1,5,scotland3
Alloa Athletic,5,1,1,3,8,10,-2,4,scotland3
Edinburgh City,5,0,2,3,6,11,-5,2,scotland3
Annan Athletic,5,0,1,4,4,15,-11,1,scotland3
Peterhead,5,4,0,1,10,4,6,12,scotland4
Stenhousemuir,5,3,2,0,5,1,4,11,scotland4
Spartans,4,2,2,0,8,6,2,8,scotland4
Dumbarton,5,2,1,2,9,7,2,7,scotland4
Bonnyrigg Rose,4,2,1,1,7,5,2,7,scotland4
Forfar Athletic,5,1,3,1,4,4,0,6,scotland4
Stranraer,5,1,1,3,3,13,-10,4,scotland4
East Fife,4,0,3,1,4,5,-1,3,scotland4
Clyde,5,0,2,3,5,9,-4,2,scotland4
Elgin City,5,0,1,4,3,15,-12,1,scotland4
Partizan,7,6,1,0,19,6,13,19,serbia
Backa Topola,5,3,2,0,9,2,7,11,serbia
Cukaricki,5,2,1,2,7,7,0,7,serbia
Napredak,5,2,1,2,7,8,-1,7,serbia
Red Star,4,2,0,2,11,9,2,6,serbia
Mladost Lucani,4,2,0,2,4,5,-1,6,serbia
Radnicki 1923,7,2,0,5,7,11,-4,6,serbia
Vozdovac,5,1,2,2,5,6,-1,5,serbia
Javor Ivanjica,7,1,2,4,7,12,-5,5,serbia
Rad. Surdulica,6,0,4,2,4,8,-4,4,serbia
Radnicki Nis,7,1,1,5,5,10,-5,4,serbia
Sp. Subotica,4,1,0,3,3,7,-4,3,serbia
IMT N. Beograd,6,1,0,5,7,12,-5,3,serbia
Z. Pancevo,5,1,0,4,5,12,-7,3,serbia
Vojvodina,5,0,2,3,3,12,-9,2,serbia
Novi Pazar,5,0,1,4,2,8,-6,1,serbia
OFK Beograd,8,6,2,0,21,6,15,20,serbia2
Indija,6,3,1,2,6,5,1,10,serbia2
Dubocica,8,2,4,2,7,8,-1,10,serbia2
Kolubara,6,2,2,2,6,5,1,8,serbia2
OFK Vrac,5,2,2,1,5,4,1,8,serbia2
S. Mitrovica,6,2,1,3,5,7,-2,7,serbia2
Graficar,7,1,4,2,7,10,-3,7,serbia2
Semendrija 1924,5,1,3,1,4,4,0,6,serbia2
Tekstilac Odzac,6,1,2,3,3,4,-1,5,serbia2
Sloboda Uzice,6,1,2,3,3,6,-3,5,serbia2
Radnicki B.,6,1,2,3,6,10,-4,5,serbia2
Jedinstvo Ub,6,1,2,3,5,11,-6,5,serbia2
Macva Sabac,5,0,3,2,3,5,-2,3,serbia2
Mladost Novi S.,5,0,2,3,2,8,-6,2,serbia2
Metalac GM,6,0,2,4,3,10,-7,2,serbia2
Novi Sad,7,0,0,7,4,18,-14,0,serbia2
Lion City,8,6,1,1,35,16,19,19,singapore
Khalsa,8,6,0,2,26,22,4,18,singapore
A. Niigata (S),8,5,2,1,24,11,13,17,singapore
Tampines Rovers,8,4,3,1,14,12,2,15,singapore
Hougang,8,5,0,3,17,16,1,15,singapore
Geylang,8,4,1,3,15,16,-1,13,singapore
DPMM FC,8,2,2,4,10,12,-2,8,singapore
Tanjong Pagar,8,2,1,5,16,24,-8,7,singapore
Young Lions,8,0,0,8,5,29,-24,0,singapore
Banska Bystrica,7,4,2,1,17,9,8,14,slovakia
S. Bratislava,6,4,1,1,10,6,4,13,slovakia
Spartak Trnava,5,3,2,0,8,5,3,11,slovakia
Trencin,6,3,1,2,11,11,0,10,slovakia
DAC Streda,6,2,2,2,5,7,-2,8,slovakia
Zilina,5,2,1,2,6,5,1,7,slovakia
Podbrezova,5,2,0,3,13,10,3,6,slovakia
FC Kosice,6,1,0,5,7,15,-8,3,slovakia
Z. Michalovce,4,0,2,2,3,6,-3,2,slovakia
Ruzomberok,5,0,2,3,5,15,-10,2,slovakia
Skalica,5,0,1,4,5,10,-5,1,slovakia
Zlate Moravce,6,0,1,5,3,10,-7,1,slovakia
Komarno,6,6,0,0,14,5,9,18,slovakia2
S. Bratislava B,7,4,2,1,10,3,7,14,slovakia2
Tatran Presov,7,4,1,2,11,6,5,13,slovakia2
Puchov,6,4,0,2,16,9,7,12,slovakia2
Zilina B,7,4,0,3,11,10,1,12,slovakia2
Petrzalka,6,2,3,1,11,7,4,9,slovakia2
Samorin,7,2,2,3,7,10,-3,8,slovakia2
L. Mikulas,8,2,1,5,11,13,-2,7,slovakia2
Spartak Myjava,6,2,1,3,6,8,-2,7,slovakia2
Futura Humenne,6,2,1,3,12,16,-4,7,slovakia2
P. Bystrica,5,1,3,1,3,4,-1,6,slovakia2
Pohronie,5,1,1,3,4,8,-4,4,slovakia2
OFK Malzenice,6,1,1,4,7,12,-5,4,slovakia2
Slavoj Trebisov,5,1,0,4,3,12,-9,3,slovakia2
Dolny Kubin,5,0,2,3,6,15,-9,2,slovakia2
Spisska Nova V.,6,0,1,5,6,12,-6,1,slovakia2
NK Celje,6,4,2,0,15,6,9,14,slovenia
Koper,6,3,3,0,10,5,5,12,slovenia
NK Olimpija,6,4,0,2,15,11,4,12,slovenia
Mura,6,4,0,2,9,9,0,12,slovenia
Radomlje,7,2,2,3,7,7,0,8,slovenia
Aluminij,6,2,0,4,7,10,-3,6,slovenia
Bravo,6,1,2,3,6,9,-3,5,slovenia
Maribor,6,1,1,4,8,9,-1,4,slovenia
Domzale,6,1,1,4,9,14,-5,4,slovenia
Rogaska,5,1,0,4,2,13,-11,3,slovenia
Mamelodi S.,5,5,0,0,8,1,7,15,southafrica
Golden Arrows,5,4,0,1,8,6,2,12,southafrica
Sekhukhune,5,3,1,1,6,3,3,10,southafrica
Chippa Utd,4,2,2,0,3,1,2,8,southafrica
Moroka Swallows,3,2,1,0,5,2,3,7,southafrica
SuperSport Utd,4,2,1,1,4,3,1,7,southafrica
Cape Town City,6,2,1,3,4,6,-2,7,southafrica
Polokwane,5,1,2,2,4,5,-1,5,southafrica
Richards Bay,4,1,2,1,2,3,-1,5,southafrica
Stellenbosch,4,1,1,2,4,5,-1,4,southafrica
Royal AM,5,1,1,3,6,10,-4,4,southafrica
Kaizer Chiefs,4,1,0,3,3,4,-1,3,southafrica
Orlando Pirates,3,0,2,1,1,2,-1,2,southafrica
AmaZulu,4,0,2,2,1,5,-4,2,southafrica
TS Galaxy,4,0,1,3,0,5,-5,1,southafrica
Cape Town Spurs,4,0,0,4,3,10,-7,0,southafrica
Polokwane,8,5,1,2,15,8,7,16,southafrica2
All Stars,8,4,2,2,12,9,3,14,southafrica2
Magesi,8,4,2,2,7,6,1,14,southafrica2
Pretoria C.,8,3,3,2,9,11,-2,12,southafrica2
Cape Town Spurs,8,3,2,3,8,9,-1,11,southafrica2
Pretoria U.,8,2,4,2,9,8,1,10,southafrica2
Uthongathi,8,3,1,4,7,8,-1,10,southafrica2
Casric Stars,8,1,6,1,8,9,-1,9,southafrica2
JDR Stars,8,2,3,3,6,7,-1,9,southafrica2
Baroka,8,2,2,4,9,12,-3,8,southafrica2
Hungry Lions,8,2,2,4,5,10,-5,8,southafrica2
MM Platinum,8,1,4,3,9,12,-3,7,southafrica2
Venda FC,8,1,4,3,6,12,-6,7,southafrica2
Black Leopards,8,1,2,5,3,8,-5,5,southafrica2
Platinum City,8,1,2,5,5,15,-10,5,southafrica2
TTM,8,0,2,6,3,14,-11,2,southafrica2
Gwangju,8,4,4,0,10,5,5,16,southkorea
Incheon Utd,8,3,4,1,9,8,1,13,southkorea
Seoul,8,3,3,2,12,10,2,12,southkorea
Pohang Steelers,8,2,5,1,8,6,2,11,southkorea
Jeonbuk Motors,8,3,2,3,8,8,0,11,southkorea
Daegu,8,3,2,3,11,12,-1,11,southkorea
Suwon City,8,3,2,3,8,10,-2,11,southkorea
Ulsan,8,2,3,3,7,10,-3,9,southkorea
Gangwon,8,1,3,4,6,8,-2,6,southkorea
Suwon Bluewings,8,1,3,4,7,16,-9,6,southkorea
Daejeon Citizen,8,0,5,3,7,13,-6,5,southkorea
Jeju Utd,8,0,0,8,5,18,-13,0,southkorea
Busan IPark,8,5,1,2,11,8,3,16,southkorea2
Gimpo,8,3,4,1,8,4,4,13,southkorea2
Cheongju,8,3,4,1,8,5,3,13,southkorea2
Gyeongnam,8,3,3,2,9,8,1,12,southkorea2
Gimcheon Sangmu,8,3,0,5,14,13,1,9,southkorea2
Cheonan City,8,2,3,3,10,10,0,9,southkorea2
Jeonnam Dragons,8,3,0,5,9,11,-2,9,southkorea2
Bucheon FC,8,2,2,4,7,9,-2,8,southkorea2
Ansan Greeners,8,2,2,4,13,19,-6,8,southkorea2
Seongnam,8,2,2,4,9,16,-7,8,southkorea2
Seoul E-Land,8,1,2,5,6,13,-7,5,southkorea2
Chungnam Asan,8,1,2,5,4,12,-8,5,southkorea2
Anyang,8,1,1,6,10,19,-9,4,southkorea2
Real Madrid,6,4,1,1,11,5,6,13,spain
Girona,5,4,1,0,10,5,5,13,spain
Rayo Vallecano,6,3,2,1,7,3,4,11,spain
Atletico Madrid,5,3,1,1,12,3,9,10,spain
FC Barcelona,5,2,3,0,10,8,2,9,spain
Osasuna,5,3,0,2,8,8,0,9,spain
Athletic Bilbao,5,2,1,2,4,4,0,7,spain
Real Betis,6,1,3,2,7,13,-6,6,spain
Villarreal,4,1,2,1,3,4,-1,5,spain
Mallorca,6,1,2,3,9,12,-3,5,spain
Valencia,5,1,2,2,5,8,-3,5,spain
Real Sociedad,4,1,1,2,3,4,-1,4,spain
Celta Vigo,5,1,1,3,7,9,-2,4,spain
Las Palmas,5,1,0,4,2,6,-4,3,spain
Alaves,5,0,2,3,2,6,-4,2,spain
Getafe,5,0,2,3,8,13,-5,2,spain
Sevilla FC,3,0,1,2,3,5,-2,1,spain
Granada,5,0,1,4,7,14,-7,1,spain
Cadiz,5,0,1,4,3,11,-8,1,spain
Almeria,5,0,1,4,5,16,-11,1,spain
Levante,6,3,3,0,6,1,5,12,spain2
Leganes,6,4,0,2,7,3,4,12,spain2
Eibar,7,4,0,3,11,12,-1,12,spain2
Espanyol,6,3,1,2,9,6,3,10,spain2
Real Zaragoza,5,3,1,1,7,4,3,10,spain2
Alcorcon,6,2,2,2,8,10,-2,8,spain2
Sporting Gijon,7,2,2,3,6,8,-2,8,spain2
Eldense,7,2,2,3,7,11,-4,8,spain2
Tenerife,5,2,1,2,5,6,-1,7,spain2
Mirandes,6,2,1,3,7,9,-2,7,spain2
Cartagena,6,1,3,2,6,7,-1,6,spain2
Huesca,6,1,3,2,4,5,-1,6,spain2
Real Oviedo,7,1,3,3,4,5,-1,6,spain2
Valladolid,6,2,0,4,3,10,-7,6,spain2
Racing,6,1,2,3,6,10,-4,5,spain2
Racing Ferrol,6,1,2,3,3,8,-5,5,spain2
Elche,6,1,2,3,4,10,-6,5,spain2
Villarreal B,6,0,3,3,7,11,-4,3,spain2
Albacete,5,1,0,4,3,10,-7,3,spain2
FC Andorra,6,1,0,5,6,14,-8,3,spain2
Amorebieta,6,0,1,5,5,16,-11,1,spain2
Burgos,6,0,0,6,5,15,-10,0,spain2
Mjallby,8,5,1,2,13,7,6,16,sweden
Varnamo,8,5,1,2,15,10,5,16,sweden
Elfsborg,8,5,0,3,15,6,9,15,sweden
Djurgarden,8,4,2,2,8,6,2,14,sweden
Malmo FF,8,4,1,3,11,8,3,13,sweden
Hammarby,8,3,3,2,6,4,2,12,sweden
Sirius,8,4,0,4,10,10,0,12,sweden
Kalmar,8,3,1,4,11,13,-2,10,sweden
IFK Goteborg,8,2,4,2,8,11,-3,10,sweden
AIK,8,3,1,4,9,14,-5,10,sweden
Hacken,8,2,2,4,10,12,-2,8,sweden
Norrkoping,8,2,2,4,14,17,-3,8,sweden
Halmstad,8,2,2,4,7,12,-5,8,sweden
Degerfors,8,2,1,5,7,13,-6,7,sweden
Varberg BoIS,8,2,0,6,8,21,-13,6,sweden
Brommapojkarna,8,0,1,7,11,20,-9,1,sweden
GAIS,8,5,2,1,24,3,21,17,sweden2
Vasteras,8,5,2,1,13,9,4,17,sweden2
Trelleborg,8,3,4,1,12,10,2,13,sweden2
Oster,8,3,3,2,12,10,2,12,sweden2
Landskrona,8,4,0,4,13,17,-4,12,sweden2
Utsikten,8,3,1,4,9,12,-3,10,sweden2
Helsingborg,8,2,3,3,10,13,-3,9,sweden2
Orgryte,8,3,0,5,10,15,-5,9,sweden2
Gefle,8,1,4,3,9,12,-3,7,sweden2
Ostersunds,8,1,4,3,8,13,-5,7,sweden2
GIF Sundsvall,8,1,3,4,9,14,-5,6,sweden2
Brage,8,1,2,5,4,12,-8,5,sweden2
Orebro,8,1,2,5,10,19,-9,5,sweden2
AFC Eskilstuna,8,1,2,5,4,15,-11,5,sweden2
Skovde AIK,8,1,1,6,11,23,-12,4,sweden2
Jonkopings,8,0,1,7,6,19,-13,1,sweden2
FC Zurich,6,2,4,0,11,5,6,10,switzerland
Servette,6,3,1,2,7,8,-1,10,switzerland
BSC Young Boys,5,2,2,1,6,5,1,8,switzerland
Lugano,6,2,0,4,10,14,-4,6,switzerland
Luzern,5,1,2,2,4,6,-2,5,switzerland
Yverdon,6,1,2,3,6,13,-7,5,switzerland
Grasshopper,5,1,1,3,7,8,-1,4,switzerland
Lausanne Sport,6,1,1,4,8,11,-3,4,switzerland
Winterthur,5,1,1,3,13,17,-4,4,switzerland
Lausanne Ouchy,4,1,0,3,5,8,-3,3,switzerland
St. Gallen,6,0,3,3,4,7,-3,3,switzerland
FC Basel,4,0,0,4,4,11,-7,0,switzerland
Foutoua,8,6,1,1,10,3,7,19,syria
Al Ittihad,8,4,2,2,7,4,3,14,syria
Teshrin,8,3,3,2,6,4,2,12,syria
Jabala,8,2,5,1,13,8,5,11,syria
Al Jaish,8,2,4,2,10,8,2,10,syria
Wathbah,8,2,3,3,5,7,-2,9,syria
Taliya,8,1,5,2,5,9,-4,8,syria
Hottin,8,1,4,3,6,8,-2,7,syria
Majd,8,2,1,5,11,18,-7,7,syria
Karama,8,1,3,4,6,8,-2,6,syria
Al Wahda,8,1,2,5,4,10,-6,5,syria
Al-Jazira,0,0,0,0,0,0,0,0,syria
Simba,3,3,0,0,9,4,5,9,tanzania
S. Big Star,4,2,0,2,5,6,-1,6,tanzania
KMC,4,1,2,1,3,7,-4,5,tanzania
Namungo,3,1,1,1,4,3,1,4,tanzania
Azam,3,1,1,1,3,3,0,4,tanzania
Kagera Sugar,5,1,1,3,3,5,-2,4,tanzania
Geita Gold,4,1,1,2,2,4,-2,4,tanzania
JKT Tanzania,4,1,1,2,3,8,-5,4,tanzania
Young Africans,2,1,0,1,4,2,2,3,tanzania
T. Prisons,4,0,2,2,3,7,-4,2,tanzania
Coastal Union,4,0,2,2,2,6,-4,2,tanzania
Kitayosce,4,0,2,2,0,5,-5,2,tanzania
Mtibwa Sugar,2,0,1,1,3,4,-1,1,tanzania
Dodoma Jiji,3,0,1,2,3,6,-3,1,tanzania
Mashujaa,3,0,1,2,0,3,-3,1,tanzania
Ihefu,2,0,0,2,0,3,-3,0,tanzania
Buriram Utd,4,2,2,0,3,1,2,8,thailand
Port FC,5,2,1,2,12,8,4,7,thailand
Pathum Utd,4,2,1,1,6,5,1,7,thailand
Muang Thong Utd,5,2,1,2,7,8,-1,7,thailand
Bangkok Utd,2,2,0,0,6,1,5,6,thailand
Uthai Thani,4,2,0,2,5,6,-1,6,thailand
Chiangrai Utd,4,1,1,2,3,4,-1,4,thailand
Nakhon Pathom,4,1,1,2,7,9,-2,4,thailand
Khon Kaen Utd,5,1,1,3,6,13,-7,4,thailand
Sukhothai,4,1,0,3,4,9,-5,3,thailand
Police Tero,3,1,0,2,4,10,-6,3,thailand
Chonburi,3,0,2,1,6,7,-1,2,thailand
Ratchaburi,4,0,2,2,3,5,-2,2,thailand
Prachuap,4,0,2,2,5,8,-3,2,thailand
Trat,4,0,1,3,1,10,-9,1,thailand
Lamphun Warrior,4,0,0,4,2,10,-8,0,thailand
Ayutthaya Utd,5,4,0,1,8,2,6,12,thailand2
Rayong,5,3,1,1,10,2,8,10,thailand2
Pattaya United,5,3,1,1,10,6,4,10,thailand2
N. Ratchasima,4,2,1,1,5,3,2,7,thailand2
Nakhon Si Thamm,4,2,1,1,7,7,0,7,thailand2
N. Bua Pitchaya,5,2,1,2,7,8,-1,7,thailand2
Samut Prakan,5,2,1,2,7,8,-1,7,thailand2
Phrae Utd,4,2,0,2,4,6,-2,6,thailand2
Chiangmai Utd,4,1,2,1,6,5,1,5,thailand2
Suphanburi,4,1,2,1,3,3,0,5,thailand2
Chiangmai FC,4,1,2,1,1,1,0,5,thailand2
Kanchanaburi,5,1,2,2,5,6,-1,5,thailand2
Lampang,5,1,2,2,6,8,-2,5,thailand2
Customs Utd,4,1,2,1,3,8,-5,5,thailand2
Chanthaburi,5,1,1,3,8,11,-3,4,thailand2
Chainat,5,0,3,2,0,4,-4,3,thailand2
Kasetsart,5,0,1,4,4,15,-11,1,thailand2
Krabi,3,0,0,3,3,12,-9,0,thailand2
Galatasaray,5,4,1,0,8,1,7,13,turkey
Fenerbahce,4,4,0,0,6,0,6,12,turkey
Kasimpasa,4,2,2,0,7,5,2,8,turkey
Sivasspor,4,2,1,1,7,6,1,7,turkey
Hatayspor,5,1,3,1,7,5,2,6,turkey
Besiktas,5,2,0,3,6,9,-3,6,turkey
Rizespor,5,2,0,3,7,13,-6,6,turkey
Konyaspor,4,1,2,1,4,5,-1,5,turkey
Kayserispor,5,1,2,2,5,8,-3,5,turkey
Pendikspor,5,1,2,2,5,8,-3,5,turkey
Basaksehir,5,1,2,2,2,6,-4,5,turkey
F. Karagumruk,4,1,1,2,4,4,0,4,turkey
Ankaragucu,5,1,1,3,8,9,-1,4,turkey
Antalyaspor,5,1,1,3,5,7,-2,4,turkey
Trabzonspor,4,1,0,3,7,7,0,3,turkey
Gaziantep,5,1,0,4,3,9,-6,3,turkey
Adana Demirspor,4,0,2,2,5,8,-3,2,turkey
Alanyaspor,4,0,2,2,1,6,-5,2,turkey
Samsunspor,5,0,1,4,4,10,-6,1,turkey
Istanbulspor,4,0,1,3,2,8,-6,1,turkey
Eyupspor,5,4,0,1,12,5,7,12,turkey2
Corum,5,3,1,1,9,3,6,10,turkey2
Goztepe,4,3,1,0,4,0,4,10,turkey2
Kocaelispor,4,3,0,1,6,3,3,9,turkey2
Manisa BB,5,2,2,1,7,5,2,8,turkey2
Bandirmaspor,5,2,2,1,5,4,1,8,turkey2
Bodrumspor,5,2,1,2,4,5,-1,7,turkey2
Genclerbirligi,4,2,1,1,4,5,-1,7,turkey2
Keciorengucu,4,1,2,1,1,3,-2,5,turkey2
Sanliurfaspor,5,1,2,2,4,8,-4,5,turkey2
Boluspor,4,1,1,2,2,3,-1,4,turkey2
Sakaryaspor,4,1,1,2,3,5,-2,4,turkey2
Giresunspor,5,1,1,3,6,10,-4,4,turkey2
Umraniyespor,5,1,1,3,5,9,-4,4,turkey2
Erzurum BB,4,0,3,1,1,2,-1,3,turkey2
Adanaspor,5,1,0,4,3,6,-3,3,turkey2
Tuzlaspor,4,1,0,3,3,7,-4,3,turkey2
Altay,5,0,1,4,3,12,-9,1,turkey2
Al Sharjah,3,3,0,0,8,4,4,9,uae
Al Wasl,3,2,1,0,11,4,7,7,uae
Shabab Al Ahli,3,2,1,0,6,1,5,7,uae
Al Jazira,2,2,0,0,7,1,6,6,uae
Al Ain,3,2,0,1,5,3,2,6,uae
Al Nasr,3,1,1,1,8,7,1,4,uae
Ittihad Kalba,3,1,1,1,6,5,1,4,uae
Emirates,3,1,1,1,2,1,1,4,uae
Al Bataeh,2,1,0,1,3,4,-1,3,uae
Al Wahda,3,1,0,2,4,6,-2,3,uae
Ajman,4,0,3,1,6,12,-6,3,uae
Bani Yas,2,0,0,2,4,6,-2,0,uae
Al Khaleej,2,0,0,2,2,5,-3,0,uae
Hatta,3,0,0,3,2,5,-3,0,uae
Emirates,8,6,0,2,22,9,13,18,uae2
Hatta,8,5,2,1,20,12,8,17,uae2
Al Fujairah,8,5,1,2,16,7,9,16,uae2
Dibba Al Hisn,8,5,1,2,16,11,5,16,uae2
Masfut,8,4,3,1,10,8,2,15,uae2
Al Hamriyah,8,4,2,2,14,10,4,14,uae2
Gulf Heroes,8,4,2,2,14,12,2,14,uae2
Al Taawon,8,4,1,3,10,11,-1,13,uae2
Al Urooba,8,3,2,3,11,9,2,11,uae2
Masafi,8,3,2,3,12,14,-2,11,uae2
Fursan Hispania,8,2,2,4,7,12,-5,8,uae2
Al Arabi,8,1,4,3,12,14,-2,7,uae2
Al Ramms,8,2,1,5,9,14,-5,7,uae2
Al Jazira Al H.,8,2,1,5,13,20,-7,7,uae2
Al Thaid,8,2,1,5,6,16,-10,7,uae2
Dubai City,8,1,2,5,10,18,-8,5,uae2
Baynounah SC,8,0,0,8,6,24,-18,0,uae2
Kryvbas KR,6,4,1,1,13,4,9,13,ukraine
Polessya,7,4,1,2,11,4,7,13,ukraine
Shakhtar,6,3,3,0,13,7,6,12,ukraine
Dnipro-1,4,3,1,0,6,3,3,10,ukraine
Rukh Lviv,4,3,0,1,10,5,5,9,ukraine
Zorya Luhansk,6,2,2,2,9,8,1,8,ukraine
Kolos Kovalivka,5,1,4,0,3,2,1,7,ukraine
Vorskla Poltava,5,2,1,2,5,8,-3,7,ukraine
Dynamo Kyiv,4,2,0,2,12,10,2,6,ukraine
Chornomorets,6,2,0,4,9,9,0,6,ukraine
Obolon,5,2,0,3,3,6,-3,6,ukraine
LNZ Cherkasy,5,1,2,2,3,5,-2,5,ukraine
Metalist 1925,5,1,1,3,2,4,-2,4,ukraine
Oleksandria,5,0,2,3,3,7,-4,2,ukraine
FC Minaj,6,0,2,4,3,11,-8,2,ukraine
Veres,4,0,1,3,1,6,-5,1,ukraine
Wanderers,8,5,3,0,11,4,7,18,uruguay
Defensor S.,7,4,2,1,13,3,10,14,uruguay
Montevideo City,7,4,1,2,13,8,5,13,uruguay
Penarol,6,3,2,1,10,7,3,11,uruguay
Nacional,8,2,4,2,10,8,2,10,uruguay
Cerro Largo,7,2,4,1,5,3,2,10,uruguay
Racing CM,7,3,1,3,9,8,1,10,uruguay
La Luz,6,2,2,2,6,7,-1,8,uruguay
Liverpool M.,8,1,4,3,9,11,-2,7,uruguay
Boston River,8,1,3,4,9,12,-3,6,uruguay
Cerro,8,1,3,4,8,12,-4,6,uruguay
Fenix,8,2,0,6,8,17,-9,6,uruguay
River Plate,8,0,5,3,4,9,-5,5,uruguay
D. Maldonado,8,1,2,5,8,18,-10,5,uruguay
Plaza Colonia,7,1,2,4,4,16,-12,5,uruguay
Danubio,8,0,3,5,8,15,-7,3,uruguay
Cerro,3,2,1,0,3,1,2,7,uruguay2
River Plate,4,2,1,1,4,5,-1,7,uruguay2
Liverpool M.,3,2,0,1,4,2,2,6,uruguay2
Wanderers,3,2,0,1,4,4,0,6,uruguay2
Defensor S.,4,1,2,1,4,4,0,5,uruguay2
Fenix,4,1,2,1,4,4,0,5,uruguay2
Danubio,4,1,1,2,4,4,0,4,uruguay2
Montevideo City,4,1,1,2,4,5,-1,4,uruguay2
Boston River,3,1,0,2,3,5,-2,3,uruguay2
D. Maldonado,4,1,0,3,5,10,-5,3,uruguay2
Racing CM,4,1,0,3,4,9,-5,3,uruguay2
Cerro Largo,3,0,2,1,3,4,-1,2,uruguay2
Nacional,3,0,2,1,3,6,-3,2,uruguay2
Plaza Colonia,4,0,2,2,4,10,-6,2,uruguay2
Penarol,3,0,1,2,2,4,-2,1,uruguay2
La Luz,3,0,1,2,0,7,-7,1,uruguay2
Orlando City,8,5,1,2,10,9,1,16,usa
Seattle,8,4,3,1,11,8,3,15,usa
Cincinnati,8,4,3,1,13,12,1,15,usa
Real Salt Lake,8,4,2,2,12,9,3,14,usa
Vancouver,8,3,3,2,11,12,-1,12,usa
New York RB,8,3,1,4,11,14,-3,10,usa
Dallas,8,2,3,3,11,11,0,9,usa
Houston Dynamo,8,2,3,3,8,8,0,9,usa
Columbus Crew,8,2,3,3,15,16,-1,9,usa
Sporting KC,8,2,3,3,13,16,-3,9,usa
Atlanta Utd,8,2,3,3,11,14,-3,9,usa
Philadelphia,8,2,2,4,11,14,-3,8,usa
Minnesota Utd,8,2,2,4,13,19,-6,8,usa
Inter Miami,8,2,2,4,11,17,-6,8,usa
St. Louis City,8,2,2,4,8,14,-6,8,usa
Los Angeles FC,8,1,4,3,8,10,-2,7,usa
Charlotte,8,1,4,3,9,13,-4,7,usa
New York City,8,1,4,3,7,12,-5,7,usa
SJ Earthquakes,8,1,4,3,6,12,-6,7,usa
Portland,8,1,4,3,9,19,-10,7,usa
Chicago Fire,8,2,1,5,3,14,-11,7,usa
Austin,8,1,3,4,12,15,-3,6,usa
Nashville SC,8,1,3,4,5,11,-6,6,usa
LA Galaxy,8,1,3,4,15,22,-7,6,usa
DC United,8,1,2,5,4,15,-11,5,usa
CF Montreal,8,1,1,6,5,19,-14,4,usa
New England,8,0,3,5,11,16,-5,3,usa
Colorado Rapids,8,0,1,7,4,22,-18,1,usa
Toronto,8,0,0,8,1,22,-21,0,usa
Orange County,8,6,1,1,19,11,8,19,usa2
San Diego Loyal,8,5,1,2,15,7,8,16,usa2
Sacramento R.,8,5,1,2,12,9,3,16,usa2
Miami FC,8,5,0,3,11,6,5,15,usa2
Tampa Bay,8,4,2,2,14,10,4,14,usa2
Pittsburgh,8,4,2,2,10,8,2,14,usa2
Colorado S.,8,4,1,3,13,11,2,13,usa2
San Antonio,8,3,3,2,11,8,3,12,usa2
Indy Eleven,8,3,3,2,12,12,0,12,usa2
Charleston,8,3,3,2,10,10,0,12,usa2
Memphis,8,3,3,2,10,10,0,12,usa2
Oakland Roots,8,4,0,4,14,15,-1,12,usa2
FC Tulsa,8,3,1,4,12,13,-1,10,usa2
El Paso,8,3,1,4,5,15,-10,10,usa2
Louisville City,8,3,0,5,12,15,-3,9,usa2
Birmingham L.,8,3,0,5,8,14,-6,9,usa2
Phoenix Rising,8,2,2,4,7,12,-5,8,usa2
Monterey Bay,8,2,2,4,7,14,-7,8,usa2
Detroit City,8,2,1,5,9,17,-8,7,usa2
New Mexico,8,1,3,4,8,11,-3,6,usa2
Rio Grande,8,1,3,4,9,13,-4,6,usa2
Loudoun Utd,8,1,1,6,8,12,-4,4,usa2
Hartford A.,8,1,1,6,8,19,-11,4,usa2
Las Vegas L.,8,0,2,6,6,14,-8,2,usa2
North Carolina,8,6,1,1,19,9,10,19,usa3
Union Omaha,8,6,1,1,16,10,6,19,usa3
N. Colorado,8,4,2,2,13,11,2,14,usa3
Greenville,8,3,4,1,10,8,2,13,usa3
Tormenta,8,3,2,3,18,16,2,11,usa3
One Knoxville,8,3,2,3,9,9,0,11,usa3
Central Valley,8,2,1,5,16,20,-4,7,usa3
Chattanooga RW,8,2,1,5,12,17,-5,7,usa3
Lexington,8,1,3,4,12,16,-4,6,usa3
Charlotte,8,1,3,4,14,20,-6,6,usa3
Forward Madison,8,1,2,5,11,19,-8,5,usa3
Richmond K.,8,0,2,6,9,19,-10,2,usa3
Pakhtakor,8,5,2,1,11,6,5,17,uzbekistan
Navbahor,8,4,2,2,15,8,7,14,uzbekistan
Nasaf Qarshi,8,4,2,2,11,8,3,14,uzbekistan
Neftchi,8,2,5,1,9,8,1,11,uzbekistan
Bunyodkor,8,3,2,3,7,7,0,11,uzbekistan
Metallurg,8,3,1,4,9,9,0,10,uzbekistan
Termez Surkhon,8,2,4,2,7,7,0,10,uzbekistan
AMGK,8,2,4,2,8,10,-2,10,uzbekistan
Andijan,8,2,2,4,6,9,-3,8,uzbekistan
FK Olympic,8,2,2,4,8,12,-4,8,uzbekistan
Qizilqum,8,1,4,3,4,10,-6,7,uzbekistan
Sogdiana,8,1,2,5,10,15,-5,5,uzbekistan
Buxoro,8,1,1,6,3,11,-8,4,uzbekistan
Turan,8,1,1,6,5,18,-13,4,uzbekistan
D. Tachira,8,5,3,0,10,5,5,18,venezuela
Portuguesa,8,4,2,2,10,10,0,14,venezuela
Caracas,8,2,5,1,9,7,2,11,venezuela
Rayo Zuliano,8,3,2,3,11,11,0,11,venezuela
Carabobo,8,1,6,1,6,5,1,9,venezuela
Puerto Cabello,8,3,0,5,10,11,-1,9,venezuela
D. La Guaira,8,2,3,3,10,12,-2,9,venezuela
Metropolitanos,8,2,3,3,9,13,-4,9,venezuela
E. Merida,8,2,1,5,6,11,-5,7,venezuela
Zamora,8,2,1,5,8,18,-10,7,venezuela
H. Colmenares,8,1,3,4,8,11,-3,6,venezuela
UCV,8,0,4,4,2,7,-5,4,venezuela
Monagas,8,1,1,6,7,15,-8,4,venezuela
Angostura,8,1,1,6,6,16,-10,4,venezuela
M. de Guayana,8,1,1,6,6,21,-15,4,venezuela
Cong An Nhan,8,6,1,1,18,8,10,19,vietnam
Thanh Hoa,8,2,6,0,8,4,4,12,vietnam
Ha Noi,8,3,2,3,13,12,1,11,vietnam
The Cong,8,2,4,2,6,6,0,10,vietnam
Nam Dinh,8,3,1,4,8,12,-4,10,vietnam
Hai Phong,8,2,3,3,6,10,-4,9,vietnam
H. A. Gia Lai,8,2,2,4,11,13,-2,8,vietnam
Binh Duong,8,1,5,2,6,8,-2,8,vietnam
Song Lam Nghe,8,2,2,4,6,11,-5,8,vietnam
S. Khanh Hoa,8,1,4,3,5,8,-3,7,vietnam
Ho Chi Minh,8,2,1,5,10,17,-7,7,vietnam
Binh Dinh,8,1,3,4,7,12,-5,6,vietnam
Da Nang,8,1,3,4,5,10,-5,6,vietnam
Hong Linh Ha T.,8,0,4,4,8,19,-11,4,vietnam
Pho Hien,8,4,1,3,13,9,4,13,vietnam2
Long An,8,3,3,2,14,13,1,12,vietnam2
Hoa Binh,8,2,4,2,8,8,0,10,vietnam2
Binh Thuan,8,3,1,4,10,21,-11,10,vietnam2
Quang Nam,8,2,3,3,14,10,4,9,vietnam2
Phu Dong,8,2,3,3,7,9,-2,9,vietnam2
Phu Tho,8,1,2,5,8,14,-6,5,vietnam2
Binh Phuoc,8,1,1,6,9,16,-7,4,vietnam2
Ba Ria Vung Tau,8,0,3,5,3,12,-9,3,vietnam2
Hue,8,0,3,5,3,14,-11,3,vietnam2
The New Saints,7,6,1,0,20,5,15,19,wales
Connah`s Quay,7,4,1,2,17,10,7,13,wales
Caernarfon Town,7,3,1,3,15,16,-1,10,wales
Newtown,6,3,0,3,12,9,3,9,wales
Penybont,6,2,1,3,10,11,-1,7,wales
Aberystwyth,8,2,1,5,4,19,-15,7,wales
Cardiff MU,6,1,2,3,5,13,-8,5,wales
Haverfordwest,7,1,2,4,6,15,-9,5,wales
Colwyn Bay,5,1,1,3,4,6,-2,4,wales
Bala Town,6,0,4,2,3,6,-3,4,wales
Pontypridd Town,6,1,1,4,1,9,-8,4,wales
Barry Town,6,0,1,5,3,9,-6,1,wales
