Equipe,GP,W,D,L,GF,GA,GD,Pts,albania2
Bylis,3,3,0,0,6,3,3,9,albania2
Flamurtari,4,2,2,0,7,2,5,8,albania2
Apolonia Fier,4,2,1,1,6,3,3,7,albania2
Vora,4,2,0,2,7,7,0,6,albania2
AF Elbasani,4,2,0,2,4,4,0,6,albania2
Lushnja,4,1,1,2,5,5,0,4,albania2
Korabi Peshkopi,4,0,2,2,0,2,-2,2,albania2
Besa Kavaje,4,0,2,2,4,9,-5,2,albania2
Kastrioti Kruje,3,0,1,2,1,4,-3,1,albania2
Tomori Berat,3,0,1,2,3,10,-7,1,albania2
Luzi 2008,3,0,0,3,1,4,-3,0,albania2
Burreli,4,0,0,4,1,9,-8,0,albania2
Paradou AC,2,1,1,0,5,0,5,4,algeria
CR Belouizdad,1,1,0,0,3,0,3,3,algeria
JS Kabylie,2,1,0,1,2,2,0,3,algeria
US Souf,2,1,0,1,2,3,-1,3,algeria
Khenchela,2,1,0,1,3,5,-2,3,algeria
ASO Chlef,2,0,1,1,2,3,-1,1,algeria
NC Magra,2,0,1,1,0,1,-1,1,algeria
MC Oran,2,0,1,1,0,2,-2,1,algeria
JS Saoura,2,0,1,1,1,4,-3,1,algeria
MC Alger,1,0,0,1,1,2,-1,0,algeria
US Biskra,2,0,0,2,1,3,-2,0,algeria
CS Constantine,2,0,0,2,0,2,-2,0,algeria
USM Alger,2,0,0,2,0,2,-2,0,algeria
ES Setif,2,0,0,2,3,6,-3,0,algeria
El Bayadh,2,0,0,2,1,4,-3,0,algeria
Ben Aknoun,2,0,0,2,0,5,-5,0,algeria
Mostaganem,2,2,0,0,5,1,4,6,algeria2
Hussein Dey,2,1,1,0,2,1,1,4,algeria2
MSP Batna,2,1,1,0,2,1,1,4,algeria2
Khemis El K.,2,1,1,0,1,0,1,4,algeria2
GC Mascara,1,1,0,0,3,1,2,3,algeria2
ASM Oran,1,1,0,0,2,1,1,3,algeria2
RC Kouba,1,1,0,0,1,0,1,3,algeria2
Oued Akbou,2,1,0,1,4,4,0,3,algeria2
Koléa,2,1,0,1,1,1,0,3,algeria2
Tiaret,2,1,0,1,2,5,-3,3,algeria2
Mechria,2,0,2,0,1,1,0,2,algeria2
Bordj Menaïel,1,0,1,0,1,1,0,1,algeria2
MO Constantine,1,0,1,0,1,1,0,1,algeria2
CA Batna,1,0,1,0,0,0,0,1,algeria2
El Eulma,1,0,1,0,0,0,0,1,algeria2
Temouchent,1,0,1,0,0,0,0,1,algeria2
Khroub,2,0,1,1,1,2,-1,1,algeria2
WA Boufarik,2,0,1,1,1,2,-1,1,algeria2
Mlila,2,0,1,1,0,1,-1,1,algeria2
Chelghoum,2,0,1,1,1,3,-2,1,algeria2
El Ghozlane,2,0,1,1,1,3,-2,1,algeria2
Teleghma,0,0,0,0,0,0,0,0,algeria2
Oued Magrane,1,0,0,1,1,2,-1,0,algeria2
WA Mostaganem,1,0,0,1,0,1,-1,0,algeria2
Khemis Melina,2,0,0,2,3,5,-2,0,algeria2
El Harrach,2,0,0,2,2,4,-2,0,algeria2
Ghir Abadla,1,0,0,1,0,2,-2,0,algeria2
Oued Sly,1,0,0,1,0,2,-2,0,algeria2
RB Ouargla,1,0,0,1,0,2,-2,0,algeria2
FC Santa Coloma,3,2,0,1,7,2,5,6,andorra
UE Santa Coloma,2,2,0,0,3,0,3,6,andorra
Inter Escaldes,3,1,1,1,9,5,4,4,andorra
Penya Encarnada,2,1,1,0,2,1,1,4,andorra
Pas de la Casa,3,1,1,1,4,4,0,4,andorra
Carroi,2,1,0,1,1,4,-3,3,andorra
A. America,2,0,1,1,2,4,-2,1,andorra
Esperanca,2,0,0,2,2,4,-2,0,andorra
A. Escaldes,3,0,0,3,1,4,-3,0,andorra
Ordino,3,0,0,3,1,5,-4,0,andorra
Argentinos Jrs,4,2,1,1,3,1,2,7,argentina
Barracas C.,4,2,1,1,4,3,1,7,argentina
T. de Cordoba,4,2,1,1,4,3,1,7,argentina
Boca Juniors,4,2,1,1,5,5,0,7,argentina
A. Tucuman,4,2,1,1,4,4,0,7,argentina
Tigre,4,2,0,2,4,3,1,6,argentina
Racing Club,4,1,2,1,6,3,3,5,argentina
River Plate,4,1,2,1,8,6,2,5,argentina
Platense,4,1,2,1,4,3,1,5,argentina
Lanus,4,1,2,1,5,5,0,5,argentina
Banfield,4,1,2,1,5,6,-1,5,argentina
San Lorenzo,4,1,2,1,3,4,-1,5,argentina
Newells,4,1,1,2,4,5,-1,4,argentina
Velez Sarsfield,4,1,1,2,3,4,-1,4,argentina
Instituto,4,1,1,2,5,7,-2,4,argentina
Estudiantes,4,1,1,2,4,6,-2,4,argentina
Defensa y J.,4,1,1,2,5,8,-3,4,argentina
Independiente,4,1,1,2,2,5,-3,4,argentina
Rosario Central,4,0,3,1,1,2,-1,3,argentina
Union Santa Fe,4,0,3,1,1,2,-1,3,argentina
Gimnasia,4,0,3,1,4,6,-2,3,argentina
Huracan,4,1,0,3,1,3,-2,3,argentina
Arsenal Sarandi,4,0,2,2,0,2,-2,2,argentina
Godoy Cruz,4,0,2,2,3,6,-3,2,argentina
Central Cordoba,4,0,2,2,2,6,-4,2,argentina
Colon Santa Fe,4,0,1,3,1,6,-5,1,argentina
Belgrano,4,0,1,3,0,7,-7,1,argentina
Sarmiento,4,0,0,4,0,8,-8,0,argentina
Atletico Mitre,4,3,0,1,6,4,2,9,argentina3
Chaco For Ever,4,3,0,1,6,4,2,9,argentina3
I. Rivadavia,4,2,2,0,3,1,2,8,argentina3
Quilmes,4,2,1,1,7,3,4,7,argentina3
SM San Juan,4,2,1,1,5,2,3,7,argentina3
CA Guemes,4,2,1,1,6,6,0,7,argentina3
Chacarita J.,4,2,1,1,4,4,0,7,argentina3
A. Rafaela,4,2,0,2,7,5,2,6,argentina3
E. Rio Cuarto,4,2,0,2,4,3,1,6,argentina3
San Telmo,4,2,0,2,4,4,0,6,argentina3
Brown de A.,4,2,0,2,3,5,-2,6,argentina3
SM Tucuman,4,1,2,1,5,4,1,5,argentina3
Agropecuario,4,1,2,1,4,4,0,5,argentina3
Deportivo Moron,4,1,2,1,3,3,0,5,argentina3
Almirante Brown,4,1,2,1,2,2,0,5,argentina3
D. Riestra,4,1,2,1,2,2,0,5,argentina3
Deportivo Maipu,4,1,2,1,5,6,-1,5,argentina3
Alvarado,4,1,1,2,6,6,0,4,argentina3
D. Madryn,4,0,4,0,0,0,0,4,argentina3
Racing Cordoba,4,1,1,2,5,7,-2,4,argentina3
Gimnasia Jujuy,4,1,1,2,4,6,-2,4,argentina3
Tristan Suarez,4,1,1,2,5,8,-3,4,argentina3
Temperley,4,1,1,2,4,7,-3,4,argentina3
D. de Belgrano,4,1,0,3,5,7,-2,3,argentina3
Nueva Chicago,4,1,0,3,3,5,-2,3,argentina3
All Boys,4,0,2,2,2,4,-2,2,argentina3
E. Caseros,4,0,2,2,3,6,-3,2,argentina3
Ferro Carril,4,0,2,2,5,9,-4,2,argentina3
Aldosivi,4,0,2,2,0,5,-5,2,argentina3
Pyunik,4,4,0,0,13,1,12,12,armenia
Noah,4,3,0,1,8,3,5,9,armenia
Ararat-Armenia,4,2,2,0,9,4,5,8,armenia
West Armenia,4,1,1,2,4,6,-2,4,armenia
Urartu,4,1,1,2,6,9,-3,4,armenia
Ararat Yerevan,4,1,0,3,4,7,-3,3,armenia
Alashkert,4,1,0,3,6,10,-4,3,armenia
Shirak,4,1,0,3,4,8,-4,3,armenia
BKMA,4,1,0,3,3,7,-4,3,armenia
Van,4,0,0,4,2,9,-7,0,armenia
Melbourne V.,1,1,0,0,2,0,2,3,australia
Western United,1,1,0,0,2,1,1,3,australia
Newcastle Jets,1,0,1,0,2,2,0,1,australia
Brisbane Roar,1,0,1,0,1,1,0,1,australia
Wellington,1,0,1,0,0,0,0,1,australia
Adelaide Utd,0,0,0,0,0,0,0,0,australia
Macarthur FC,0,0,0,0,0,0,0,0,australia
Melbourne City,0,0,0,0,0,0,0,0,australia
Perth Glory,0,0,0,0,0,0,0,0,australia
Western Sydney,0,0,0,0,0,0,0,0,australia
Central Coast,1,0,0,1,0,3,-3,0,australia
Sydney FC,1,0,0,1,0,3,-3,0,australia
Sturm Graz,4,3,1,0,6,3,3,10,austria
Salzburg,4,2,2,0,10,5,5,8,austria
A. Klagenfurt,4,2,2,0,8,4,4,8,austria
Rapid Wien,4,2,1,1,10,2,8,7,austria
Hartberg,4,2,1,1,5,2,3,7,austria
LASK Linz,4,2,1,1,6,4,2,7,austria
Wolfsberger AC,4,1,3,0,6,5,1,6,austria
BW Linz,4,2,0,2,6,10,-4,6,austria
Altach,4,1,2,1,4,2,2,5,austria
Tirol,4,1,1,2,4,7,-3,4,austria
Austria Wien,4,1,0,3,4,6,-2,3,austria
A. Lustenau,4,0,2,2,1,4,-3,2,austria
Bregenz,4,3,0,1,9,2,7,9,austria2
Stripfing,4,3,0,1,8,3,5,9,austria2
First Vienna,4,3,0,1,7,7,0,9,austria2
Kapfenberger,4,2,1,1,8,7,1,7,austria2
St. Polten,4,2,1,1,7,6,1,7,austria2
Grazer AK,4,2,1,1,6,6,0,7,austria2
Floridsdorfer,4,1,2,1,8,6,2,5,austria2
Ried,4,1,2,1,4,4,0,5,austria2
Leoben,4,1,1,2,5,7,-2,4,austria2
Lafnitz,4,1,1,2,4,7,-3,4,austria2
Sturm Graz B,4,1,1,2,4,8,-4,4,austria2
Admira Wacker,4,0,2,2,4,6,-2,2,austria2
Amstetten,4,0,1,3,3,7,-4,1,austria2
Dornbirn,4,0,1,3,2,7,-5,1,austria2
Liefering,4,0,1,3,3,9,-6,1,austria2
SV Horn,4,0,0,4,2,13,-11,0,austria2
Sebail,4,3,1,0,8,2,6,10,azerbaijan
Turan,4,2,1,1,6,2,4,7,azerbaijan
Araz,4,2,1,1,7,4,3,7,azerbaijan
Qarabag,4,2,1,1,7,5,2,7,azerbaijan
Neftci,4,2,1,1,6,4,2,7,azerbaijan
Zira,4,1,1,2,2,3,-1,4,azerbaijan
Qabala,4,1,1,2,3,6,-3,4,azerbaijan
Kapaz,4,0,2,2,3,5,-2,2,azerbaijan
Sabah,4,0,1,3,2,6,-4,1,azerbaijan
Sumqayit,4,0,1,3,2,10,-8,1,azerbaijan
Bashundhara K.,4,3,0,1,14,7,7,9,bangladesh
B. Police,4,3,0,1,13,6,7,9,bangladesh
Mohammedan,4,3,0,1,5,3,2,9,bangladesh
Rahmatgonj,4,2,1,1,8,8,0,7,bangladesh
Sheikh Jamal,4,2,1,1,5,5,0,7,bangladesh
Chittagong,4,1,2,1,5,6,-1,5,bangladesh
Sheikh Russel,4,1,2,1,4,5,-1,5,bangladesh
Fortis,4,1,1,2,6,7,-1,4,bangladesh
Abahani,4,0,1,3,3,6,-3,1,bangladesh
A. Uttara,4,0,1,3,1,9,-8,1,bangladesh
Muktijoddha S.,4,0,0,4,3,15,-12,0,bangladesh
Dinamo Minsk,4,4,0,0,13,2,11,12,belarus
Gomel,4,3,0,1,8,4,4,9,belarus
Isloch,4,3,0,1,6,3,3,9,belarus
T. Zhodino,4,2,2,0,4,2,2,8,belarus
Neman Grodno,4,2,1,1,10,6,4,7,belarus
BATE Borisov,4,2,1,1,5,3,2,7,belarus
Dinamo Brest,4,2,0,2,6,8,-2,6,belarus
S. Soligorsk,4,1,2,1,9,7,2,5,belarus
Slavia Mozyr,4,1,2,1,6,5,1,5,belarus
Slutsk,4,1,2,1,3,3,0,5,belarus
Naftan,4,1,1,2,6,8,-2,4,belarus
Energetik-BGU,4,1,1,2,5,8,-3,4,belarus
FC Minsk,4,1,0,3,2,7,-5,3,belarus
Smorgon,4,0,2,2,5,8,-3,2,belarus
Belshina,4,0,1,3,4,10,-6,1,belarus
Dnepr Mogilev,4,4,0,0,15,0,15,12,belarus2
FC Ostrovets,4,3,0,1,12,5,7,9,belarus2
Arsenal D.,4,3,0,1,7,4,3,9,belarus2
Vitebsk,4,2,1,1,8,4,4,7,belarus2
Zhodino Yuzhnoe,4,2,0,2,6,5,1,6,belarus2
Maxline,4,2,0,2,9,9,0,6,belarus2
S.Petrikov,4,2,0,2,4,5,-1,6,belarus2
Lokomotiv Gomel,4,1,2,1,3,3,0,5,belarus2
Molodechno-DYuS,4,1,2,1,9,10,-1,5,belarus2
Volna Pinsk,4,1,1,2,5,4,1,4,belarus2
Orsha,4,1,1,2,8,9,-1,4,belarus2
Lida,4,1,1,2,6,12,-6,4,belarus2
Niva,4,1,0,3,7,12,-5,3,belarus2
Bumprom,4,1,0,3,2,8,-6,3,belarus2
Slonim,4,0,2,2,4,8,-4,2,belarus2
Baranovichi,4,0,1,3,2,5,-3,1,belarus2
Osipovichy,4,0,0,4,1,10,-9,0,belarus2
Royale Union SG,4,3,0,1,9,6,3,9,belgium
Standard Liege,4,2,2,0,7,4,3,8,belgium
KRC Genk,4,2,2,0,5,2,3,8,belgium
Cercle Brugge,4,2,0,2,5,4,1,6,belgium
Antwerp,4,1,2,1,7,5,2,5,belgium
Anderlecht,4,1,2,1,8,7,1,5,belgium
Westerlo,4,0,3,1,5,6,-1,3,belgium
Gent,4,0,3,1,2,4,-2,3,belgium
Sint-Truiden,4,0,3,1,5,9,-4,3,belgium
OH Leuven,4,1,0,3,6,12,-6,3,belgium
KV Mechelen,4,1,0,3,4,11,-7,3,belgium
RWDM,4,0,2,2,3,10,-7,2,belgium
Club Brugge,4,0,1,3,3,6,-3,1,belgium
Charleroi,4,0,1,3,4,9,-5,1,belgium
Eupen,4,0,0,4,3,11,-8,0,belgium
Kortrijk,4,0,0,4,0,11,-11,0,belgium
Real Tomayapo,4,3,0,1,5,4,1,9,bolivia
U. de Vinto,4,2,2,0,3,0,3,8,bolivia
Oriente P.,4,2,1,1,8,4,4,7,bolivia
Aurora,4,1,3,0,5,4,1,6,bolivia
I. Petrolero,4,2,0,2,5,5,0,6,bolivia
Santa Cruz,4,2,0,2,5,7,-2,6,bolivia
The Strongest,4,1,2,1,4,5,-1,5,bolivia
Wilstermann,4,1,1,2,6,6,0,4,bolivia
Vaca Diez,4,1,1,2,5,10,-5,4,bolivia
Nacional Potosi,4,0,2,2,8,10,-2,2,bolivia
Royal Pari,4,0,2,2,5,7,-2,2,bolivia
Bolivar,4,0,2,2,3,6,-3,2,bolivia
Libertad,4,0,2,2,5,9,-4,2,bolivia
A. Palmaflor,4,0,1,3,2,9,-7,1,bolivia
Blooming,4,0,1,3,2,9,-7,1,bolivia
Always Ready,4,0,1,3,1,11,-10,1,bolivia
Guabira,4,0,0,4,1,8,-7,0,bolivia
Atletico MG,4,3,1,0,7,2,5,10,brazil
Bragantino,4,2,2,0,6,2,4,8,brazil
Cruzeiro,4,2,1,1,4,1,3,7,brazil
Athletico PR,4,2,1,1,6,4,2,7,brazil
Botafogo,4,2,0,2,4,3,1,6,brazil
Bahia,4,2,0,2,10,10,0,6,brazil
Santos,4,2,0,2,5,11,-6,6,brazil
Flamengo,4,1,2,1,5,4,1,5,brazil
Palmeiras,4,1,1,2,3,3,0,4,brazil
Corinthians,4,1,1,2,6,7,-1,4,brazil
Internacional,4,1,1,2,3,4,-1,4,brazil
Vasco da Gama,4,1,1,2,3,6,-3,4,brazil
Cuiaba,4,1,0,3,3,5,-2,3,brazil
Fortaleza,4,1,0,3,2,5,-3,3,brazil
Coritiba,4,1,0,3,5,10,-5,3,brazil
America MG,4,0,2,2,6,8,-2,2,brazil
Goias,4,0,2,2,5,8,-3,2,brazil
Gremio,4,0,2,2,7,11,-4,2,brazil
Fluminense,4,0,1,3,4,10,-6,1,brazil
Sao Paulo,4,0,1,3,1,9,-8,1,brazil
CSKA Sofia,4,4,0,0,9,2,7,12,bulgaria
Arda,4,2,1,1,5,2,3,7,bulgaria
Ludogorets,4,2,1,1,4,2,2,7,bulgaria
Hebar,4,2,0,2,7,6,1,6,bulgaria
Lok. Plovdiv,4,1,3,0,5,4,1,6,bulgaria
Pirin Blag.,4,2,0,2,5,7,-2,6,bulgaria
Lokomotiv Sofia,4,2,0,2,3,9,-6,6,bulgaria
Levski Sofia,4,1,2,1,6,5,1,5,bulgaria
Cherno More,4,1,2,1,2,2,0,5,bulgaria
CSKA 1948 Sofia,4,1,2,1,2,3,-1,5,bulgaria
Botev Plovdiv,4,1,1,2,7,7,0,4,bulgaria
Etar,4,1,1,2,3,5,-2,4,bulgaria
Beroe,4,1,0,3,3,8,-5,3,bulgaria
Slavia Sofia,4,0,1,3,2,7,-5,1,bulgaria
Botev Vratsa,4,0,1,3,2,8,-6,1,bulgaria
L. Krumovgrad,4,0,1,3,0,7,-7,1,bulgaria
Cavalry,4,3,1,0,5,2,3,10,canada
Forge,4,3,0,1,9,5,4,9,canada
York Utd,4,2,1,1,8,7,1,7,canada
Valour,4,2,0,2,6,5,1,6,canada
Vancouver FC,4,2,0,2,5,5,0,6,canada
HFX Wanderers,4,1,2,1,4,4,0,5,canada
A. Ottawa,4,1,0,3,4,6,-2,3,canada
Pacific,4,1,0,3,3,8,-5,3,canada
Everton,4,3,0,1,7,2,5,9,chile
Huachipato,4,3,0,1,8,6,2,9,chile
Union La Calera,4,2,1,1,6,3,3,7,chile
Cobresal,4,2,1,1,6,10,-4,7,chile
Nublense,4,2,0,2,7,4,3,6,chile
O`Higgins,4,2,0,2,9,7,2,6,chile
Colo-Colo,4,1,2,1,5,5,0,5,chile
U. Catolica,4,1,1,2,6,7,-1,4,chile
Palestino,4,1,1,2,6,8,-2,4,chile
Copiapo,4,0,3,1,3,4,-1,3,chile
Curico Unido,4,0,3,1,4,7,-3,3,chile
Audax Italiano,4,1,0,3,3,7,-4,3,chile
Coquimbo Unido,4,0,2,2,6,8,-2,2,chile
Union Espanola,4,0,0,4,5,10,-5,0,chile
Magallanes,4,0,0,4,3,8,-5,0,chile
U. de Chile,4,0,0,4,3,10,-7,0,chile
S. Morning,4,3,0,1,6,2,4,9,chile2
D. Iquique,4,2,2,0,6,2,4,8,chile2
Barnechea,4,2,1,1,7,5,2,7,chile2
Cobreloa,4,2,1,1,7,6,1,7,chile2
Recoleta,4,2,1,1,5,4,1,7,chile2
S. Wanderers,4,2,1,1,5,4,1,7,chile2
Rangers,4,2,1,1,5,6,-1,7,chile2
Deportes Temuco,4,1,2,1,4,4,0,5,chile2
Puerto Montt,4,1,2,1,5,6,-1,5,chile2
San Luis,4,1,1,2,4,5,-1,4,chile2
U. Concepcion,4,1,1,2,6,9,-3,4,chile2
San Marcos,4,0,3,1,6,7,-1,3,chile2
La Serena,4,1,0,3,4,11,-7,3,chile2
CD Santa Cruz,4,0,1,3,3,7,-4,1,chile2
U. San Felipe,4,0,1,3,1,5,-4,1,chile2
Antofagasta,4,0,0,4,4,10,-6,0,chile2
Zhejiang,4,3,1,0,11,4,7,10,china
Beijing Guoan,4,3,1,0,9,3,6,10,china
S. Taishan,4,2,1,1,6,3,3,7,china
Shanghai Port,4,2,0,2,8,5,3,6,china
Tianjin T.,4,2,0,2,5,3,2,6,china
Wuhan Three T.,4,2,0,2,6,5,1,6,china
S. Shenhua,4,2,0,2,4,6,-2,6,china
Chengdu,4,1,2,1,5,4,1,5,china
Henan SL,4,1,1,2,5,7,-2,4,china
Nantong Zhiyun,4,1,1,2,5,8,-3,4,china
Meizhou Hakka,4,1,1,2,4,10,-6,4,china
Changchun Yatai,4,1,0,3,3,7,-4,3,china
Qingdao Jonoon,4,0,1,3,2,6,-4,1,china
Dalian P.,4,0,0,4,1,8,-7,0,china
Shenzhen,4,0,0,4,2,14,-12,0,china
Cangzhou,4,0,0,4,1,13,-12,0,china
Sichuan Jiuniu,4,4,0,0,11,1,10,12,china2
Wuxi Wugou,4,2,1,1,6,8,-2,7,china2
Jiangxi L.,4,1,3,0,4,3,1,6,china2
Nanjing,4,1,3,0,3,2,1,6,china2
Qingdao Y. I.,4,1,2,1,5,4,1,5,china2
Hebei Kungfu,4,1,2,1,4,4,0,5,china2
Jinan Xingzhou,4,1,2,1,3,3,0,5,china2
Shenyang Urban,4,1,2,1,3,3,0,5,china2
Guangxi Baoyun,4,0,4,0,3,3,0,4,china2
Shanghai Jiadin,4,1,1,2,3,5,-2,4,china2
Dantong Hantong,4,1,1,2,2,4,-2,4,china2
Guangzhou FC,4,1,0,3,4,6,-2,3,china2
Dongguan United,4,1,0,3,2,6,-4,3,china2
Yanbian Longdin,4,0,2,2,3,7,-4,2,china2
Suzhou Dongwu,4,0,1,3,1,9,-8,1,china2
Heilongjiang L.,4,0,0,4,2,6,-4,0,china2
Deportes Tolima,4,3,0,1,3,2,1,9,colombia2
R. Aguilas,4,2,2,0,7,1,6,8,colombia2
Millonarios,4,2,1,1,6,6,0,7,colombia2
America de Cali,4,1,3,0,7,5,2,6,colombia2
I. Medelin,4,1,3,0,6,5,1,6,colombia2
La Equidad,4,1,2,1,5,5,0,5,colombia2
Junior,4,1,1,2,3,3,0,4,colombia2
D. Pereira,4,1,1,2,4,5,-1,4,colombia2
A. Nacional,4,1,1,2,6,8,-2,4,colombia2
Union Magdalena,4,1,1,2,5,7,-2,4,colombia2
Deportivo Cali,4,1,1,2,7,10,-3,4,colombia2
Deportivo Pasto,4,1,0,3,2,5,-3,3,colombia2
A. Bucaramanga,4,1,0,3,2,7,-5,3,colombia2
Santa Fe,4,0,2,2,2,6,-4,2,colombia2
Once Caldas,4,0,1,3,3,6,-3,1,colombia2
Jaguares de C.,4,0,1,3,0,5,-5,1,colombia2
A. Petrolera,4,0,1,3,0,6,-6,1,colombia2
Envigado,4,0,1,3,4,11,-7,1,colombia2
Boyaca Chico,4,0,1,3,1,9,-8,1,colombia2
Atletico Huila,4,0,0,4,1,6,-5,0,colombia2
Herediano,4,2,2,0,9,4,5,8,costarica
Saprissa,4,2,1,1,8,5,3,7,costarica
Alajuelense,4,2,1,1,8,7,1,7,costarica
Guanacasteca,4,2,1,1,3,5,-2,7,costarica
Cartagines,4,2,0,2,7,5,2,6,costarica
Sporting SJ,4,1,2,1,5,5,0,5,costarica
M. Liberia,4,1,1,2,8,9,-1,4,costarica
Santos DG,4,0,2,2,1,7,-6,2,costarica
San Carlos,4,0,1,3,6,9,-3,1,costarica
Puntarenas,4,0,1,3,4,9,-5,1,costarica
Zeledon,4,0,0,4,0,10,-10,0,costarica
AD Grecia,4,0,0,4,2,16,-14,0,costarica
Sparta Prague,4,2,2,0,7,3,4,8,czechrepublic
Slavia Prague,4,2,2,0,5,3,2,8,czechrepublic
Banik Ostrava,4,2,1,1,5,2,3,7,czechrepublic
Viktoria Plzen,4,2,0,2,13,9,4,6,czechrepublic
Mlada Boleslav,4,2,0,2,11,12,-1,6,czechrepublic
Sigma Olomouc,4,1,1,2,7,7,0,4,czechrepublic
Teplice,4,1,1,2,5,7,-2,4,czechrepublic
Pardubice,4,1,1,2,4,8,-4,4,czechrepublic
Bohemians,4,1,0,3,2,7,-5,3,czechrepublic
Slovacko,4,1,0,3,1,9,-8,3,czechrepublic
Slovan Liberec,4,0,2,2,4,9,-5,2,czechrepublic
Jablonec,4,0,1,3,4,7,-3,1,czechrepublic
Hradec Kralove,4,0,1,3,3,9,-6,1,czechrepublic
C. Budejovice,4,0,1,3,2,9,-7,1,czechrepublic
Zlin,4,0,1,3,1,8,-7,1,czechrepublic
Karvina,4,0,0,4,2,11,-9,0,czechrepublic
Brondby IF,4,3,1,0,9,2,7,10,denmark
Silkeborg,4,3,0,1,8,3,5,9,denmark
FC Kobenhavn,4,2,2,0,8,5,3,8,denmark
FC Midtjylland,4,2,1,1,6,6,0,7,denmark
Odense BK,4,2,0,2,8,5,3,6,denmark
Lyngby,4,2,0,2,3,7,-4,6,denmark
AGF Aarhus,4,1,2,1,5,4,1,5,denmark
Nordsjaelland,4,1,2,1,3,3,0,5,denmark
Vejle BK,4,1,1,2,5,6,-1,4,denmark
Randers FC,4,1,1,2,5,7,-2,4,denmark
Hvidovre,4,0,2,2,1,4,-3,2,denmark
Viborg,4,0,0,4,0,6,-6,0,denmark
Aalborg BK,4,3,1,0,10,4,6,10,denmark2
SonderjyskE,4,3,1,0,10,7,3,10,denmark2
Hobro,4,3,0,1,7,3,4,9,denmark2
Fredericia,4,2,2,0,5,2,3,8,denmark2
Hillerod,4,2,1,1,11,6,5,7,denmark2
Vendsyssel,4,2,0,2,7,5,2,6,denmark2
Kolding IF,4,2,0,2,5,9,-4,6,denmark2
AC Horsens,4,1,1,2,2,4,-2,4,denmark2
B 93,4,1,1,2,2,6,-4,4,denmark2
Helsingor,4,0,1,3,0,6,-6,1,denmark2
Naestved,4,0,1,3,4,11,-7,1,denmark2
HB Koge,4,0,1,3,4,12,-8,1,denmark2
I. del Valle,4,4,0,0,9,4,5,12,ecuador
El Nacional,4,3,0,1,10,9,1,9,ecuador
LDU Quito,4,2,2,0,10,5,5,8,ecuador
U. Catolica,4,2,2,0,5,3,2,8,ecuador
Barcelona SC,4,1,2,1,7,9,-2,5,ecuador
Emelec,4,1,1,2,7,7,0,4,ecuador
Gualaceo,4,1,1,2,2,3,-1,4,ecuador
Delfin,4,1,1,2,2,8,-6,4,ecuador
D. Cuenca,4,1,0,3,4,6,-2,3,ecuador
Cumbaya,4,0,2,2,1,3,-2,2,ecuador
Libertad,4,0,2,2,5,8,-3,2,ecuador
Mushuc Runa,4,0,1,3,3,8,-5,1,ecuador
Aucas,4,0,1,3,1,9,-8,1,ecuador
Guayaquil City,4,0,1,3,1,9,-8,1,ecuador
Tecnico U.,4,0,0,4,2,6,-4,0,ecuador
Orense,4,0,0,4,2,10,-8,0,ecuador
Cuniburo,4,3,0,1,9,5,4,9,ecuador3
I. Juniors,4,2,1,1,6,3,3,7,ecuador3
Macara,4,2,0,2,4,6,-2,6,ecuador3
Imbabura,4,1,2,1,4,4,0,5,ecuador3
America de Q.,4,1,2,1,6,8,-2,5,ecuador3
Manta,4,1,1,2,7,10,-3,4,ecuador3
Vargas Torres,4,1,1,2,5,9,-4,4,ecuador3
Nueve Octubre,4,1,0,3,2,4,-2,3,ecuador3
Chacaritas,4,1,0,3,3,7,-4,3,ecuador3
Guayaquil,4,0,0,4,2,11,-9,0,ecuador3
Future FC,2,2,0,0,4,0,4,6,egypt
Pyramids FC,2,2,0,0,2,0,2,6,egypt
Baladiyyat,2,1,1,0,5,3,2,4,egypt
Zamalek,2,1,1,0,4,3,1,4,egypt
ZED FC,2,1,1,0,4,3,1,4,egypt
Pharco,2,1,0,1,1,1,0,3,egypt
Smouha,2,1,0,1,3,5,-2,3,egypt
Al Masry,3,1,0,2,5,8,-3,3,egypt
El Gouna,2,0,2,0,3,3,0,2,egypt
Al Mokawloon,2,0,1,1,2,3,-1,1,egypt
Ceramica C.,2,0,1,1,2,3,-1,1,egypt
El Geish,2,0,1,1,0,1,-1,1,egypt
Al Ittihad,2,0,1,1,3,5,-2,1,egypt
Al Ahly,0,0,0,0,0,0,0,0,egypt
ENPPI,2,0,0,2,0,2,-2,0,egypt
Ismaily,2,0,0,2,1,4,-3,0,egypt
National Bank,2,0,0,2,1,5,-4,0,egypt
El Daklyeh,2,0,0,2,1,6,-5,0,egypt
Tottenham,4,3,1,0,10,4,6,10,england
Arsenal,4,3,1,0,8,2,6,10,england
Chelsea,4,2,1,1,7,4,3,7,england
Liverpool,4,2,1,1,8,6,2,7,england
Wolverhampton,4,2,1,1,6,5,1,7,england
Aston Villa,4,2,1,1,5,5,0,7,england
Manchester City,4,2,0,2,6,5,1,6,england
Brighton,4,2,0,2,9,10,-1,6,england
West Ham Utd,4,2,0,2,7,9,-2,6,england
Manchester Utd,4,2,0,2,4,6,-2,6,england
Newcastle Utd,4,1,1,2,11,6,5,4,england
Brentford,4,1,1,2,5,4,1,4,england
Nottm Forest,4,1,1,2,3,5,-2,4,england
Luton Town,4,1,1,2,4,7,-3,4,england
Everton,4,1,1,2,5,9,-4,4,england
Burnley,4,1,1,2,3,7,-4,4,england
Crystal Palace,4,1,1,2,3,8,-5,4,england
Fulham,4,0,2,2,3,9,-6,2,england
Bournemouth,4,0,1,3,4,11,-7,1,england
Sheffield Utd,4,0,0,4,3,9,-6,0,england
Leicester City,4,4,0,0,13,3,10,12,england2
Middlesbrough,4,3,1,0,10,4,6,10,england2
Ipswich Town,4,3,1,0,4,1,3,10,england2
Swansea City,4,2,1,1,7,4,3,7,england2
Hull City,4,2,1,1,7,6,1,7,england2
Southampton,4,2,1,1,6,5,1,7,england2
Blackburn,4,2,0,2,9,6,3,6,england2
Sunderland,4,2,0,2,7,4,3,6,england2
Cardiff City,4,2,0,2,5,3,2,6,england2
Millwall,4,1,3,0,4,2,2,6,england2
Bristol City,4,2,0,2,5,5,0,6,england2
West Brom,4,1,2,1,7,5,2,5,england2
Huddersfield,4,1,2,1,4,6,-2,5,england2
Stoke City,4,1,1,2,5,7,-2,4,england2
Leeds Utd,4,1,1,2,4,6,-2,4,england2
Preston,4,1,1,2,5,8,-3,4,england2
Watford,4,1,1,2,2,6,-4,4,england2
Coventry City,4,1,0,3,5,7,-2,3,england2
Plymouth,4,0,2,2,3,7,-4,2,england2
QP Rangers,4,0,1,3,1,5,-4,1,england2
Norwich City,4,0,1,3,5,11,-6,1,england2
Rotherham,4,0,1,3,1,8,-7,1,england2
Birmingham City,4,0,0,4,1,7,-6,0,england2
Sheffield Wed,4,0,0,4,0,8,-8,0,england2
Barnsley,4,3,1,0,8,2,6,10,england3
Oxford Utd,4,3,0,1,9,4,5,9,england3
Portsmouth,4,2,2,0,6,4,2,8,england3
Derby County,4,2,1,1,6,3,3,7,england3
Bolton,4,2,1,1,7,5,2,7,england3
Fleetwood,4,2,1,1,6,4,2,7,england3
Burton Albion,4,2,1,1,5,4,1,7,england3
Leyton Orient,4,1,2,1,4,4,0,5,england3
Blackpool,4,1,2,1,4,5,-1,5,england3
Peterborough,4,1,2,1,4,5,-1,5,england3
Wycombe,4,1,1,2,8,8,0,4,england3
Stevenage,4,1,1,2,6,7,-1,4,england3
Carlisle Utd,4,1,1,2,4,5,-1,4,england3
Lincoln City,4,1,1,2,3,5,-2,4,england3
Northampton,4,1,0,3,3,4,-1,3,england3
Wigan Athletic,4,1,0,3,4,7,-3,3,england3
Bristol Rovers,4,1,0,3,4,8,-4,3,england3
Exeter City,4,1,0,3,2,9,-7,3,england3
Charlton,4,0,2,2,3,6,-3,2,england3
Port Vale,4,0,2,2,1,6,-5,2,england3
Cambridge Utd,4,0,1,3,2,5,-3,1,england3
Shrewsbury,4,0,1,3,1,8,-7,1,england3
Cheltenham,4,0,0,4,2,9,-7,0,england3
Reading,4,0,0,4,3,13,-10,0,england3
Stockport,4,4,0,0,10,3,7,12,england4
Harrogate,4,3,1,0,6,3,3,10,england4
Morecambe,4,3,0,1,9,6,3,9,england4
Mansfield,4,2,2,0,10,4,6,8,england4
AFC Wimbledon,4,2,2,0,4,1,3,8,england4
Notts County,4,2,1,1,9,7,2,7,england4
Accrington,4,2,1,1,7,5,2,7,england4
Salford City,4,2,0,2,9,6,3,6,england4
Bradford,4,2,0,2,7,7,0,6,england4
Doncaster,4,2,0,2,6,6,0,6,england4
Crewe Alexandra,4,1,2,1,11,11,0,5,england4
Crawley Town,4,1,2,1,7,8,-1,5,england4
Wrexham,4,1,2,1,2,6,-4,5,england4
Barrow,4,1,1,2,5,5,0,4,england4
Walsall,4,1,1,2,6,10,-4,4,england4
Forest Green,4,1,0,3,5,8,-3,3,england4
Gillingham,4,1,0,3,3,8,-5,3,england4
Colchester Utd,4,1,0,3,5,11,-6,3,england4
Milton Keynes,4,0,2,2,2,4,-2,2,england4
Swindon Town,4,0,2,2,5,8,-3,2,england4
Grimsby,4,0,1,3,5,10,-5,1,england4
Tranmere,4,0,0,4,3,10,-7,0,england4
Newport,4,0,0,4,2,11,-9,0,england4
Sutton Utd,4,0,0,4,3,13,-10,0,england4
Chesterfield,4,3,1,0,6,2,4,10,england5
Altrincham,4,3,1,0,5,1,4,10,england5
Dorking,4,3,0,1,5,2,3,9,england5
Barnet,4,3,0,1,11,9,2,9,england5
Halifax Town,4,2,1,1,6,4,2,7,england5
Oldham,4,2,1,1,7,8,-1,7,england5
Woking,4,2,0,2,4,3,1,6,england5
Aldershot Town,4,2,0,2,5,5,0,6,england5
Eastleigh,4,2,0,2,6,7,-1,6,england5
York City,4,2,0,2,5,9,-4,6,england5
Gateshead FC,4,1,2,1,8,6,2,5,england5
Boreham Wood,4,1,2,1,7,7,0,5,england5
Rochdale,4,1,2,1,5,6,-1,5,england5
Southend Utd,4,1,2,1,5,6,-1,5,england5
Bromley,4,1,2,1,4,5,-1,5,england5
Solihull Moors,4,1,2,1,5,8,-3,5,england5
Kidderminster,4,1,1,2,4,5,-1,4,england5
Dagenham & R.,4,0,3,1,3,4,-1,3,england5
Hartlepool,4,1,0,3,3,5,-2,3,england5
AFC Fylde,4,1,0,3,4,8,-4,3,england5
Maidenhead Utd,4,0,1,3,5,11,-6,1,england5
Ebbsfleet Utd,4,0,1,3,4,15,-11,1,england5
Wealdstone,4,0,0,4,4,9,-5,0,england5
Oxford City,4,0,0,4,2,12,-10,0,england5
Flora,4,3,1,0,6,3,3,10,estonia
Levadia,4,2,1,1,6,5,1,7,estonia
Vaprus,4,1,1,2,5,5,0,4,estonia
Paide,4,1,1,2,3,4,-1,4,estonia
Nomme Kalju,4,1,0,3,3,5,-2,3,estonia
Harju Jalgpalli,4,1,0,3,4,9,-5,3,estonia
Narva Trans,4,1,0,3,4,9,-5,3,estonia
Tallinna Kalev,4,0,2,2,3,5,-2,2,estonia
Tammeka,4,0,1,3,3,9,-6,1,estonia
Kuressaare,4,0,0,4,1,11,-10,0,estonia
Nomme Utd,4,4,0,0,19,3,16,12,estonia2
Viimsi,4,3,1,0,9,2,7,10,estonia2
Flora B,4,3,0,1,10,6,4,9,estonia2
FC Tallinn,4,2,1,1,8,4,4,7,estonia2
Levadia B,4,2,1,1,5,3,2,7,estonia2
Tabasalu,4,2,0,2,9,8,1,6,estonia2
Alliance,4,1,1,2,4,6,-2,4,estonia2
Paide B,4,1,1,2,7,12,-5,4,estonia2
Elva,4,1,0,3,4,12,-8,3,estonia2
Legion,4,0,2,2,6,11,-5,2,estonia2
Vikingur,4,4,0,0,14,2,12,12,faroeislands
HB Torshavn,4,3,1,0,15,5,10,10,faroeislands
Klaksvik,4,2,2,0,8,2,6,8,faroeislands
B36 Torshavn,4,2,1,1,8,8,0,7,faroeislands
B68 Toftir,4,1,2,1,5,6,-1,5,faroeislands
Streymur,4,1,2,1,3,10,-7,5,faroeislands
07 Vestur,4,1,0,3,5,8,-3,3,faroeislands
TB Tvoroyri,4,0,1,3,1,6,-5,1,faroeislands
AB Argir,4,0,1,3,4,12,-8,1,faroeislands
IF Fuglafjordur,4,0,0,4,2,12,-10,0,faroeislands
Skala,4,3,0,1,16,5,11,9,faroeislands2
NSI Runavik,4,3,0,1,12,6,6,9,faroeislands2
Vikingur B,4,2,0,2,9,4,5,6,faroeislands2
Hoyvik,4,2,0,2,12,8,4,6,faroeislands2
Klaksvik B,4,2,0,2,11,7,4,6,faroeislands2
B36 Torshavn B,4,1,0,3,10,12,-2,3,faroeislands2
B71 Sandur,4,0,3,1,3,7,-4,3,faroeislands2
HB B,4,0,0,4,1,12,-11,0,faroeislands2
B68 Toftir B,4,0,0,4,2,14,-12,0,faroeislands2
Streymur B,4,0,0,4,0,22,-22,0,faroeislands2
VPS,4,4,0,0,9,1,8,12,finland
HJK Helsinki,4,3,0,1,11,7,4,9,finland
KuPS,4,2,2,0,7,5,2,8,finland
Ilves,4,2,1,1,12,6,6,7,finland
Haka,4,2,1,1,6,5,1,7,finland
Honka,4,2,0,2,5,8,-3,6,finland
SJK,4,1,1,2,3,6,-3,4,finland
Inter Turku,4,1,1,2,3,7,-4,4,finland
Mariehamn,4,1,0,3,7,8,-1,3,finland
Lahti,4,0,2,2,2,5,-3,2,finland
Oulu,4,0,0,4,5,11,-6,0,finland
KTP,4,0,0,4,2,8,-6,0,finland
Ekenas IF,4,4,0,0,10,3,7,12,finland2
Gnistan,4,2,2,0,8,6,2,8,finland2
JaPS,4,2,0,2,4,5,-1,6,finland2
Jaro,4,1,2,1,5,5,0,5,finland2
KaPa,4,1,1,2,9,9,0,4,finland2
SJK Akatemia,4,1,1,2,6,7,-1,4,finland2
Mikkelin,4,1,1,2,5,6,-1,4,finland2
TPS,4,1,1,2,4,6,-2,4,finland2
HIFK,4,1,0,3,5,8,-3,3,finland2
JJK,4,0,2,2,5,8,-3,2,finland2
SalPa,4,0,2,2,4,7,-3,2,finland2
KPV Kokkola,4,0,1,3,3,11,-8,1,finland2
Nice,4,3,1,0,6,3,3,10,france
Paris SG,4,2,2,0,8,3,5,8,france
Monaco,4,2,2,0,12,8,4,8,france
Reims,4,2,2,0,8,5,3,8,france
Nantes,4,2,0,2,4,6,-2,6,france
Metz,4,2,0,2,3,5,-2,6,france
Lille,4,1,2,1,6,7,-1,5,france
Montpellier,4,1,1,2,5,5,0,4,france
Clermont,4,1,1,2,5,7,-2,4,france
Brest,4,1,1,2,2,4,-2,4,france
Lens,4,1,1,2,2,6,-4,4,france
Rennes,4,0,3,1,2,3,-1,3,france
Le Havre,4,0,3,1,4,7,-3,3,france
Strasbourg,4,1,0,3,1,8,-7,3,france
Toulouse,4,0,2,2,2,5,-3,2,france
Lorient,4,0,2,2,6,11,-5,2,france
Lyon,4,0,1,3,1,5,-4,1,france
Marseille,4,0,1,3,3,9,-6,1,france
Saint-Etienne,4,4,0,0,5,1,4,12,france2
Auxerre,4,3,1,0,9,4,5,10,france2
Laval,4,3,1,0,5,0,5,10,france2
Angers,4,3,0,1,7,5,2,9,france2
Concarneau,4,2,1,1,4,4,0,7,france2
Grenoble,4,1,3,0,4,3,1,6,france2
Pau FC,4,1,2,1,8,7,1,5,france2
Quevilly Rouen,4,1,2,1,6,6,0,5,france2
Caen,4,1,1,2,7,8,-1,4,france2
Paris FC,4,1,1,2,6,7,-1,4,france2
Annecy,4,1,1,2,5,7,-2,4,france2
Rodez Aveyron,4,1,1,2,5,7,-2,4,france2
Guingamp,4,1,1,2,3,6,-3,4,france2
Bordeaux,4,1,1,2,2,5,-3,4,france2
Valenciennes,4,0,3,1,3,4,-1,3,france2
Troyes,4,0,2,2,4,6,-2,2,france2
SC Bastia,4,0,2,2,1,5,-4,2,france2
AC Ajaccio,4,0,2,2,0,6,-6,2,france2
USL Dunkerque,4,0,1,3,5,11,-6,1,france2
Amiens,4,0,1,3,1,7,-6,1,france2
Red Star,4,3,1,0,6,3,3,10,france3
Le Mans,4,3,0,1,7,7,0,9,france3
Versailles,4,2,1,1,4,1,3,7,france3
Rouen,4,2,1,1,5,4,1,7,france3
Sochaux,4,1,2,1,5,5,0,5,france3
Nimes,4,1,2,1,4,4,0,5,france3
Marignane G.,4,1,2,1,3,3,0,5,france3
G. O. A. L.,4,1,1,2,6,5,1,4,france3
Chateauroux,4,0,4,0,6,6,0,4,france3
Niort,4,1,1,2,6,8,-2,4,france3
Villefranche,4,1,1,2,4,7,-3,4,france3
Orleans,4,1,1,2,4,8,-4,4,france3
Martigues,4,0,3,1,0,2,-2,3,france3
Cholet,4,1,0,3,3,7,-4,3,france3
Avranches,4,0,2,2,2,6,-4,2,france3
Nancy,4,0,1,3,1,4,-3,1,france3
Dijon,4,0,1,3,0,8,-8,1,france3
Epinal,4,0,0,4,3,10,-7,0,france3
Dinamo Batumi,4,3,1,0,12,1,11,10,georgia
Dinamo Tbilisi,4,2,1,1,10,7,3,7,georgia
Samtredia,4,2,1,1,7,4,3,7,georgia
Torpedo Kutaisi,4,1,3,0,2,1,1,6,georgia
Telavi,4,2,0,2,5,6,-1,6,georgia
Gagra,4,1,1,2,4,10,-6,4,georgia
Saburtalo,4,1,0,3,2,8,-6,3,georgia
Dila Gori,4,0,2,2,3,6,-3,2,georgia
Samgurali,4,0,0,4,4,13,-9,0,georgia
Shukura,4,0,0,4,3,15,-12,0,georgia
Bolnisi,4,3,1,0,9,1,8,10,georgia2
Gareji Sagarejo,4,3,0,1,7,4,3,9,georgia2
Kolkheti Poti,4,2,2,0,13,2,11,8,georgia2
Spaeri,4,2,1,1,6,4,2,7,georgia2
L. Tbilisi,4,2,1,1,5,3,2,7,georgia2
WIT Georgia,4,1,2,1,8,8,0,5,georgia2
D. Tbilisi B,4,1,1,2,3,5,-2,4,georgia2
Kolkheti Khobi,4,0,2,2,2,8,-6,2,georgia2
Merani Tbilisi,4,0,1,3,2,10,-8,1,georgia2
Merani Martvili,4,0,1,3,6,17,-11,1,georgia2
Hoffenheim,4,4,0,0,11,5,6,12,germany
Bayern Munich,4,3,1,0,11,4,7,10,germany
Leverkusen,4,3,1,0,10,3,7,10,germany
RB Leipzig,4,3,0,1,9,4,5,9,germany
Stuttgart,4,3,0,1,9,6,3,9,germany
Dortmund,3,2,1,0,8,4,4,7,germany
Monchengladbach,4,1,2,1,11,11,0,5,germany
E. Frankfurt,4,1,2,1,5,5,0,5,germany
Freiburg,4,1,1,2,2,9,-7,4,germany
Union Berlin,4,1,0,3,7,8,-1,3,germany
FC Augsburg,4,1,0,3,6,10,-4,3,germany
Wolfsburg,4,1,0,3,4,8,-4,3,germany
Darmstadt,4,1,0,3,4,10,-6,3,germany
Bochum,4,0,2,2,3,11,-8,2,germany
FC Koln,4,0,1,3,2,7,-5,1,germany
Heidenheim,4,0,1,3,3,10,-7,1,germany
FSV Mainz,4,0,1,3,4,12,-8,1,germany
Werder Bremen,4,0,0,4,4,10,-6,0,germany
Holstein Kiel,4,3,0,1,8,6,2,9,germany2
Dusseldorf,4,2,1,1,8,2,6,7,germany2
Paderborn,4,2,1,1,7,5,2,7,germany2
Elversberg,4,2,1,1,6,4,2,7,germany2
Hannover 96,4,2,1,1,7,6,1,7,germany2
Sankt Pauli,4,1,3,0,5,4,1,6,germany2
Hertha Berlin,4,2,0,2,10,12,-2,6,germany2
Kaiserslautern,4,1,2,1,8,8,0,5,germany2
Hamburger SV,4,1,1,2,4,5,-1,4,germany2
FC Nurnberg,4,1,1,2,7,12,-5,4,germany2
Wehen Wiesbaden,4,1,0,3,4,6,-2,3,germany2
Hansa Rostock,4,1,0,3,3,7,-4,3,germany2
Greuther Furth,4,0,2,2,2,9,-7,2,germany2
Osnabruck,4,0,2,2,3,11,-8,2,germany2
Magdeburg,4,0,1,3,4,7,-3,1,germany2
Karlsruher SC,4,0,1,3,5,9,-4,1,germany2
Schalke 04,4,0,1,3,3,10,-7,1,germany2
Braunschweig,4,0,0,4,0,9,-9,0,germany2
Regensburg,4,3,1,0,7,3,4,10,germany3
Ulm,4,3,0,1,6,6,0,9,germany3
Verl,4,2,1,1,10,5,5,7,germany3
Preuss. Munster,4,2,1,1,6,2,4,7,germany3
Dortmund B,4,2,1,1,8,7,1,7,germany3
Bielefeld,4,2,1,1,5,5,0,7,germany3
Dynamo Dresden,4,2,1,1,5,5,0,7,germany3
Sandhausen,4,2,1,1,5,5,0,7,germany3
Freiburg B,4,2,0,2,4,5,-1,6,germany3
RW Essen,4,2,0,2,5,7,-2,6,germany3
Saarbrucken,4,1,1,2,7,6,1,4,germany3
FC Ingolstadt,4,1,1,2,6,6,0,4,germany3
1860 Munchen,4,1,1,2,4,4,0,4,germany3
Mannheim,4,1,1,2,5,7,-2,4,germany3
Erzgebirge Aue,4,1,1,2,5,9,-4,4,germany3
Viktoria Koln,4,0,2,2,7,9,-2,2,germany3
VfB Lubeck,4,0,2,2,3,7,-4,2,germany3
Unterhaching,4,0,2,2,2,6,-4,2,germany3
Hallescher,4,0,1,3,6,10,-4,1,germany3
MSV Duisburg,4,0,1,3,2,6,-4,1,germany3
Lincoln RI,4,4,0,0,14,1,13,12,gibraltar
Manchester 62,4,4,0,0,14,3,11,12,gibraltar
Mons Calpe,4,4,0,0,14,5,9,12,gibraltar
Europa FC,4,3,0,1,5,4,1,9,gibraltar
Lynx,4,2,1,1,5,5,0,7,gibraltar
Lions FC,4,2,0,2,10,6,4,6,gibraltar
Magpies,4,1,2,1,6,3,3,5,gibraltar
St Josephs,4,1,1,2,2,5,-3,4,gibraltar
Europa Point,4,0,2,2,3,6,-3,2,gibraltar
College 1975,4,0,2,2,5,9,-4,2,gibraltar
Glacis Utd,4,0,0,4,5,15,-10,0,gibraltar
Panathinaikos,3,3,0,0,10,1,9,9,greece
AEK Athens,4,3,0,1,8,5,3,9,greece
Olympiakos,2,1,1,0,4,1,3,4,greece
PAOK,3,1,1,1,5,4,1,4,greece
Asteras T.,4,1,1,2,4,7,-3,4,greece
OFI Crete,4,0,3,1,3,6,-3,3,greece
PAS Giannina,4,0,2,2,5,7,-2,2,greece
Panserraikos,4,0,2,2,5,8,-3,2,greece
Lamia,4,0,2,2,3,9,-6,2,greece
Aris,4,0,1,3,3,8,-5,1,greece
Panaitolikos,4,0,1,3,1,8,-7,1,greece
Atromitos,4,0,1,3,2,10,-8,1,greece
Kifisia,4,0,1,3,2,10,-8,1,greece
Volos,4,0,1,3,1,9,-8,1,greece
Achuapa,4,2,1,1,7,7,0,7,guatemala
Municipal,4,1,2,1,7,6,1,5,guatemala
Comunicaciones,4,1,2,1,7,7,0,5,guatemala
Malacateco,4,1,1,2,4,4,0,4,guatemala
Guastatoya,4,1,0,3,2,4,-2,3,guatemala
Coban Imperial,4,0,2,2,3,7,-4,2,guatemala
Antigua GFC,4,0,1,3,6,10,-4,1,guatemala
Xelaju,4,0,1,3,1,5,-4,1,guatemala
Mixco,4,0,1,3,4,9,-5,1,guatemala
Xinabajul,4,0,1,3,3,10,-7,1,guatemala
Coatepecano IB,4,0,1,3,2,9,-7,1,guatemala
Zacapa Tellioz,4,0,0,4,3,9,-6,0,guatemala
Marathon,4,3,1,0,7,3,4,10,honduras
Olimpia,4,3,1,0,6,3,3,10,honduras
Olancho,4,2,1,1,3,1,2,7,honduras
Victoria,4,1,2,1,5,5,0,5,honduras
Motagua,4,1,1,2,8,8,0,4,honduras
Vida,4,1,1,2,3,6,-3,4,honduras
Génesis,4,1,1,2,2,5,-3,4,honduras
Real Espana,4,1,0,3,7,8,-1,3,honduras
Real Sociedad,4,0,3,1,0,3,-3,3,honduras
UPNFM,4,0,0,4,2,8,-6,0,honduras
North District,2,1,1,0,5,2,3,4,hongkong
LM Warriors,1,1,0,0,3,1,2,3,hongkong
Eastern,1,1,0,0,2,0,2,3,hongkong
Southern D.,3,1,0,2,6,5,1,3,hongkong
HK Rangers,4,1,0,3,7,7,0,3,hongkong
Wofoo Tai Po,2,1,0,1,1,3,-2,3,hongkong
Resources C.,3,1,0,2,2,7,-5,3,hongkong
Hong Kong FC,2,1,0,1,1,8,-7,3,hongkong
HK U23,4,0,1,3,0,12,-12,1,hongkong
Kitchee,1,0,0,1,1,4,-3,0,hongkong
Sham Shui Po,2,0,0,2,1,11,-10,0,hongkong
Ferencvaros,4,4,0,0,19,7,12,12,hungary
Puskas Akad.,4,2,1,1,10,6,4,7,hungary
Paks,4,2,1,1,9,9,0,7,hungary
Diosgyor VTK,4,2,0,2,8,7,1,6,hungary
MTK,4,2,0,2,6,6,0,6,hungary
Zalaegerszegi,4,1,1,2,6,7,-1,4,hungary
Ujpest,3,1,1,1,5,7,-2,4,hungary
Mezokovesd,4,1,0,3,4,6,-2,3,hungary
Debrecen,3,0,1,2,3,7,-4,1,hungary
MOL Fehervar,4,0,1,3,3,8,-5,1,hungary
Kisvarda,4,0,0,4,3,8,-5,0,hungary
Kecskemeti TE,4,0,0,4,4,11,-7,0,hungary
Gyori ETO,4,2,1,1,9,6,3,7,hungary2
Kozarmisleny,4,2,1,1,6,3,3,7,hungary2
Nyiregyhaza,4,2,1,1,7,5,2,7,hungary2
Vasas,4,2,1,1,7,5,2,7,hungary2
Csakvari,4,2,1,1,5,3,2,7,hungary2
Szeged,4,1,3,0,5,4,1,6,hungary2
Gyirmot,4,1,2,1,4,3,1,5,hungary2
Haladas,4,1,2,1,4,4,0,5,hungary2
BVSC,4,1,2,1,6,7,-1,5,hungary2
Pecsi MFC,4,1,2,1,2,3,-1,5,hungary2
Tiszakecske,4,1,1,2,5,6,-1,4,hungary2
Soroksar,4,1,1,2,2,3,-1,4,hungary2
Budafoki,4,1,1,2,4,8,-4,4,hungary2
Kazincbarcika,4,0,3,1,4,5,-1,3,hungary2
Ajka,4,1,0,3,3,4,-1,3,hungary2
Siofok,4,1,0,3,2,7,-5,3,hungary2
Honved,4,0,2,2,2,4,-2,2,hungary2
MTE,4,0,1,3,3,9,-6,1,hungary2
KA Akureyri,4,2,1,1,8,4,4,7,iceland
Fylkir,4,2,1,1,6,5,1,7,iceland
Vikingur R.,4,2,0,2,9,8,1,6,iceland
Stjarnan,4,2,0,2,6,5,1,6,iceland
Hafnarfjordur,4,2,0,2,6,6,0,6,iceland
IBV,4,1,2,1,6,6,0,5,iceland
Fram,4,0,3,1,4,8,-4,3,iceland
KR Reykjavik,4,0,2,2,5,9,-4,2,iceland
Valur,4,0,2,2,6,11,-5,2,iceland
Breidablik,4,0,1,3,9,14,-5,1,iceland
Keflavik,4,0,1,3,4,11,-7,1,iceland
HK Kopavogur,4,0,0,4,3,13,-10,0,iceland
IA Akranes,4,3,1,0,9,5,4,10,iceland2
Leiknir R.,4,3,0,1,11,3,8,9,iceland2
Vestri,4,3,0,1,9,4,5,9,iceland2
Njardvík,4,3,0,1,11,9,2,9,iceland2
Fjolnir,4,2,1,1,7,7,0,7,iceland2
Thor Akureyri,4,1,1,2,5,6,-1,4,iceland2
Afturelding,4,1,1,2,7,9,-2,4,iceland2
Grindavik,4,1,0,3,3,14,-11,3,iceland2
Throttur R.,4,0,2,2,6,8,-2,2,iceland2
Grotta,4,0,1,3,4,9,-5,1,iceland2
Selfoss,4,0,0,4,5,9,-4,0,iceland2
AEggir,4,0,0,4,3,19,-16,0,iceland2
IR Reykjavik,4,4,0,0,14,4,10,12,iceland3
Dalvik / Reynir,4,3,1,0,8,1,7,10,iceland3
Haukar,4,3,1,0,8,3,5,10,iceland3
Throttur Vogar,4,3,0,1,10,7,3,9,iceland3
Volsungur,4,2,0,2,8,8,0,6,iceland3
Hottur / Huginn,4,2,0,2,7,7,0,6,iceland3
Fjallabyggd,4,1,1,2,9,8,1,4,iceland3
Fjardabyggd,4,1,1,2,5,6,-1,4,iceland3
V. Olafsvik,4,1,1,2,6,8,-2,4,iceland3
KFG,4,0,1,3,6,11,-5,1,iceland3
KV Reykjavik,4,0,1,3,2,10,-8,1,iceland3
Sindri,4,0,0,4,3,15,-12,0,iceland3
Punjab,4,4,0,0,8,1,7,12,india2
Gokulam,4,3,0,1,7,3,4,9,india2
Real Kashmir,4,2,1,1,5,4,1,7,india2
Rajasthan,4,2,1,1,2,2,0,7,india2
TRAU,4,2,0,2,7,9,-2,6,india2
Sreenidi Deccan,4,1,1,2,7,9,-2,4,india2
Churchill B.,4,1,1,2,5,7,-2,4,india2
Neroca,4,0,3,1,7,8,-1,3,india2
Sudeva,4,1,0,3,6,17,-11,3,india2
Kenkre,4,0,1,3,3,6,-3,1,india2
Mohammedan,4,0,1,3,2,6,-4,1,india2
Aizawl,4,0,1,3,4,10,-6,1,india2
Madura Utd,4,3,1,0,9,2,7,10,indonesia
Borneo,4,3,0,1,6,3,3,9,indonesia
Persib,4,2,2,0,7,5,2,8,indonesia
R. Nusantara,4,2,1,1,6,5,1,7,indonesia
Dewa United,4,1,2,1,5,3,2,5,indonesia
Persik Kediri,4,1,2,1,7,7,0,5,indonesia
Bali Utd,4,1,1,2,5,7,-2,4,indonesia
Persis Solo,4,1,1,2,5,7,-2,4,indonesia
PSIS Semarang,4,1,1,2,5,7,-2,4,indonesia
Arema,4,1,1,2,5,8,-3,4,indonesia
Persija,4,1,1,2,4,7,-3,4,indonesia
PSS Sleman,4,1,0,3,5,8,-3,3,indonesia
Barito Putera,4,0,2,2,2,5,-3,2,indonesia
Bhayangkara S.,4,0,2,2,3,7,-4,2,indonesia
PSM,4,0,1,3,2,5,-3,1,indonesia
TIRA Persikabo,4,0,1,3,1,6,-5,1,indonesia
Persita,4,0,1,3,1,8,-7,1,indonesia
Persebaya S.,4,0,1,3,2,11,-9,1,indonesia
Zob Ahan,4,3,1,0,7,4,3,10,iran
Persepolis,3,3,0,0,6,1,5,9,iran
Tractor Sazi,4,3,0,1,6,1,5,9,iran
Shams A. Qazvin,4,3,0,1,7,4,3,9,iran
Sepahan,2,2,0,0,5,1,4,6,iran
Esteghlal,3,2,0,1,4,1,3,6,iran
Aluminium Arak,4,2,0,2,3,4,-1,6,iran
Paykan,4,1,2,1,3,4,-1,5,iran
Havadar,3,1,1,1,4,4,0,4,iran
Mes Rafsanjan,3,1,1,1,2,2,0,4,iran
Gol Gohar,3,1,1,1,1,1,0,4,iran
Sanat Naft,3,1,0,2,4,8,-4,3,iran
Foolad,3,1,0,2,1,7,-6,3,iran
Malavan,3,0,2,1,2,3,-1,2,iran
N. Mazandaran,2,0,1,1,1,2,-1,1,iran
E. Khuzestan,3,0,0,3,0,3,-3,0,iran
Newroz SC,1,1,0,0,2,0,2,3,iraq
Al-Qasim,1,1,0,0,1,0,1,3,iraq
Naft Al-Wasat,1,0,1,0,2,2,0,1,iraq
Naft Maysan,1,0,1,0,0,0,0,1,iraq
Al Hudod,0,0,0,0,0,0,0,0,iraq
Al Kahrabaa,0,0,0,0,0,0,0,0,iraq
Al Karkh,0,0,0,0,0,0,0,0,iraq
Al Minaa Basra,0,0,0,0,0,0,0,0,iraq
Al Naft,0,0,0,0,0,0,0,0,iraq
Al Najaf,0,0,0,0,0,0,0,0,iraq
Al Quwa Al J.,0,0,0,0,0,0,0,0,iraq
Al Shorta,0,0,0,0,0,0,0,0,iraq
Al Talaba,0,0,0,0,0,0,0,0,iraq
Al Zawraa,0,0,0,0,0,0,0,0,iraq
Baghdad,0,0,0,0,0,0,0,0,iraq
Duhok,0,0,0,0,0,0,0,0,iraq
Erbil,0,0,0,0,0,0,0,0,iraq
Karbala,0,0,0,0,0,0,0,0,iraq
Zakho,0,0,0,0,0,0,0,0,iraq
Naft Al-Janoob,1,0,0,1,1,2,-1,0,iraq
St. Patricks,4,3,0,1,5,2,3,9,ireland
Derry City,4,2,1,1,8,2,6,7,ireland
Shelbourne,4,1,2,1,2,2,0,5,ireland
Bohemians,4,1,2,1,2,4,-2,5,ireland
Shamrock Rovers,4,0,4,0,2,2,0,4,ireland
Dundalk,4,1,0,3,3,5,-2,3,ireland
Cork City,4,1,0,3,4,10,-6,3,ireland
Drogheda Utd,4,1,0,3,3,12,-9,3,ireland
UC Dublin,4,0,1,3,1,12,-11,1,ireland
Sligo Rovers,4,0,0,4,1,8,-7,0,ireland
Galway Utd,4,3,0,1,12,3,9,9,ireland2
Waterford,4,2,1,1,9,4,5,7,ireland2
Bray Wanderers,4,2,1,1,7,5,2,7,ireland2
Wexford,4,2,1,1,4,4,0,7,ireland2
Cobh Ramblers,4,1,1,2,7,9,-2,4,ireland2
Treaty Utd,4,1,1,2,5,7,-2,4,ireland2
Longford Town,4,0,2,2,0,4,-4,2,ireland2
Kerry,4,0,1,3,4,8,-4,1,ireland2
Finn Harps,4,0,1,3,2,9,-7,1,ireland2
Athlone Town,4,0,0,4,2,15,-13,0,ireland2
M. Tel Aviv,2,2,0,0,8,0,8,6,israel
Hapoel Haifa,2,2,0,0,4,2,2,6,israel
Maccabi Haifa,3,2,0,1,7,6,1,6,israel
Hapoel Tel Aviv,3,1,2,0,4,1,3,5,israel
M. Bnei Raina,3,1,2,0,4,3,1,5,israel
B. Jerusalem,2,1,0,1,3,3,0,3,israel
Hapoel Hadera,3,1,0,2,1,5,-4,3,israel
M. Petah Tikva,2,0,2,0,3,3,0,2,israel
Bnei Sakhnin,3,0,2,1,3,7,-4,2,israel
H. Beer Sheva,2,0,1,1,1,2,-1,1,israel
Maccabi Netanya,2,0,1,1,1,3,-2,1,israel
H. Jerusalem,3,0,1,2,2,6,-4,1,israel
Ashdod,2,0,0,2,1,6,-5,0,israel
H. Petah Tikva,2,0,0,2,1,6,-5,0,israel
Ramat Hasharon,3,2,1,0,8,3,5,7,israel2
H. Umm al-Fahm,3,1,2,0,4,2,2,5,israel2
H. Ramat Gan,3,1,2,0,5,4,1,5,israel2
H. Ironi Rishon,4,1,2,1,3,3,0,5,israel2
Bnei Yehuda,3,1,1,1,5,5,0,4,israel2
H. Kfar Saba,3,1,1,1,2,2,0,4,israel2
Kafr Qasim,3,1,1,1,2,2,0,4,israel2
H. Nof Hagalil,4,1,1,2,4,6,-2,4,israel2
Hapoel Afula,4,1,1,2,4,10,-6,4,israel2
Kiryat Shmona,3,1,0,2,4,4,0,3,israel2
Maccabi Jaffa,3,1,0,2,6,8,-2,3,israel2
Ihud B. Shfaram,3,1,0,2,5,8,-3,3,israel2
M. Herziliya,3,1,0,2,3,7,-4,3,israel2
Hapoel Akko,4,0,2,2,0,2,-2,2,israel2
Ironi Tiberias,3,0,2,1,3,6,-3,2,israel2
Nes Tziona,4,0,1,3,4,12,-8,1,israel2
Inter Milan,4,4,0,0,10,0,10,12,italy
AC Milan,4,3,0,1,7,7,0,9,italy
Napoli,4,2,2,0,9,3,6,8,italy
Juventus,4,2,1,1,5,4,1,7,italy
Fiorentina,4,2,1,1,6,6,0,7,italy
Lazio,4,2,0,2,5,6,-1,6,italy
Bologna,4,0,4,0,3,3,0,4,italy
AS Roma,4,1,1,2,7,8,-1,4,italy
Sassuolo,4,1,1,2,5,8,-3,4,italy
Monza,4,1,1,2,2,5,-3,4,italy
Lecce,4,0,3,1,4,5,-1,3,italy
Atalanta,4,1,0,3,6,8,-2,3,italy
Udinese,4,0,3,1,2,5,-3,3,italy
Torino,4,1,0,3,4,8,-4,3,italy
Empoli,4,1,0,3,2,12,-10,3,italy
Frosinone,4,0,2,2,2,5,-3,2,italy
Genoa,4,0,1,3,2,6,-4,1,italy
Hellas Verona,4,0,1,3,2,6,-4,1,italy
Cagliari,4,0,1,3,3,9,-6,1,italy
Salernitana,4,0,1,3,2,8,-6,1,italy
Palermo,4,4,0,0,9,2,7,12,italy2
Cremonese,4,3,1,0,8,4,4,10,italy2
Catanzaro,4,3,1,0,9,6,3,10,italy2
Parma,4,3,0,1,11,5,6,9,italy2
Como,4,2,1,1,6,3,3,7,italy2
Brescia,3,2,1,0,3,0,3,7,italy2
Modena,4,1,3,0,3,2,1,6,italy2
Cosenza,4,2,0,2,3,4,-1,6,italy2
Venezia,4,1,2,1,3,2,1,5,italy2
Ascoli,4,1,2,1,6,6,0,5,italy2
Cittadella,4,1,2,1,5,5,0,5,italy2
Sudtirol,4,1,2,1,5,5,0,5,italy2
Pisa,4,1,2,1,1,2,-1,5,italy2
Reggiana,4,1,2,1,4,6,-2,5,italy2
Spezia,4,1,1,2,4,7,-3,4,italy2
Lecco,4,1,1,2,3,6,-3,4,italy2
FeralpiSalo,4,1,1,2,3,8,-5,4,italy2
Bari,4,0,3,1,3,4,-1,3,italy2
Sampdoria,4,0,3,1,3,4,-1,3,italy2
Ternana,4,0,1,3,4,8,-4,1,italy2
Waterhouse,4,3,1,0,8,5,3,10,jamaica
Portmore Utd,4,3,0,1,7,3,4,9,jamaica
Harbour View,4,3,0,1,5,4,1,9,jamaica
Dunbeholden,4,2,1,1,10,4,6,7,jamaica
Molynes Utd,4,2,1,1,9,6,3,7,jamaica
Cavalier,4,2,1,1,5,6,-1,7,jamaica
Arnett Gardens,4,1,3,0,4,2,2,6,jamaica
Mount Pleasant,4,1,2,1,7,4,3,5,jamaica
Humble Lions,4,1,2,1,3,3,0,5,jamaica
Vere Utd,4,1,1,2,5,5,0,4,jamaica
Faulkland,4,0,2,2,4,9,-5,2,jamaica
Montego Bay,4,0,2,2,3,10,-7,2,jamaica
Tivoli Gardens,4,0,1,3,7,12,-5,1,jamaica
Chapelton,4,0,1,3,4,18,-14,1,jamaica
Shonan Bellmare,4,3,0,1,5,2,3,9,japan
Urawa RD,4,2,1,1,6,4,2,7,japan
Vissel Kobe,4,2,1,1,5,4,1,7,japan
Albirex Niigata,4,2,1,1,5,5,0,7,japan
Kashiwa Reysol,4,2,1,1,5,5,0,7,japan
Avispa Fukuoka,4,2,0,2,7,8,-1,6,japan
S. Hiroshima,4,1,1,2,2,2,0,4,japan
Cerezo Osaka,4,1,1,2,1,2,-1,4,japan
K. Frontale,4,1,1,2,6,8,-2,4,japan
Yokohama M.,4,1,1,2,3,7,-4,4,japan
Sagan Tosu,4,0,3,1,5,6,-1,3,japan
FC Tokyo,4,1,0,3,2,4,-2,3,japan
Nagoya G.,4,1,0,3,3,7,-4,3,japan
Kashima Antlers,4,0,2,2,3,6,-3,2,japan
Yokohama FC,4,0,2,2,3,7,-4,2,japan
C. Sapporo,4,0,2,2,4,10,-6,2,japan
Kyoto Sanga,4,0,1,3,3,7,-4,1,japan
Gamba Osaka,4,0,1,3,2,10,-8,1,japan
Machida Zelvia,4,3,1,0,11,1,10,10,japan2
JEF Utd Chiba,4,3,0,1,11,5,6,9,japan2
Omiya Ardija,4,3,0,1,7,5,2,9,japan2
Tokushima V.,4,2,2,0,5,3,2,8,japan2
Shimizu S-Pulse,4,2,1,1,11,4,7,7,japan2
Blaublitz Akita,4,2,1,1,6,4,2,7,japan2
Mito Hollyhock,4,2,1,1,5,4,1,7,japan2
Tokyo Verdy,4,1,3,0,4,1,3,6,japan2
R. Kumamoto,4,2,0,2,4,2,2,6,japan2
Iwaki,4,2,0,2,7,7,0,6,japan2
Tochigi SC,4,2,0,2,3,6,-3,6,japan2
V-V. Nagasaki,4,1,2,1,5,2,3,5,japan2
Fagiano Okayama,4,1,2,1,4,5,-1,5,japan2
Jubilo Iwata,4,1,1,2,5,4,1,4,japan2
Oita Trinita,4,1,1,2,4,5,-1,4,japan2
Vegalta Sendai,4,1,1,2,4,6,-2,4,japan2
Fujieda MYFC,4,1,1,2,5,9,-4,4,japan2
M. Yamagata,4,1,1,2,2,9,-7,4,japan2
Ventforet Kofu,4,0,3,1,5,6,-1,3,japan2
Kusatsu,4,1,0,3,4,9,-5,3,japan2
Z. Kanazawa,4,0,1,3,3,8,-5,1,japan2
R. Yamaguchi,4,0,1,3,1,6,-5,1,japan2
Al Hussein,3,3,0,0,8,0,8,9,jordan
Al Ramtha,4,2,0,2,7,3,4,6,jordan
Moghayer Al S.,2,1,1,0,5,3,2,4,jordan
Al Salt,4,1,1,2,5,5,0,4,jordan
Al Wihdat,1,1,0,0,1,0,1,3,jordan
Sahab,3,0,3,0,6,6,0,3,jordan
Al Faysali,2,1,0,1,3,3,0,3,jordan
Aqaba,1,0,1,0,0,0,0,1,jordan
Al Jalil,2,0,1,1,2,3,-1,1,jordan
Maan,3,0,1,2,2,8,-6,1,jordan
Al Ahli,3,0,0,3,1,4,-3,0,jordan
Shabab Al Ordon,3,0,0,3,0,9,-9,0,jordan
Ordabasy,4,2,1,1,6,5,1,7,kazakhstan
Maqtaaral,4,2,0,2,3,3,0,6,kazakhstan
Okzhetpes,4,2,0,2,5,8,-3,6,kazakhstan
Kaisar K.,4,1,2,1,5,5,0,5,kazakhstan
Kyzylzhar,4,1,2,1,4,4,0,5,kazakhstan
Aktobe,4,0,4,0,2,2,0,4,kazakhstan
Zhetysu,4,1,1,2,5,6,-1,4,kazakhstan
Kairat Almaty,4,1,1,2,5,7,-2,4,kazakhstan
FC Astana,4,1,0,3,2,5,-3,3,kazakhstan
Tobol,4,0,2,2,4,6,-2,2,kazakhstan
Kaspiy Aktau,4,0,2,2,5,8,-3,2,kazakhstan
Atyrau,4,0,2,2,3,7,-4,2,kazakhstan
S. Karagandy,4,0,2,2,3,7,-4,2,kazakhstan
Aksu,4,0,0,4,2,10,-8,0,kazakhstan
Drita,4,3,1,0,7,2,5,10,kosovo
Llapi,4,3,0,1,9,5,4,9,kosovo
Ballkani,4,2,2,0,5,2,3,8,kosovo
Dukagjini,4,1,3,0,9,8,1,6,kosovo
Feronikeli,4,1,1,2,7,10,-3,4,kosovo
Malisheva,4,1,0,3,4,7,-3,3,kosovo
Prishtina,4,0,3,1,2,5,-3,3,kosovo
Liria,4,0,1,3,2,8,-6,1,kosovo
Gjilani,4,0,0,4,2,8,-6,0,kosovo
Fushe Kosova,4,0,0,4,1,7,-6,0,kosovo
Al Qadsia,3,3,0,0,6,1,5,9,kuwait
Al Kuwait,2,2,0,0,9,3,6,6,kuwait
Kazma,2,1,1,0,5,4,1,4,kuwait
Al Shabab,3,1,1,1,3,6,-3,4,kuwait
Al Nasar,2,1,0,1,4,3,1,3,kuwait
Al Arabi SC,2,0,2,0,2,2,0,2,kuwait
Khaitan,3,0,2,1,2,6,-4,2,kuwait
Al Fahaheel,3,0,1,2,1,5,-4,1,kuwait
Al Salmiyah,2,0,0,2,2,5,-3,0,kuwait
Al Jahra,3,0,0,3,3,7,-4,0,kuwait
Riga FC,4,3,1,0,8,1,7,10,latvia
RFS,4,3,0,1,7,5,2,9,latvia
FS Jelgava,4,2,2,0,8,5,3,8,latvia
Valmiera,4,2,1,1,8,4,4,7,latvia
Auda,4,2,1,1,5,5,0,7,latvia
Super Nova,4,1,1,2,2,3,-1,4,latvia
Liepaja,4,1,1,2,5,7,-2,4,latvia
Daugavpils,4,1,1,2,2,5,-3,4,latvia
Tukums,4,0,1,3,1,14,-13,1,latvia
Metta / LU,4,0,0,4,3,13,-10,0,latvia
Kauno Zalgiris,4,3,1,0,11,3,8,10,lithuania
Zalgiris,4,3,0,1,10,4,6,9,lithuania
Panevezys,4,2,2,0,4,1,3,8,lithuania
Hegelmann L.,4,2,1,1,7,9,-2,7,lithuania
Riteriai,4,2,0,2,5,5,0,6,lithuania
Suduva,4,2,0,2,5,6,-1,6,lithuania
FA Siauliai,4,1,1,2,4,7,-3,4,lithuania
Dziugas Telsiai,4,0,3,1,1,2,-1,3,lithuania
Banga,4,1,0,3,2,5,-3,3,lithuania
Dainava,4,0,2,2,1,4,-3,2,lithuania
Neptuna K.,4,3,1,0,10,3,7,10,lithuania2
Be1 NFA,4,3,1,0,6,1,5,10,lithuania2
BFA Vilnius,4,2,2,0,8,3,5,8,lithuania2
Riteriai B,4,2,2,0,8,6,2,8,lithuania2
TransINVEST,4,1,2,1,5,5,0,5,lithuania2
Nevezis,4,1,2,1,6,7,-1,5,lithuania2
Kauno Z. B,4,1,2,1,3,5,-2,5,lithuania2
Zalgiris B,4,1,1,2,5,10,-5,4,lithuania2
Garliava,4,0,3,1,6,7,-1,3,lithuania2
Jonava,4,1,0,3,8,10,-2,3,lithuania2
Ekranas,4,1,0,3,4,7,-3,3,lithuania2
Minija,4,1,0,3,4,9,-5,3,lithuania2
Marijampole C.,4,1,0,3,3,12,-9,3,lithuania2
Panevezys B,4,0,1,3,4,13,-9,1,lithuania2
Babrungas,4,0,1,3,2,12,-10,1,lithuania2
FA Siauliai B,4,0,0,4,1,18,-17,0,lithuania2
Hesperang,4,3,0,1,10,3,7,9,luxembourg
Differdange,4,1,3,0,6,5,1,6,luxembourg
Marisca Mersch,4,2,0,2,6,6,0,6,luxembourg
Jeunesse Esch,4,1,2,1,6,5,1,5,luxembourg
V. Rosport,4,1,2,1,7,7,0,5,luxembourg
Wiltz,4,1,2,1,4,5,-1,5,luxembourg
UNA Strassen,4,1,1,2,6,6,0,4,luxembourg
Dudelange,4,1,1,2,3,7,-4,4,luxembourg
Mondercange,4,1,1,2,3,8,-5,4,luxembourg
Niedercorn,4,0,3,1,7,9,-2,3,luxembourg
Mondorf,4,0,3,1,5,7,-2,3,luxembourg
Petange,4,1,0,3,2,7,-5,3,luxembourg
Racing,4,0,1,3,3,7,-4,1,luxembourg
UN Käerjéng,4,0,1,3,5,11,-6,1,luxembourg
Fola Esch,4,0,0,4,5,12,-7,0,luxembourg
Schifflange,4,0,0,4,1,9,-8,0,luxembourg
Kedah,4,4,0,0,6,1,5,12,malaysia
Terengganu,4,3,1,0,14,1,13,10,malaysia
Johor Darul,4,3,1,0,16,5,11,10,malaysia
Selangor,4,3,0,1,19,4,15,9,malaysia
PDRM,4,2,1,1,8,8,0,7,malaysia
Pahang,4,2,0,2,10,7,3,6,malaysia
Sabah,4,2,0,2,5,3,2,6,malaysia
Perak,4,2,0,2,3,7,-4,6,malaysia
Kuala Lumpur,4,1,0,3,6,7,-1,3,malaysia
Negeri Sembilan,4,0,2,2,3,7,-4,2,malaysia
Kelantan United,4,0,2,2,5,13,-8,2,malaysia
Kuching,4,0,1,3,7,10,-3,1,malaysia
Kelantan,4,0,1,3,7,15,-8,1,malaysia
Pulau Pinang,4,0,0,4,1,10,-9,0,malaysia
Johor Darul B,4,3,1,0,6,0,6,10,malaysia2
Kelantan,4,3,1,0,6,2,4,10,malaysia2
Terengganu B,4,2,1,1,7,7,0,7,malaysia2
Perak,4,2,0,2,4,4,0,6,malaysia2
Kelantan United,4,1,2,1,5,5,0,5,malaysia2
Kuching,4,1,1,2,4,4,0,4,malaysia2
PDRM,4,1,1,2,4,4,0,4,malaysia2
UiTM,4,1,1,2,3,5,-2,4,malaysia2
Skuad Projek,4,1,0,3,4,8,-4,3,malaysia2
Selangor B,4,1,0,3,2,7,-5,3,malaysia2
Mosta,4,3,1,0,9,2,7,10,malta
Hamrun Spartans,4,3,1,0,8,2,6,10,malta
Balzan,4,3,1,0,8,4,4,10,malta
Valletta,4,3,0,1,9,4,5,9,malta
Hibernians,4,3,0,1,13,9,4,9,malta
Gzira Utd,4,2,1,1,9,2,7,7,malta
Sirens,4,2,1,1,3,2,1,7,malta
Floriana,4,2,0,2,8,6,2,6,malta
Marsaxlokk,4,1,2,1,7,6,1,5,malta
Birkirkara,4,1,2,1,5,4,1,5,malta
Pieta Hotspurs,4,1,1,2,5,6,-1,4,malta
Santa Lucia,4,1,0,3,5,7,-2,3,malta
Zebbug Rangers,4,1,0,3,2,9,-7,3,malta
Gudja Utd,4,0,2,2,3,7,-4,2,malta
CF America,4,3,1,0,8,5,3,10,mexico
Cruz Azul,4,2,1,1,8,6,2,7,mexico
Puebla,4,2,1,1,6,5,1,7,mexico
Monterrey,4,2,1,1,4,5,-1,7,mexico
Pumas UNAM,4,2,0,2,7,4,3,6,mexico
Mazatlan,4,2,0,2,9,8,1,6,mexico
Club Leon,4,1,2,1,5,5,0,5,mexico
Necaxa,4,1,2,1,7,8,-1,5,mexico
Tigres,4,1,1,2,5,7,-2,4,mexico
Guadalajara,4,1,1,2,4,7,-3,4,mexico
Atlas,4,1,1,2,4,8,-4,4,mexico
Pachuca,4,1,1,2,1,9,-8,4,mexico
A. San Luis,4,1,0,3,7,8,-1,3,mexico
Queretaro,4,1,0,3,4,13,-9,3,mexico
Toluca,4,0,2,2,3,5,-2,2,mexico
Santos Laguna,4,0,1,3,9,12,-3,1,mexico
Juarez,4,0,1,3,3,10,-7,1,mexico
Tijuana,4,0,0,4,2,7,-5,0,mexico
CF America,4,4,0,0,10,3,7,12,mexico2
Pachuca,4,3,0,1,8,5,3,9,mexico2
Monterrey,4,3,0,1,6,3,3,9,mexico2
Atlas,4,2,2,0,8,2,6,8,mexico2
Club Leon,4,2,2,0,5,3,2,8,mexico2
Puebla,4,2,1,1,7,4,3,7,mexico2
Guadalajara,4,2,1,1,7,5,2,7,mexico2
Queretaro,4,2,1,1,5,4,1,7,mexico2
Cruz Azul,4,1,2,1,5,4,1,5,mexico2
Toluca,4,1,1,2,6,8,-2,4,mexico2
Santos Laguna,4,1,1,2,5,8,-3,4,mexico2
Tigres,4,1,1,2,3,6,-3,4,mexico2
Necaxa,4,1,1,2,2,5,-3,4,mexico2
Mazatlan,4,1,0,3,5,11,-6,3,mexico2
Tijuana,4,1,0,3,6,13,-7,3,mexico2
Juarez,4,0,2,2,3,8,-5,2,mexico2
Pumas UNAM,4,0,1,3,2,7,-5,1,mexico2
A. San Luis,4,0,0,4,2,8,-6,0,mexico2
SP Falcons,4,4,0,0,9,0,9,12,mongolia
Khoromkhon,4,4,0,0,9,5,4,12,mongolia
FC Ulaanbaatar,4,3,0,1,9,2,7,9,mongolia
Deren,4,2,2,0,8,1,7,8,mongolia
Erchim,4,2,2,0,15,9,6,8,mongolia
Bavarians,4,2,0,2,7,11,-4,6,mongolia
Tuv Buganuud,3,1,1,1,9,10,-1,4,mongolia
Khangarid,4,0,2,2,5,7,-2,2,mongolia
Khovd,4,0,1,3,3,11,-8,1,mongolia
Bayanzurkh S.,4,0,0,4,2,13,-11,0,mongolia
Jezero,4,3,1,0,7,4,3,10,montenegro
Decic,4,3,1,0,5,2,3,10,montenegro
Mornar,4,2,2,0,4,2,2,8,montenegro
Buducnost,4,2,1,1,7,4,3,7,montenegro
Sutjeska,4,1,3,0,6,2,4,6,montenegro
Petrovac,4,1,1,2,3,3,0,4,montenegro
Arsenal Tivat,4,1,1,2,3,5,-2,4,montenegro
Rudar,4,1,0,3,1,5,-4,3,montenegro
Jedinstvo,4,0,2,2,6,9,-3,2,montenegro
Mladost DG,4,0,1,3,5,10,-5,1,montenegro
Wydad,3,2,1,0,6,2,4,7,morocco
FUS Rabat,4,2,1,1,6,3,3,7,morocco
Moghreb Tetouan,4,2,0,2,4,3,1,6,morocco
Raja Casablanca,3,1,2,0,5,3,2,5,morocco
Maghreb de Fes,3,1,2,0,4,2,2,5,morocco
FAR Rabat,3,1,1,1,6,4,2,4,morocco
Berkane,2,1,1,0,3,1,2,4,morocco
Olympic Safi,3,1,1,1,3,3,0,4,morocco
C. Mohammedia,3,1,1,1,1,2,-1,4,morocco
Union Touarga,2,1,0,1,3,2,1,3,morocco
Salmi,3,1,0,2,2,4,-2,3,morocco
Mouloudia Oujda,3,0,2,1,1,3,-2,2,morocco
Ittihad Tanger,2,0,1,1,3,4,-1,1,morocco
Hassania Agadir,4,0,1,3,2,7,-5,1,morocco
Youssoufia B.,3,0,0,3,2,6,-4,0,morocco
R. Zemamra,3,0,0,3,3,8,-5,0,morocco
Chabab Atlas K.,4,2,2,0,4,1,3,8,morocco2
Difaa El Jadida,4,2,2,0,3,1,2,8,morocco2
C. Benguerir,4,2,1,1,3,2,1,7,morocco2
Kawkab M.,3,2,0,1,3,1,2,6,morocco2
El Massira,3,1,2,0,5,3,2,5,morocco2
Meknes,4,1,2,1,5,5,0,5,morocco2
Ittifaq M.,4,1,1,2,1,4,-3,4,morocco2
RAC Casablanca,3,1,0,2,1,2,-1,3,morocco2
Dcheira,3,0,2,1,4,5,-1,2,morocco2
Khouribga,4,0,2,2,2,4,-2,2,morocco2
Stade Marocain,3,0,2,1,2,4,-2,2,morocco2
Wydad Fès,3,0,2,1,2,4,-2,2,morocco2
USM Oujda,4,0,2,2,3,7,-4,2,morocco2
R. Beni Mellal,2,0,1,1,2,3,-1,1,morocco2
Rapide Oued Z.,3,0,1,2,0,2,-2,1,morocco2
AS Salé,3,0,0,3,3,7,-4,0,morocco2
Shan Utd,4,3,1,0,10,2,8,10,myanmar
Yangon Utd,4,3,0,1,12,5,7,9,myanmar
Sagaing Utd,4,2,2,0,10,6,4,8,myanmar
Ispe FC,4,2,1,1,7,5,2,7,myanmar
Ayeyawady,4,2,0,2,5,8,-3,6,myanmar
Rakhine Utd,4,1,2,1,8,7,1,5,myanmar
Dagon,4,1,2,1,3,3,0,5,myanmar
Yadanarbon,4,1,1,2,8,8,0,4,myanmar
Myawady,4,1,1,2,4,8,-4,4,myanmar
Hantharwady,4,1,0,3,6,8,-2,3,myanmar
Chinland,4,0,1,3,3,16,-13,1,myanmar
Kachin Utd,4,0,0,4,2,8,-6,0,myanmar
PSV Eindhoven,4,4,0,0,15,1,14,12,netherlands
AZ Alkmaar,4,4,0,0,10,2,8,12,netherlands
Feyenoord,4,3,1,0,13,3,10,10,netherlands
FC Twente,4,2,1,1,7,3,4,7,netherlands
Excelsior,4,2,1,1,8,6,2,7,netherlands
PEC Zwolle,4,2,0,2,8,8,0,6,netherlands
Almere City,4,1,2,1,4,7,-3,5,netherlands
Sparta,4,1,1,2,4,5,-1,4,netherlands
FC Utrecht,4,1,0,3,3,6,-3,3,netherlands
RKC Waalwijk,4,1,0,3,3,7,-4,3,netherlands
Vitesse Arnhem,4,1,0,3,3,7,-4,3,netherlands
Ajax Amsterdam,4,0,2,2,6,9,-3,2,netherlands
NEC Nijmegen,4,0,2,2,3,8,-5,2,netherlands
Heracles Almelo,4,0,2,2,4,11,-7,2,netherlands
Fortuna Sittard,4,0,1,3,3,12,-9,1,netherlands
Go Ahead Eagles,4,0,1,3,3,12,-9,1,netherlands
FC Volendam,4,0,0,4,4,12,-8,0,netherlands
Heerenveen,4,0,0,4,3,13,-10,0,netherlands
FC Eindhoven,4,3,1,0,7,4,3,10,netherlands2
ADO Den Haag,4,2,2,0,7,3,4,8,netherlands2
FC Dordrecht,4,2,2,0,7,4,3,8,netherlands2
FC Emmen,4,2,2,0,7,4,3,8,netherlands2
NAC Breda,4,2,1,1,9,7,2,7,netherlands2
Willem II,4,2,1,1,3,1,2,7,netherlands2
VVV,4,2,1,1,4,5,-1,7,netherlands2
Helmond Sport,4,2,0,2,8,5,3,6,netherlands2
FC Groningen,4,2,0,2,7,6,1,6,netherlands2
De Graafschap,4,2,0,2,7,9,-2,6,netherlands2
Jong PSV,4,2,0,2,7,12,-5,6,netherlands2
Roda JC,4,1,2,1,4,3,1,5,netherlands2
MVV Maastricht,4,1,0,3,7,9,-2,3,netherlands2
FC Den Bosch,4,1,0,3,6,10,-4,3,netherlands2
Cambuur,4,0,1,3,6,11,-5,1,netherlands2
TOP Oss,4,0,1,3,3,8,-5,1,netherlands2
Jong AZ,4,0,1,3,3,9,-6,1,netherlands2
Telstar,4,0,1,3,2,9,-7,1,netherlands2
Jong Utrecht,4,0,1,3,3,11,-8,1,netherlands2
Jong Ajax,4,0,0,4,5,14,-9,0,netherlands2
Real Esteli,4,3,0,1,11,3,8,9,nicaragua
Diriangen,4,3,0,1,9,4,5,9,nicaragua
Export Sebaco,4,2,1,1,6,8,-2,7,nicaragua
Jalapa,4,2,0,2,6,8,-2,6,nicaragua
UNAN Managua,4,1,2,1,5,6,-1,5,nicaragua
D. Ocotal,4,1,0,3,5,8,-3,3,nicaragua
Managua FC,4,0,2,2,4,6,-2,2,nicaragua
Matagalpa,4,0,1,3,4,8,-4,1,nicaragua
O. Masachapa,4,0,1,3,1,8,-7,1,nicaragua
Walter Ferreti,4,0,0,4,2,10,-8,0,nicaragua
Remo Stars,4,2,2,0,6,4,2,8,nigeria
Enyimba,4,2,1,1,3,2,1,7,nigeria
Shooting Stars,4,1,2,1,2,2,0,5,nigeria
Bendel,4,0,4,0,3,3,0,4,nigeria
Bayelsa Utd,4,1,1,2,5,6,-1,4,nigeria
Akwa Utd,4,1,1,2,2,3,-1,4,nigeria
Rivers Utd,4,0,3,1,4,5,-1,3,nigeria
Sunshine Stars,4,1,0,3,4,5,-1,3,nigeria
Enugu Rangers,4,0,3,1,3,4,-1,3,nigeria
El Kanemi,4,1,0,3,3,6,-3,3,nigeria
Wikki Tourist,4,1,0,3,2,7,-5,3,nigeria
Plateau Utd,4,0,2,2,6,8,-2,2,nigeria
Nasarawa Utd,4,0,2,2,3,5,-2,2,nigeria
Lobi Stars,4,0,2,2,2,6,-4,2,nigeria
Gombe Utd,4,0,2,2,1,9,-8,2,nigeria
Niger Tornadoes,4,0,1,3,3,7,-4,1,nigeria
Doma Utd,4,0,1,3,1,6,-5,1,nigeria
Kwara Utd,4,0,1,3,2,9,-7,1,nigeria
Dakkada,4,0,0,4,1,10,-9,0,nigeria
Abia Warriors,4,0,0,4,1,14,-13,0,nigeria
Cliftonville,4,3,0,1,6,1,5,9,northernireland
Linfield,4,3,0,1,5,3,2,9,northernireland
Crusaders,4,2,1,1,9,4,5,7,northernireland
Glentoran,4,2,0,2,7,6,1,6,northernireland
Ballymena Utd,4,2,0,2,2,2,0,6,northernireland
Coleraine,4,2,0,2,5,9,-4,6,northernireland
Larne,4,1,2,1,5,2,3,5,northernireland
Loughgall,4,1,2,1,5,9,-4,5,northernireland
Carrick Rangers,4,1,0,3,6,11,-5,3,northernireland
Newry City,4,1,0,3,5,12,-7,3,northernireland
Dungannon,4,0,2,2,3,9,-6,2,northernireland
Glenavon,4,0,0,4,3,12,-9,0,northernireland
Portadown,4,3,0,1,6,2,4,9,northernireland2
Dundela,4,3,0,1,9,6,3,9,northernireland2
Ards,4,2,2,0,5,3,2,8,northernireland2
Institute,4,2,1,1,5,4,1,7,northernireland2
Ballyclare,4,1,1,2,8,9,-1,4,northernireland2
Bangor,4,1,1,2,6,7,-1,4,northernireland2
Ballinamallard,4,1,1,2,4,5,-1,4,northernireland2
Annagh Utd,4,1,1,2,5,9,-4,4,northernireland2
Newington Youth,4,1,0,3,5,7,-2,3,northernireland2
Dergview,4,0,1,3,6,11,-5,1,northernireland2
H&W Welders,4,0,0,4,5,11,-6,0,northernireland2
Knockbreda,4,0,0,4,2,12,-10,0,northernireland2
Skendija,4,2,1,1,7,5,2,7,northmacedonia
Shkupi,4,1,3,0,4,3,1,6,northmacedonia
Struga,4,2,0,2,4,3,1,6,northmacedonia
Gostivar,4,2,0,2,4,6,-2,6,northmacedonia
Sileks,4,1,2,1,5,6,-1,5,northmacedonia
Vardar,4,1,1,2,3,4,-1,4,northmacedonia
Voska Sport,4,0,2,2,4,8,-4,2,northmacedonia
Makedonija,4,0,1,3,4,7,-3,1,northmacedonia
A. Pandev,4,0,1,3,1,4,-3,1,northmacedonia
Rabotnicki,4,0,1,3,1,5,-4,1,northmacedonia
Bregalnica Stip,4,0,0,4,1,7,-6,0,northmacedonia
Tikves,4,0,0,4,1,7,-6,0,northmacedonia
Brann,4,4,0,0,7,1,6,12,norway
Bodo / Glimt,4,2,2,0,11,7,4,8,norway
Viking,4,2,1,1,6,6,0,7,norway
Haugesund,4,1,3,0,5,2,3,6,norway
HamKam,4,2,0,2,6,7,-1,6,norway
Tromso,4,2,0,2,6,9,-3,6,norway
Molde,4,1,2,1,7,7,0,5,norway
Sarpsborg 08,4,1,1,2,6,5,1,4,norway
Lillestrom,4,1,1,2,4,6,-2,4,norway
Valerenga,4,1,1,2,5,8,-3,4,norway
Stromsgodset,4,1,0,3,2,6,-4,3,norway
Aalesund,4,1,0,3,4,13,-9,3,norway
Stabaek,4,0,2,2,3,5,-2,2,norway
Odd,4,0,1,3,6,12,-6,1,norway
Sandefjord,4,0,0,4,8,12,-4,0,norway
Rosenborg,4,0,0,4,3,14,-11,0,norway
Fredrikstad,4,3,1,0,11,5,6,10,norway2
Ranheim,4,3,0,1,4,4,0,9,norway2
Kristiansund,4,2,2,0,7,4,3,8,norway2
KFUM Oslo,4,2,1,1,7,6,1,7,norway2
Bryne,4,2,0,2,7,5,2,6,norway2
Kongsvinger,4,2,0,2,6,5,1,6,norway2
Sogndal,4,1,1,2,6,8,-2,4,norway2
Asane,4,1,1,2,5,7,-2,4,norway2
Start,4,1,1,2,1,3,-2,4,norway2
Raufoss,4,1,1,2,4,7,-3,4,norway2
Hodd,4,1,0,3,1,5,-4,3,norway2
Mjondalen,4,0,2,2,0,2,-2,2,norway2
Moss,4,0,2,2,3,6,-3,2,norway2
Jerv,4,0,2,2,8,14,-6,2,norway2
Sandnes Ulf,4,0,2,2,2,8,-6,2,norway2
Skeid,4,0,0,4,0,8,-8,0,norway2
Al Seeb,4,3,1,0,8,0,8,10,oman
Sohar,4,3,0,1,9,4,5,9,oman
Al-Nahda,4,2,2,0,9,6,3,8,oman
Al-Shabab Club,4,2,2,0,7,5,2,8,oman
Al Wehda,4,2,1,1,5,5,0,7,oman
Ibri,4,2,0,2,5,4,1,6,oman
Al-Rustaq,4,1,2,1,4,4,0,5,oman
Sur,3,1,1,1,2,2,0,4,oman
Al Nasr,4,1,1,2,1,2,-1,4,oman
Dhofar,4,1,1,2,6,8,-2,4,oman
Oman Club,3,1,1,1,3,5,-2,4,oman
Bahla,4,1,0,3,1,4,-3,3,oman
Plaza Amador,4,3,0,1,8,3,5,9,panama
San Miguelito,4,2,1,1,4,3,1,7,panama
Independiente,4,2,0,2,9,6,3,6,panama
UMECIT,4,1,3,0,1,0,1,6,panama
Arabe Unido,4,1,2,1,2,2,0,5,panama
Tauro,4,1,1,2,2,4,-2,4,panama
San Francisco,4,0,3,1,0,3,-3,3,panama
Herrera,4,0,2,2,2,5,-3,2,panama
Alianza,4,0,2,2,1,5,-4,2,panama
Universitario,4,0,1,3,1,4,-3,1,panama
Costa del Este,4,0,1,3,4,12,-8,1,panama
A. Chiriqui,4,0,0,4,2,9,-7,0,panama
Arabe Unido,4,3,1,0,7,1,6,10,panama2
San Francisco,4,3,0,1,9,2,7,9,panama2
Tauro,4,2,2,0,5,2,3,8,panama2
Costa del Este,4,2,2,0,6,4,2,8,panama2
Independiente,4,2,1,1,11,7,4,7,panama2
Alianza,4,1,3,0,6,5,1,6,panama2
Universitario,4,1,2,1,4,7,-3,5,panama2
UMECIT,4,1,0,3,4,8,-4,3,panama2
San Miguelito,4,0,2,2,2,4,-2,2,panama2
Plaza Amador,4,0,0,4,2,7,-5,0,panama2
Herrera,4,0,0,4,4,11,-7,0,panama2
A. Chiriqui,4,0,0,4,1,15,-14,0,panama2
G. Caballero,4,2,1,1,4,4,0,7,paraguay
Libertad,4,2,0,2,4,5,-1,6,paraguay
S. Trinidense,4,1,2,1,6,5,1,5,paraguay
Cerro Porteno,4,1,2,1,6,6,0,5,paraguay
Guarani,4,1,2,1,5,6,-1,5,paraguay
Nacional,4,1,1,2,5,6,-1,4,paraguay
Olimpia,4,1,1,2,4,5,-1,4,paraguay
S. Ameliano,4,1,1,2,4,5,-1,4,paraguay
S. Luqueno,4,1,1,2,4,6,-2,4,paraguay
Guairena,4,1,1,2,3,6,-3,4,paraguay
Resistencia,4,0,1,3,1,7,-6,1,paraguay
Tacuary,4,0,0,4,1,6,-5,0,paraguay
Libertad,4,3,1,0,12,3,9,10,paraguay2
Cerro Porteno,4,2,1,1,10,5,5,7,paraguay2
S. Trinidense,4,2,1,1,9,5,4,7,paraguay2
Nacional,4,1,2,1,5,3,2,5,paraguay2
Guarani,4,1,2,1,1,4,-3,5,paraguay2
S. Luqueno,4,1,1,2,4,4,0,4,paraguay2
Resistencia,4,1,1,2,3,7,-4,4,paraguay2
Olimpia,4,1,1,2,1,5,-4,4,paraguay2
G. Caballero,4,1,0,3,5,6,-1,3,paraguay2
Guairena,4,1,0,3,3,7,-4,3,paraguay2
S. Ameliano,4,1,0,3,6,11,-5,3,paraguay2
Tacuary,4,0,1,3,3,8,-5,1,paraguay2
S. Cristal,4,3,1,0,9,2,7,10,peru
FBC Melgar,4,1,3,0,7,6,1,6,peru
Alianza Lima,4,2,0,2,6,5,1,6,peru
D. Garcilaso,4,1,2,1,7,6,1,5,peru
Sport Huancayo,4,1,1,2,6,8,-2,4,peru
Sport Boys,4,1,1,2,2,4,-2,4,peru
Union Comercio,4,1,1,2,4,10,-6,4,peru
Universitario,4,1,0,3,4,5,-1,3,peru
D. Municipal,4,1,0,3,2,4,-2,3,peru
Cusco,4,1,0,3,4,7,-3,3,peru
Carlos Manucci,4,1,0,3,2,7,-5,3,peru
Cienciano,4,1,0,3,6,12,-6,3,peru
Cajamarca,4,1,0,3,5,11,-6,3,peru
ADT,4,0,2,2,5,7,-2,2,peru
Cesar Vallejo,4,0,2,2,3,9,-6,2,peru
Atletico Grau,4,0,1,3,4,7,-3,1,peru
Binacional,4,0,1,3,3,10,-7,1,peru
AD Cantolao,4,0,1,3,1,12,-11,1,peru
Alianza A.,4,0,0,4,7,14,-7,0,peru
Alianza Lima,4,3,1,0,6,2,4,10,peru2
FBC Melgar,4,2,2,0,3,1,2,8,peru2
Cesar Vallejo,4,2,1,1,6,2,4,7,peru2
Universitario,4,1,3,0,4,3,1,6,peru2
ADT,4,1,2,1,3,3,0,5,peru2
D. Garcilaso,4,1,2,1,2,3,-1,5,peru2
Sport Boys,4,1,1,2,4,5,-1,4,peru2
Sport Huancayo,4,1,1,2,4,5,-1,4,peru2
AD Cantolao,4,1,1,2,3,4,-1,4,peru2
Cienciano,4,1,1,2,6,8,-2,4,peru2
Atletico Grau,4,1,1,2,4,7,-3,4,peru2
S. Cristal,4,1,1,2,3,6,-3,4,peru2
D. Municipal,4,1,0,3,3,9,-6,3,peru2
Carlos Manucci,4,0,2,2,3,6,-3,2,peru2
Cajamarca,4,0,2,2,3,8,-5,2,peru2
Binacional,4,0,1,3,5,9,-4,1,peru2
Alianza A.,4,0,1,3,1,7,-6,1,peru2
Union Comercio,4,0,1,3,4,11,-7,1,peru2
Cusco,4,0,0,4,2,8,-6,0,peru2
Santa Rosa,4,2,1,1,7,5,2,7,peru3
Llacuabamba,4,2,0,2,8,7,1,6,peru3
Ayacucho,4,1,2,1,6,6,0,5,peru3
Juan Aurich,4,1,2,1,3,3,0,5,peru3
Comerciantes U.,4,1,1,2,7,6,1,4,peru3
U. San Martin,4,1,1,2,4,4,0,4,peru3
D. Coopsol,4,1,1,2,3,5,-2,4,peru3
Comerciantes,4,1,1,2,2,6,-4,4,peru3
A. Huanuco,4,0,2,2,2,4,-2,2,peru3
Huaral,4,0,1,3,3,7,-4,1,peru3
Santos FC,4,0,1,3,2,8,-6,1,peru3
Alfonso Ugarte,4,0,1,3,1,9,-8,1,peru3
Carlos Stein,4,0,1,3,4,17,-13,1,peru3
M. El Pirata,4,0,0,4,1,18,-17,0,peru3
Cebu FC,4,4,0,0,9,3,6,12,philippines
Kaya,4,3,1,0,12,3,9,10,philippines
Stallion,4,2,1,1,5,3,2,7,philippines
Mendiola,4,2,0,2,6,9,-3,6,philippines
United City,4,1,1,2,8,10,-2,4,philippines
Maharlika,4,1,0,3,3,13,-10,3,philippines
Azkals,4,0,0,4,0,12,-12,0,philippines
Slask Wroclaw,4,4,0,0,8,1,7,12,poland
Pogon Szczecin,4,2,1,1,8,2,6,7,poland
Warta Poznan,4,2,1,1,4,2,2,7,poland
Rakow C.,4,2,0,2,9,10,-1,6,poland
Jagiellonia,4,1,2,1,10,9,1,5,poland
Cracovia Krakow,4,1,2,1,3,3,0,5,poland
Korona Kielce,4,1,2,1,5,6,-1,5,poland
Legia Warsaw,4,1,1,2,5,10,-5,4,poland
Lech Poznan,4,1,1,2,4,9,-5,4,poland
Ruch Chorzow,4,0,3,1,4,5,-1,3,poland
Piast Gliwice,4,0,3,1,3,4,-1,3,poland
Radomiak Radom,4,1,0,3,4,8,-4,3,poland
Zaglebie Lubin,4,1,0,3,4,9,-5,3,poland
Widzew Lodz,4,0,2,2,5,8,-3,2,poland
Gornik Zabrze,4,0,2,2,4,8,-4,2,poland
Stal Mielec,4,0,1,3,2,6,-4,1,poland
Puszcza Niepolo,4,0,1,3,2,8,-6,1,poland
LKS Lodz,4,0,0,4,2,9,-7,0,poland
Odra Opole,4,3,1,0,10,4,6,10,poland2
Gornik Leczna,4,2,2,0,4,2,2,8,poland2
T. Nieciecza,4,2,1,1,8,3,5,7,poland2
Wisla Krakow,4,2,1,1,8,5,3,7,poland2
Miedz Legnica,4,2,1,1,8,6,2,7,poland2
Polonia Warszaw,4,2,1,1,6,4,2,7,poland2
Z. Sosnowiec,4,1,3,0,2,1,1,6,poland2
Stal Rzeszow,4,2,0,2,6,6,0,6,poland2
Motor Lublin,4,2,0,2,2,4,-2,6,poland2
Wisla Plock,4,1,1,2,1,5,-4,4,poland2
Arka Gdynia,4,1,0,3,4,7,-3,3,poland2
Znicz Pruszkow,4,1,0,3,4,10,-6,3,poland2
Chrobry Glogow,4,0,2,2,4,7,-3,2,poland2
Katowice,4,0,2,2,3,8,-5,2,poland2
Lechia Gdansk,4,0,2,2,2,7,-5,2,poland2
Podbeskidzie,4,0,1,3,2,10,-8,1,poland2
Tychy,4,0,0,4,2,10,-8,0,poland2
Resovia Rzeszow,4,0,0,4,3,12,-9,0,poland2
Pogon Siedlce,4,3,0,1,9,4,5,9,poland3
SKRA Czestochow,4,2,1,1,6,3,3,7,poland3
Chojniczanka,4,2,1,1,5,3,2,7,poland3
Kalisz,4,2,1,1,5,3,2,7,poland3
K. Kolobrzeg,4,2,1,1,10,9,1,7,poland3
Hutnik Krakow,4,2,0,2,3,5,-2,6,poland3
Radunia Stezyca,4,1,2,1,4,7,-3,5,poland3
Lech Poznan B,4,1,1,2,6,7,-1,4,poland3
LKS Lodz B,4,1,1,2,6,7,-1,4,poland3
Stomil Olsztyn,4,1,0,3,6,8,-2,3,poland3
Zaglebie L. B,4,1,0,3,4,7,-3,3,poland3
Wisla Pulawy,4,1,0,3,7,11,-4,3,poland3
Sandecja Nowy,4,1,0,3,2,6,-4,3,poland3
Olimpia Elblag,4,0,2,2,3,5,-2,2,poland3
Polonia Bytom,4,0,2,2,2,4,-2,2,poland3
Jastrzebie,4,0,2,2,1,4,-3,2,poland3
Stalowa Wola,4,0,1,3,0,4,-4,1,poland3
O. Grudziadz,4,0,0,4,4,13,-9,0,poland3
Benfica,4,4,0,0,9,4,5,12,portugal
Sporting Braga,4,3,0,1,12,9,3,9,portugal
FC Porto,4,3,0,1,5,3,2,9,portugal
Moreirense,4,2,1,1,6,4,2,7,portugal
Sporting CP,3,2,1,0,6,4,2,7,portugal
Casa Pia,4,2,1,1,5,3,2,7,portugal
Boavista,4,2,1,1,8,7,1,7,portugal
Portimonense,4,2,1,1,6,5,1,7,portugal
Guimaraes,4,2,1,1,4,5,-1,7,portugal
Famalicao,4,1,2,1,5,5,0,5,portugal
Estrela Amadora,4,1,2,1,4,5,-1,5,portugal
Chaves,4,1,0,3,3,11,-8,3,portugal
Arouca,4,0,2,2,4,6,-2,2,portugal
Vizela,4,0,2,2,4,7,-3,2,portugal
Rio Ave,4,0,1,3,2,7,-5,1,portugal
Farense,3,0,0,3,1,4,-3,0,portugal
Estoril,4,0,0,4,9,14,-5,0,portugal
Gil Vicente,4,0,0,4,4,9,-5,0,portugal
Al Rayyan,4,3,0,1,9,6,3,9,qatar
Al Duhail,4,2,1,1,9,8,1,7,qatar
Al Sadd,2,2,0,0,6,2,4,6,qatar
Al Wakrah,2,1,1,0,3,0,3,4,qatar
Umm Salal,2,1,1,0,4,2,2,4,qatar
Qatar SC,4,1,1,2,6,6,0,4,qatar
Al Gharafa,3,1,1,1,8,9,-1,4,qatar
Al Shamal,4,0,3,1,6,7,-1,3,qatar
Al Arabi,1,0,0,1,0,1,-1,0,qatar
Al Ahli Doha,2,0,0,2,3,7,-4,0,qatar
Al Markhiya,2,0,0,2,2,7,-5,0,qatar
Al Muaidar,4,0,0,4,5,16,-11,0,qatar
FCSB,4,3,1,0,9,4,5,10,romania
CFR Cluj,4,2,1,1,10,8,2,7,romania
Rapid Bucharest,4,1,3,0,8,6,2,6,romania
Otelul,4,1,3,0,4,2,2,6,romania
P. Iasi,4,2,0,2,7,6,1,6,romania
U. Cluj,4,1,3,0,6,5,1,6,romania
Farul Constanta,4,2,0,2,4,7,-3,6,romania
Petrolul,4,1,2,1,4,3,1,5,romania
Hermannstadt,4,0,4,0,4,4,0,4,romania
U Craiova 1948,4,1,1,2,5,7,-2,4,romania
UTA Arad,4,0,3,1,4,5,-1,3,romania
Voluntari,4,0,3,1,3,5,-2,3,romania
Sepsi OSK,4,1,0,3,2,5,-3,3,romania
Din. Bucharest,4,1,0,3,3,11,-8,3,romania
Univ. Craiova,4,0,2,2,1,6,-5,2,romania
Botosani,4,0,1,3,5,14,-9,1,romania
Lokomotiv M.,4,2,2,0,6,4,2,8,russia
Zenit,4,2,1,1,7,4,3,7,russia
FC Krasnodar,4,1,3,0,5,3,2,6,russia
Rubin Kazan,4,2,0,2,3,5,-2,6,russia
Dinamo Moscow,4,1,2,1,3,3,0,5,russia
Fakel Voronezh,4,1,2,1,2,4,-2,5,russia
CSKA Moscow,4,0,4,0,6,6,0,4,russia
Akhmat Grozny,4,1,1,2,1,4,-3,4,russia
Ural,4,1,1,2,3,8,-5,4,russia
PFC Sochi,4,1,0,3,5,6,-1,3,russia
Spartak Moscow,4,1,0,3,6,10,-4,3,russia
Orenburg,4,1,0,3,3,8,-5,3,russia
Krylya Sovetov,4,0,1,3,4,9,-5,1,russia
Nizhny Novgorod,4,0,1,3,1,6,-5,1,russia
Rostov,4,0,1,3,4,10,-6,1,russia
Baltika,4,0,0,4,3,8,-5,0,russia
Makhachkala,4,3,1,0,5,1,4,10,russia2
Akron,4,3,0,1,3,1,2,9,russia2
Neftekhimik,4,2,2,0,5,3,2,8,russia2
Tyumen,4,2,2,0,5,3,2,8,russia2
Khimki,4,2,1,1,7,5,2,7,russia2
Rodina Moskva,4,1,2,1,8,6,2,5,russia2
Arsenal Tula,4,0,4,0,3,3,0,4,russia2
Leningradets,4,1,1,2,5,6,-1,4,russia2
V. Astrakhan,4,0,3,1,2,3,-1,3,russia2
Chernomorets,4,1,0,3,3,6,-3,3,russia2
Shinnik,4,1,0,3,5,10,-5,3,russia2
Kamaz,4,0,2,2,2,4,-2,2,russia2
A. Vladikavkaz,4,0,2,2,2,6,-4,2,russia2
Yenisey,4,0,1,3,2,5,-3,1,russia2
Torpedo Moscow,4,0,1,3,1,5,-4,1,russia2
Urozhay,4,0,1,3,3,8,-5,1,russia2
SKA Khabarovsk,4,0,0,4,3,10,-7,0,russia2
Sokol Saratov,4,0,0,4,6,15,-9,0,russia2
Al Nassr,4,4,0,0,15,3,12,12,saudiarabia
Al Hilal,4,3,1,0,12,4,8,10,saudiarabia
Al Fateh,4,3,0,1,8,5,3,9,saudiarabia
Al Ittihad,4,2,2,0,5,1,4,8,saudiarabia
Al Feiha,4,2,1,1,7,5,2,7,saudiarabia
Al Taawon,4,2,1,1,7,5,2,7,saudiarabia
Al Khaleej,4,2,1,1,5,3,2,7,saudiarabia
Al Akhdoud,4,2,0,2,3,4,-1,6,saudiarabia
Al Ahli Jeddah,4,2,0,2,8,10,-2,6,saudiarabia
Al Ittifaq,4,1,1,2,3,4,-1,4,saudiarabia
Al Shabab,4,1,1,2,3,8,-5,4,saudiarabia
Damak,4,1,0,3,6,9,-3,3,saudiarabia
Al Wahda,4,1,0,3,6,12,-6,3,saudiarabia
Al Riyadh,4,1,0,3,4,12,-8,3,saudiarabia
Al Raed,4,0,2,2,4,6,-2,2,saudiarabia
Al Hazm,4,0,2,2,5,11,-6,2,saudiarabia
Al Tai,4,0,1,3,4,10,-6,1,saudiarabia
Abha,4,0,1,3,3,11,-8,1,saudiarabia
Al Quadisiya,4,3,1,0,4,0,4,10,saudiarabia2
Al Orubah,4,3,0,1,6,3,3,9,saudiarabia2
Jeddah,4,2,1,1,4,3,1,7,saudiarabia2
Al Kholood,4,2,0,2,8,4,4,6,saudiarabia2
Al Adalh,4,2,0,2,7,6,1,6,saudiarabia2
Ohod,4,2,0,2,5,5,0,6,saudiarabia2
Al Faisaly,4,1,2,1,6,6,0,5,saudiarabia2
Al Najma,4,1,1,2,10,8,2,4,saudiarabia2
Al Arabi,3,1,1,1,7,5,2,4,saudiarabia2
Al Jabalain,4,1,1,2,4,6,-2,4,saudiarabia2
Al-Ain,4,1,1,2,4,7,-3,4,saudiarabia2
Al-Jndal,4,1,1,2,3,7,-4,4,saudiarabia2
Al Batin,4,1,0,3,2,4,-2,3,saudiarabia2
Al Taraji,4,1,0,3,2,7,-5,3,saudiarabia2
Al Bukayriyah,3,0,1,2,1,3,-2,1,saudiarabia2
Al Qaisoma,4,0,1,3,4,8,-4,1,saudiarabia2
Hajer,3,0,0,3,2,9,-7,0,saudiarabia2
Al Safa,4,0,0,4,2,10,-8,0,saudiarabia2
Celtic,4,4,0,0,10,2,8,12,scotland
Rangers,4,3,0,1,7,1,6,9,scotland
St. Mirren,4,2,2,0,6,4,2,8,scotland
Hearts,4,2,0,2,3,2,1,6,scotland
Aberdeen,4,1,2,1,5,5,0,5,scotland
Livingston,4,1,2,1,6,7,-1,5,scotland
Hibernian,4,1,2,1,6,8,-2,5,scotland
Motherwell,4,1,1,2,2,4,-2,4,scotland
Ross County,4,1,1,2,3,8,-5,4,scotland
Kilmarnock,4,0,2,2,4,7,-3,2,scotland
Dundee FC,4,0,2,2,3,7,-4,2,scotland
St. Johnstone,4,0,2,2,0,4,-4,2,scotland
Dundee Utd,4,3,1,0,10,1,9,10,scotland2
Ayr Utd,4,3,0,1,9,5,4,9,scotland2
Partick Thistle,4,2,1,1,9,3,6,7,scotland2
Raith Rovers,4,2,1,1,5,4,1,7,scotland2
Arbroath,3,2,0,1,7,2,5,6,scotland2
Dunfermline,4,1,2,1,4,5,-1,5,scotland2
Inverness,4,1,0,3,4,6,-2,3,scotland2
Airdrieonians,4,1,0,3,2,8,-6,3,scotland2
Greenock Morton,4,0,2,2,4,7,-3,2,scotland2
Queen`s Park,4,0,1,3,5,11,-6,1,scotland2
Falkirk,4,4,0,0,13,3,10,12,scotland3
Hamilton,4,2,2,0,7,3,4,8,scotland3
Montrose,4,2,0,2,8,7,1,6,scotland3
Queen of South,4,2,0,2,4,5,-1,6,scotland3
Cove Rangers,4,1,2,1,7,5,2,5,scotland3
Kelty Hearts,4,1,1,2,7,7,0,4,scotland3
Stirling Albion,4,1,0,3,1,7,-6,3,scotland3
Edinburgh City,4,0,2,2,6,10,-4,2,scotland3
Alloa Athletic,4,0,1,3,4,7,-3,1,scotland3
Annan Athletic,4,0,1,3,4,12,-8,1,scotland3
Stenhousemuir,4,3,1,0,5,1,4,10,scotland4
Peterhead,4,3,0,1,7,4,3,9,scotland4
Spartans,4,2,2,0,8,6,2,8,scotland4
Bonnyrigg Rose,4,2,1,1,7,5,2,7,scotland4
Dumbarton,4,2,0,2,8,6,2,6,scotland4
Forfar Athletic,4,1,2,1,4,4,0,5,scotland4
East Fife,4,0,3,1,4,5,-1,3,scotland4
Clyde,4,0,1,3,4,8,-4,1,scotland4
Stranraer,4,0,1,3,2,13,-11,1,scotland4
Elgin City,4,0,0,4,3,15,-12,0,scotland4
Partizan,4,4,0,0,11,1,10,12,serbia
Backa Topola,4,2,2,0,6,2,4,8,serbia
Red Star,4,2,0,2,11,9,2,6,serbia
Radnicki 1923,4,2,0,2,6,4,2,6,serbia
Mladost Lucani,4,2,0,2,4,5,-1,6,serbia
Cukaricki,4,1,1,2,5,6,-1,4,serbia
Vozdovac,4,1,1,2,3,4,-1,4,serbia
Radnicki Nis,4,1,1,2,2,3,-1,4,serbia
Napredak,4,1,1,2,5,8,-3,4,serbia
Javor Ivanjica,4,1,0,3,4,7,-3,3,serbia
Sp. Subotica,4,1,0,3,3,7,-4,3,serbia
Rad. Surdulica,4,0,2,2,3,7,-4,2,serbia
Vojvodina,4,0,2,2,3,7,-4,2,serbia
Novi Pazar,4,0,1,3,1,5,-4,1,serbia
IMT N. Beograd,4,0,0,4,2,7,-5,0,serbia
Z. Pancevo,4,0,0,4,4,12,-8,0,serbia
OFK Beograd,4,2,2,0,6,3,3,8,serbia2
Kolubara,4,2,1,1,6,4,2,7,serbia2
Indija,4,2,1,1,5,3,2,7,serbia2
OFK Vrac,4,2,1,1,5,4,1,7,serbia2
S. Mitrovica,4,2,0,2,4,3,1,6,serbia2
Dubocica,4,1,3,0,3,2,1,6,serbia2
Semendrija 1924,4,1,2,1,3,3,0,5,serbia2
Sloboda Uzice,4,1,1,2,1,2,-1,4,serbia2
Jedinstvo Ub,4,1,1,2,5,8,-3,4,serbia2
Tekstilac Odzac,4,1,0,3,3,4,-1,3,serbia2
Macva Sabac,4,0,3,1,1,2,-1,3,serbia2
Radnicki B.,4,1,0,3,3,7,-4,3,serbia2
Graficar,4,0,2,2,1,6,-5,2,serbia2
Metalac GM,4,0,1,3,1,5,-4,1,serbia2
Mladost Novi S.,4,0,1,3,1,7,-6,1,serbia2
Novi Sad,4,0,0,4,2,10,-8,0,serbia2
A. Niigata (S),4,3,1,0,15,5,10,10,singapore
Lion City,4,3,0,1,18,7,11,9,singapore
Khalsa,4,3,0,1,14,11,3,9,singapore
Hougang,4,3,0,1,11,8,3,9,singapore
Tampines Rovers,4,3,0,1,10,9,1,9,singapore
Geylang,4,2,1,1,8,8,0,7,singapore
DPMM FC,4,1,2,1,5,4,1,5,singapore
Tanjong Pagar,4,0,1,3,6,12,-6,1,singapore
Young Lions,4,0,0,4,4,15,-11,0,singapore
Spartak Trnava,4,3,1,0,7,4,3,10,slovakia
S. Bratislava,4,3,0,1,8,5,3,9,slovakia
Banska Bystrica,4,2,1,1,10,6,4,7,slovakia
Zilina,4,2,1,1,6,3,3,7,slovakia
Trencin,4,2,1,1,7,5,2,7,slovakia
DAC Streda,4,2,0,2,4,6,-2,6,slovakia
Podbrezova,4,1,0,3,9,9,0,3,slovakia
Z. Michalovce,4,0,2,2,3,6,-3,2,slovakia
Ruzomberok,4,0,2,2,4,12,-8,2,slovakia
Skalica,4,0,1,3,4,8,-4,1,slovakia
Zlate Moravce,4,0,1,3,3,7,-4,1,slovakia
FC Kosice,4,0,0,4,3,10,-7,0,slovakia
Komarno,4,4,0,0,12,5,7,12,slovakia2
S. Bratislava B,4,2,2,0,7,2,5,8,slovakia2
Tatran Presov,4,2,1,1,6,3,3,7,slovakia2
Futura Humenne,4,2,1,1,7,6,1,7,slovakia2
Zilina B,4,2,0,2,5,4,1,6,slovakia2
Puchov,4,2,0,2,7,7,0,6,slovakia2
P. Bystrica,4,1,2,1,2,3,-1,5,slovakia2
Petrzalka,4,1,2,1,4,7,-3,5,slovakia2
OFK Malzenice,4,1,1,2,6,6,0,4,slovakia2
Samorin,4,1,1,2,3,3,0,4,slovakia2
Pohronie,4,1,1,2,4,6,-2,4,slovakia2
Spartak Myjava,4,1,1,2,4,6,-2,4,slovakia2
Spisska Nova V.,4,0,1,3,3,6,-3,1,slovakia2
L. Mikulas,4,0,1,3,3,8,-5,1,slovakia2
Dolny Kubin,4,0,1,3,5,14,-9,1,slovakia2
Slavoj Trebisov,4,0,0,4,0,10,-10,0,slovakia2
NK Celje,4,3,1,0,11,3,8,10,slovenia
NK Olimpija,4,3,0,1,9,5,4,9,slovenia
Mura,4,3,0,1,6,3,3,9,slovenia
Koper,4,1,3,0,5,4,1,6,slovenia
Radomlje,4,1,1,2,4,5,-1,4,slovenia
Bravo,4,1,1,2,4,6,-2,4,slovenia
Aluminij,4,1,0,3,5,9,-4,3,slovenia
Rogaska,4,1,0,3,2,11,-9,3,slovenia
Domzale,4,0,1,3,5,10,-5,1,slovenia
Maribor,4,0,0,4,2,7,-5,0,slovenia
Mamelodi S.,4,4,0,0,6,0,6,12,southafrica
Golden Arrows,4,3,0,1,6,5,1,9,southafrica
Chippa Utd,4,2,2,0,3,1,2,8,southafrica
Moroka Swallows,3,2,1,0,5,2,3,7,southafrica
Sekhukhune,4,2,1,1,4,3,1,7,southafrica
SuperSport Utd,4,2,1,1,4,3,1,7,southafrica
Richards Bay,4,1,2,1,2,3,-1,5,southafrica
Stellenbosch,4,1,1,2,4,5,-1,4,southafrica
Polokwane,4,1,1,2,3,4,-1,4,southafrica
Royal AM,4,1,1,2,4,6,-2,4,southafrica
Cape Town City,4,1,1,2,3,5,-2,4,southafrica
Kaizer Chiefs,4,1,0,3,3,4,-1,3,southafrica
Orlando Pirates,3,0,2,1,1,2,-1,2,southafrica
AmaZulu,4,0,2,2,1,5,-4,2,southafrica
TS Galaxy,4,0,1,3,0,5,-5,1,southafrica
Cape Town Spurs,4,0,0,4,3,10,-7,0,southafrica
All Stars,4,2,2,0,8,4,4,8,southafrica2
Polokwane,4,2,1,1,8,6,2,7,southafrica2
Uthongathi,4,2,1,1,4,2,2,7,southafrica2
Baroka,4,2,1,1,5,4,1,7,southafrica2
Magesi,4,2,1,1,5,5,0,7,southafrica2
MM Platinum,4,1,2,1,7,6,1,5,southafrica2
JDR Stars,4,1,2,1,2,2,0,5,southafrica2
Pretoria U.,4,1,2,1,2,2,0,5,southafrica2
Cape Town Spurs,4,1,1,2,4,6,-2,4,southafrica2
Hungry Lions,4,1,1,2,3,6,-3,4,southafrica2
Pretoria C.,4,1,1,2,4,8,-4,4,southafrica2
Venda FC,4,0,3,1,3,4,-1,3,southafrica2
Casric Stars,4,0,3,1,4,6,-2,3,southafrica2
Black Leopards,4,0,1,3,0,4,-4,1,southafrica2
TTM,4,0,1,3,0,7,-7,1,southafrica2
Platinum City,4,0,1,3,1,9,-8,1,southafrica2
Gwangju,4,3,1,0,7,3,4,10,southkorea
Jeonbuk Motors,4,3,1,0,5,1,4,10,southkorea
Seoul,4,2,1,1,8,6,2,7,southkorea
Daegu,4,2,1,1,7,6,1,7,southkorea
Incheon Utd,4,1,3,0,4,3,1,6,southkorea
Pohang Steelers,4,1,2,1,3,2,1,5,southkorea
Ulsan,4,1,2,1,5,5,0,5,southkorea
Suwon City,4,1,2,1,4,5,-1,5,southkorea
Daejeon Citizen,4,0,3,1,6,7,-1,3,southkorea
Gangwon,4,1,0,3,4,5,-1,3,southkorea
Jeju Utd,4,0,0,4,1,5,-4,0,southkorea
Suwon Bluewings,4,0,0,4,1,11,-10,0,southkorea
Busan IPark,4,4,0,0,7,3,4,12,southkorea2
Cheonan City,4,2,2,0,7,2,5,8,southkorea2
Cheongju,4,2,1,1,4,3,1,7,southkorea2
Gimcheon Sangmu,4,2,0,2,10,7,3,6,southkorea2
Jeonnam Dragons,4,2,0,2,5,5,0,6,southkorea2
Gimpo,4,1,2,1,5,4,1,5,southkorea2
Gyeongnam,4,1,2,1,5,4,1,5,southkorea2
Ansan Greeners,4,1,1,2,7,9,-2,4,southkorea2
Bucheon FC,4,1,1,2,3,5,-2,4,southkorea2
Seoul E-Land,4,1,0,3,2,4,-2,3,southkorea2
Seongnam,4,0,2,2,2,7,-5,2,southkorea2
Anyang,4,0,1,3,5,12,-7,1,southkorea2
Chungnam Asan,4,0,0,4,0,8,-8,0,southkorea2
Girona,4,4,0,0,9,4,5,12,spain
Atletico Madrid,4,3,0,1,12,3,9,9,spain
FC Barcelona,4,2,2,0,10,8,2,8,spain
Real Madrid,4,2,1,1,6,4,2,7,spain
Osasuna,4,2,0,2,6,8,-2,6,spain
Rayo Vallecano,4,1,2,1,3,3,0,5,spain
Villarreal,4,1,2,1,3,4,-1,5,spain
Celta Vigo,4,1,1,2,7,8,-1,4,spain
Real Sociedad,4,1,1,2,3,4,-1,4,spain
Mallorca,4,1,1,2,6,8,-2,4,spain
Athletic Bilbao,4,1,1,2,2,4,-2,4,spain
Las Palmas,4,1,0,3,2,5,-3,3,spain
Real Betis,4,0,3,1,3,8,-5,3,spain
Getafe,4,0,2,2,8,10,-2,2,spain
Alaves,4,0,2,2,2,5,-3,2,spain
Valencia,4,0,2,2,3,7,-4,2,spain
Sevilla FC,3,0,1,2,3,5,-2,1,spain
Granada,4,0,1,3,6,11,-5,1,spain
Cadiz,4,0,1,3,3,9,-6,1,spain
Almeria,4,0,0,4,4,15,-11,0,spain
Eibar,4,4,0,0,10,5,5,12,spain2
Levante,4,2,2,0,4,0,4,8,spain2
Real Zaragoza,4,2,1,1,6,4,2,7,spain2
Sporting Gijon,4,2,1,1,6,4,2,7,spain2
Espanyol,4,2,0,2,7,5,2,6,spain2
Mirandes,4,2,0,2,6,5,1,6,spain2
Leganes,4,2,0,2,4,3,1,6,spain2
Valladolid,4,2,0,2,2,4,-2,6,spain2
Real Oviedo,4,1,2,1,3,2,1,5,spain2
Alcorcon,4,1,2,1,6,6,0,5,spain2
Eldense,4,1,2,1,5,6,-1,5,spain2
Huesca,4,1,1,2,3,4,-1,4,spain2
Racing,4,1,1,2,5,7,-2,4,spain2
Tenerife,4,1,1,2,3,6,-3,4,spain2
Elche,4,1,1,2,2,7,-5,4,spain2
Villarreal B,4,0,3,1,7,8,-1,3,spain2
Cartagena,4,0,3,1,2,3,-1,3,spain2
Albacete,4,1,0,3,3,8,-5,3,spain2
Racing Ferrol,4,0,1,3,1,7,-6,1,spain2
FC Andorra,4,0,0,4,5,11,-6,0,spain2
Burgos,4,0,0,4,2,10,-8,0,spain2
Amorebieta,4,0,0,4,1,11,-10,0,spain2
Varnamo,4,4,0,0,10,3,7,12,sweden
Kalmar,4,3,0,1,9,4,5,9,sweden
Malmo FF,4,3,0,1,8,4,4,9,sweden
Hammarby,4,2,2,0,4,0,4,8,sweden
Mjallby,4,2,1,1,5,2,3,7,sweden
Djurgarden,4,2,1,1,3,2,1,7,sweden
Elfsborg,4,2,0,2,4,2,2,6,sweden
Sirius,4,2,0,2,5,5,0,6,sweden
IFK Goteborg,4,1,2,1,5,6,-1,5,sweden
Hacken,4,0,1,3,4,8,-4,1,sweden
Halmstad,4,0,1,3,3,7,-4,1,sweden
Norrkoping,4,0,1,3,6,11,-5,1,sweden
Degerfors,4,0,1,3,3,9,-6,1,sweden
Brommapojkarna,4,0,0,4,6,10,-4,0,sweden
AIK,4,0,0,4,3,12,-9,0,sweden
Varberg BoIS,4,0,0,4,1,17,-16,0,sweden
GAIS,4,3,0,1,17,3,14,9,sweden2
Landskrona,4,3,0,1,7,6,1,9,sweden2
Vasteras,4,2,2,0,6,4,2,8,sweden2
Trelleborg,4,2,1,1,6,6,0,7,sweden2
Orgryte,4,2,0,2,5,5,0,6,sweden2
Oster,4,1,1,2,5,6,-1,4,sweden2
GIF Sundsvall,4,1,1,2,5,7,-2,4,sweden2
Brage,4,1,1,2,2,6,-4,4,sweden2
Gefle,4,0,3,1,5,7,-2,3,sweden2
Orebro,4,1,0,3,5,9,-4,3,sweden2
Helsingborg,4,0,2,2,4,8,-4,2,sweden2
Ostersunds,4,0,2,2,3,8,-5,2,sweden2
Skovde AIK,4,0,1,3,8,13,-5,1,sweden2
AFC Eskilstuna,4,0,1,3,1,8,-7,1,sweden2
Utsikten,4,0,1,3,3,11,-8,1,sweden2
Jonkopings,4,0,0,4,4,9,-5,0,sweden2
BSC Young Boys,4,2,1,1,4,3,1,7,switzerland
FC Zurich,4,1,3,0,6,3,3,6,switzerland
Servette,4,2,0,2,3,6,-3,6,switzerland
Winterthur,4,1,1,2,11,12,-1,4,switzerland
Luzern,4,1,1,2,4,6,-2,4,switzerland
Grasshopper,4,1,0,3,6,7,-1,3,switzerland
Lausanne Ouchy,4,1,0,3,5,8,-3,3,switzerland
Lugano,4,1,0,3,7,11,-4,3,switzerland
St. Gallen,4,0,2,2,3,5,-2,2,switzerland
Yverdon,4,0,2,2,4,10,-6,2,switzerland
Lausanne Sport,4,0,1,3,5,8,-3,1,switzerland
FC Basel,4,0,0,4,4,11,-7,0,switzerland
Foutoua,4,4,0,0,7,2,5,12,syria
Al Ittihad,4,3,1,0,4,1,3,10,syria
Teshrin,4,2,1,1,3,2,1,7,syria
Al Jaish,4,1,2,1,4,4,0,5,syria
Karama,4,1,1,2,6,4,2,4,syria
Hottin,4,1,1,2,4,3,1,4,syria
Taliya,4,0,4,0,3,3,0,4,syria
Wathbah,4,1,1,2,2,4,-2,4,syria
Jabala,4,0,3,1,3,4,-1,3,syria
Majd,4,1,0,3,5,9,-4,3,syria
Al Wahda,4,0,2,2,3,5,-2,2,syria
Al-Jazira,0,0,0,0,0,0,0,0,syria
Simba,3,3,0,0,9,4,5,9,tanzania
S. Big Star,4,2,0,2,5,6,-1,6,tanzania
KMC,4,1,2,1,3,7,-4,5,tanzania
Azam,3,1,1,1,3,3,0,4,tanzania
Kagera Sugar,4,1,1,2,3,3,0,4,tanzania
Geita Gold,4,1,1,2,2,4,-2,4,tanzania
JKT Tanzania,4,1,1,2,3,8,-5,4,tanzania
Young Africans,2,1,0,1,4,2,2,3,tanzania
T. Prisons,4,0,2,2,3,7,-4,2,tanzania
Coastal Union,4,0,2,2,2,6,-4,2,tanzania
Kitayosce,4,0,2,2,0,5,-5,2,tanzania
Mtibwa Sugar,2,0,1,1,3,4,-1,1,tanzania
Namungo,2,0,1,1,1,2,-1,1,tanzania
Dodoma Jiji,3,0,1,2,3,6,-3,1,tanzania
Mashujaa,3,0,1,2,0,3,-3,1,tanzania
Ihefu,2,0,0,2,0,3,-3,0,tanzania
Buriram Utd,4,2,2,0,3,1,2,8,thailand
Pathum Utd,4,2,1,1,6,5,1,7,thailand
Bangkok Utd,2,2,0,0,6,1,5,6,thailand
Port FC,4,2,0,2,10,6,4,6,thailand
Muang Thong Utd,4,2,0,2,7,8,-1,6,thailand
Uthai Thani,4,2,0,2,5,6,-1,6,thailand
Chiangrai Utd,4,1,1,2,3,4,-1,4,thailand
Nakhon Pathom,4,1,1,2,7,9,-2,4,thailand
Sukhothai,4,1,0,3,4,9,-5,3,thailand
Police Tero,3,1,0,2,4,10,-6,3,thailand
Khon Kaen Utd,4,1,0,3,6,13,-7,3,thailand
Chonburi,3,0,2,1,6,7,-1,2,thailand
Ratchaburi,4,0,2,2,3,5,-2,2,thailand
Prachuap,4,0,2,2,5,8,-3,2,thailand
Trat,4,0,1,3,1,10,-9,1,thailand
Lamphun Warrior,4,0,0,4,2,10,-8,0,thailand
Ayutthaya Utd,4,3,0,1,7,2,5,9,thailand2
Rayong,4,2,1,1,9,2,7,7,thailand2
Pattaya United,4,2,1,1,8,5,3,7,thailand2
N. Ratchasima,4,2,1,1,5,3,2,7,thailand2
Nakhon Si Thamm,4,2,1,1,7,7,0,7,thailand2
N. Bua Pitchaya,4,2,0,2,6,7,-1,6,thailand2
Phrae Utd,4,2,0,2,4,6,-2,6,thailand2
Chiangmai Utd,4,1,2,1,6,5,1,5,thailand2
Kanchanaburi,4,1,2,1,4,4,0,5,thailand2
Suphanburi,4,1,2,1,3,3,0,5,thailand2
Chiangmai FC,4,1,2,1,1,1,0,5,thailand2
Lampang,4,1,2,1,6,7,-1,5,thailand2
Customs Utd,4,1,2,1,3,8,-5,5,thailand2
Chanthaburi,4,1,1,2,8,9,-1,4,thailand2
Samut Prakan,4,1,1,2,5,7,-2,4,thailand2
Chainat,4,0,2,2,0,4,-4,2,thailand2
Kasetsart,4,0,1,3,3,11,-8,1,thailand2
Krabi,3,0,0,3,3,12,-9,0,thailand2
Galatasaray,4,4,0,0,8,1,7,12,turkey
Fenerbahce,4,4,0,0,6,0,6,12,turkey
Kasimpasa,4,2,2,0,7,5,2,8,turkey
Sivasspor,4,2,1,1,7,6,1,7,turkey
Rizespor,4,2,0,2,6,11,-5,6,turkey
Konyaspor,4,1,2,1,4,5,-1,5,turkey
Basaksehir,4,1,2,1,2,4,-2,5,turkey
Ankaragucu,4,1,1,2,6,6,0,4,turkey
F. Karagumruk,4,1,1,2,4,4,0,4,turkey
Antalyaspor,4,1,1,2,5,6,-1,4,turkey
Pendikspor,4,1,1,2,4,7,-3,4,turkey
Trabzonspor,4,1,0,3,7,7,0,3,turkey
Hatayspor,4,0,3,1,2,4,-2,3,turkey
Besiktas,4,1,0,3,5,9,-4,3,turkey
Gaziantep,4,1,0,3,2,7,-5,3,turkey
Adana Demirspor,4,0,2,2,5,8,-3,2,turkey
Kayserispor,4,0,2,2,3,7,-4,2,turkey
Alanyaspor,4,0,2,2,1,6,-5,2,turkey
Istanbulspor,3,0,1,2,1,5,-4,1,turkey
Samsunspor,4,0,0,4,3,9,-6,0,turkey
Goztepe,4,3,1,0,4,0,4,10,turkey2
Eyupspor,4,3,0,1,11,5,6,9,turkey2
Kocaelispor,4,3,0,1,6,3,3,9,turkey2
Corum,4,2,1,1,6,3,3,7,turkey2
Bandirmaspor,4,2,1,1,4,3,1,7,turkey2
Genclerbirligi,4,2,1,1,4,5,-1,7,turkey2
Manisa BB,4,1,2,1,5,5,0,5,turkey2
Keciorengucu,4,1,2,1,1,3,-2,5,turkey2
Boluspor,4,1,1,2,2,3,-1,4,turkey2
Bodrumspor,4,1,1,2,3,5,-2,4,turkey2
Sakaryaspor,4,1,1,2,3,5,-2,4,turkey2
Umraniyespor,4,1,1,2,4,7,-3,4,turkey2
Erzurum BB,4,0,3,1,1,2,-1,3,turkey2
Giresunspor,4,1,0,3,6,10,-4,3,turkey2
Tuzlaspor,4,1,0,3,3,7,-4,3,turkey2
Sanliurfaspor,4,0,2,2,2,7,-5,2,turkey2
Altay,4,0,1,3,2,10,-8,1,turkey2
Adanaspor,4,0,0,4,1,6,-5,0,turkey2
Al Sharjah,3,3,0,0,8,4,4,9,uae
Al Wasl,3,2,1,0,11,4,7,7,uae
Shabab Al Ahli,3,2,1,0,6,1,5,7,uae
Al Jazira,2,2,0,0,7,1,6,6,uae
Al Ain,3,2,0,1,5,3,2,6,uae
Al Nasr,3,1,1,1,8,7,1,4,uae
Ittihad Kalba,3,1,1,1,6,5,1,4,uae
Emirates,3,1,1,1,2,1,1,4,uae
Al Bataeh,2,1,0,1,3,4,-1,3,uae
Al Wahda,3,1,0,2,4,6,-2,3,uae
Ajman,4,0,3,1,6,12,-6,3,uae
Bani Yas,2,0,0,2,4,6,-2,0,uae
Al Khaleej,2,0,0,2,2,5,-3,0,uae
Hatta,3,0,0,3,2,5,-3,0,uae
Emirates,4,3,0,1,12,5,7,9,uae2
Al Fujairah,4,3,0,1,10,3,7,9,uae2
Hatta,4,3,0,1,11,6,5,9,uae2
Dibba Al Hisn,4,3,0,1,8,5,3,9,uae2
Gulf Heroes,4,2,2,0,7,4,3,8,uae2
Masfut,4,2,1,1,6,6,0,7,uae2
Fursan Hispania,4,2,1,1,5,5,0,7,uae2
Al Urooba,4,2,0,2,7,6,1,6,uae2
Al Jazira Al H.,4,2,0,2,9,10,-1,6,uae2
Al Arabi,4,1,1,2,7,8,-1,4,uae2
Al Hamriyah,4,1,1,2,7,8,-1,4,uae2
Masafi,4,1,1,2,7,11,-4,4,uae2
Al Taawon,4,1,1,2,5,9,-4,4,uae2
Al Thaid,4,1,0,3,2,10,-8,3,uae2
Dubai City,4,0,2,2,6,10,-4,2,uae2
Al Ramms,4,0,0,4,3,8,-5,0,uae2
Baynounah SC,4,0,0,4,4,14,-10,0,uae2
Kryvbas KR,4,3,1,0,10,2,8,10,ukraine
Dnipro-1,4,3,1,0,6,3,3,10,ukraine
Rukh Lviv,4,3,0,1,10,5,5,9,ukraine
Shakhtar,4,2,2,0,10,5,5,8,ukraine
Polessya,4,2,1,1,6,1,5,7,ukraine
Vorskla Poltava,4,2,1,1,4,4,0,7,ukraine
Dynamo Kyiv,4,2,0,2,12,10,2,6,ukraine
Kolos Kovalivka,4,1,3,0,3,2,1,6,ukraine
Obolon,4,2,0,2,3,4,-1,6,ukraine
Zorya Luhansk,4,1,2,1,6,5,1,5,ukraine
Metalist 1925,4,1,1,2,2,3,-1,4,ukraine
Chornomorets,4,1,0,3,7,7,0,3,ukraine
Oleksandria,4,0,2,2,2,5,-3,2,ukraine
FC Minaj,4,0,2,2,2,6,-4,2,ukraine
LNZ Cherkasy,4,0,2,2,0,5,-5,2,ukraine
Veres,4,0,1,3,1,6,-5,1,ukraine
Wanderers,4,3,1,0,6,2,4,10,uruguay
Nacional,4,2,2,0,7,2,5,8,uruguay
Defensor S.,4,2,1,1,6,2,4,7,uruguay
Penarol,4,2,1,1,4,2,2,7,uruguay
Racing CM,4,2,0,2,6,4,2,6,uruguay
Montevideo City,4,2,0,2,6,5,1,6,uruguay
La Luz,4,1,2,1,3,4,-1,5,uruguay
Cerro Largo,4,1,2,1,2,3,-1,5,uruguay
Liverpool M.,4,1,1,2,4,5,-1,4,uruguay
D. Maldonado,4,1,1,2,6,9,-3,4,uruguay
Boston River,4,0,3,1,4,5,-1,3,uruguay
Cerro,4,0,3,1,3,6,-3,3,uruguay
River Plate,4,0,3,1,3,6,-3,3,uruguay
Fenix,4,1,0,3,3,8,-5,3,uruguay
Plaza Colonia,4,0,2,2,3,9,-6,2,uruguay
Danubio,4,0,0,4,3,9,-6,0,uruguay
Cerro,3,2,1,0,3,1,2,7,uruguay2
River Plate,4,2,1,1,4,5,-1,7,uruguay2
Liverpool M.,3,2,0,1,4,2,2,6,uruguay2
Wanderers,3,2,0,1,4,4,0,6,uruguay2
Defensor S.,4,1,2,1,4,4,0,5,uruguay2
Fenix,4,1,2,1,4,4,0,5,uruguay2
Danubio,4,1,1,2,4,4,0,4,uruguay2
Montevideo City,4,1,1,2,4,5,-1,4,uruguay2
Boston River,3,1,0,2,3,5,-2,3,uruguay2
D. Maldonado,4,1,0,3,5,10,-5,3,uruguay2
Racing CM,4,1,0,3,4,9,-5,3,uruguay2
Cerro Largo,3,0,2,1,3,4,-1,2,uruguay2
Nacional,3,0,2,1,3,6,-3,2,uruguay2
Plaza Colonia,4,0,2,2,4,10,-6,2,uruguay2
Penarol,3,0,1,2,2,4,-2,1,uruguay2
La Luz,3,0,1,2,0,7,-7,1,uruguay2
New York RB,4,3,1,0,8,4,4,10,usa
Orlando City,4,3,0,1,4,2,2,9,usa
Dallas,4,2,2,0,8,3,5,8,usa
Seattle,4,2,2,0,5,2,3,8,usa
Cincinnati,4,2,2,0,7,5,2,8,usa
Real Salt Lake,4,2,1,1,5,4,1,7,usa
Nashville SC,4,1,3,0,4,1,3,6,usa
Los Angeles FC,4,1,3,0,5,3,2,6,usa
Sporting KC,4,2,0,2,7,9,-2,6,usa
Houston Dynamo,4,1,2,1,5,4,1,5,usa
Columbus Crew,4,1,2,1,7,7,0,5,usa
Portland,4,1,2,1,8,10,-2,5,usa
St. Louis City,4,1,2,1,5,7,-2,5,usa
Charlotte,4,1,1,2,5,7,-2,4,usa
Chicago Fire,4,1,1,2,1,4,-3,4,usa
Atlanta Utd,4,0,3,1,7,8,-1,3,usa
Austin,4,0,3,1,4,5,-1,3,usa
SJ Earthquakes,4,0,3,1,3,4,-1,3,usa
Philadelphia,4,0,2,2,5,8,-3,2,usa
Vancouver,4,0,2,2,4,8,-4,2,usa
DC United,4,0,2,2,2,6,-4,2,usa
New England,4,0,1,3,7,10,-3,1,usa
LA Galaxy,4,0,1,3,8,14,-6,1,usa
New York City,4,0,1,3,2,8,-6,1,usa
Minnesota Utd,4,0,1,3,6,13,-7,1,usa
Colorado Rapids,4,0,1,3,4,11,-7,1,usa
Inter Miami,4,0,1,3,4,11,-7,1,usa
CF Montreal,4,0,0,4,2,11,-9,0,usa
Toronto,4,0,0,4,0,13,-13,0,usa
Colorado S.,4,3,0,1,8,4,4,9,usa2
Pittsburgh,4,2,2,0,4,1,3,8,usa2
Tampa Bay,4,2,1,1,10,8,2,7,usa2
San Diego Loyal,4,2,1,1,5,3,2,7,usa2
Orange County,4,2,1,1,7,6,1,7,usa2
FC Tulsa,4,2,0,2,9,7,2,6,usa2
Miami FC,4,2,0,2,5,4,1,6,usa2
Sacramento R.,4,2,0,2,5,6,-1,6,usa2
El Paso,4,2,0,2,3,6,-3,6,usa2
Detroit City,4,2,0,2,6,10,-4,6,usa2
Indy Eleven,4,1,2,1,8,8,0,5,usa2
Memphis,4,1,2,1,7,8,-1,5,usa2
Phoenix Rising,4,1,2,1,4,5,-1,5,usa2
Rio Grande,4,1,2,1,4,5,-1,5,usa2
New Mexico,4,1,1,2,3,4,-1,4,usa2
Charleston,4,1,1,2,5,7,-2,4,usa2
Monterey Bay,4,1,1,2,4,8,-4,4,usa2
Louisville City,4,1,0,3,6,9,-3,3,usa2
Birmingham L.,4,1,0,3,2,6,-4,3,usa2
San Antonio,4,0,2,2,4,6,-2,2,usa2
Las Vegas L.,4,0,2,2,6,9,-3,2,usa2
Hartford A.,4,0,1,3,3,10,-7,1,usa2
Loudoun Utd,4,0,0,4,3,8,-5,0,usa2
Oakland Roots,4,0,0,4,5,12,-7,0,usa2
North Carolina,4,4,0,0,8,0,8,12,usa3
Union Omaha,4,3,1,0,9,3,6,10,usa3
N. Colorado,4,3,1,0,6,1,5,10,usa3
Greenville,4,3,1,0,7,4,3,10,usa3
Tormenta,4,2,1,1,6,5,1,7,usa3
Lexington,4,0,3,1,7,8,-1,3,usa3
Central Valley,4,1,0,3,8,11,-3,3,usa3
Chattanooga RW,4,1,0,3,7,11,-4,3,usa3
One Knoxville,4,0,2,2,2,4,-2,2,usa3
Charlotte,4,0,2,2,6,11,-5,2,usa3
Richmond K.,4,0,1,3,3,7,-4,1,usa3
Forward Madison,4,0,1,3,5,11,-6,1,usa3
Nasaf Qarshi,4,2,1,1,5,3,2,7,uzbekistan
Bunyodkor,4,2,1,1,4,4,0,7,uzbekistan
Navbahor,4,2,0,2,7,5,2,6,uzbekistan
AMGK,4,1,3,0,5,4,1,6,uzbekistan
Qizilqum,4,1,3,0,4,3,1,6,uzbekistan
Termez Surkhon,4,1,3,0,3,2,1,6,uzbekistan
Pakhtakor,4,1,2,1,4,4,0,5,uzbekistan
Neftchi,4,1,2,1,3,4,-1,5,uzbekistan
Metallurg,4,1,1,2,5,6,-1,4,uzbekistan
Andijan,4,1,1,2,3,5,-2,4,uzbekistan
Buxoro,4,1,1,2,2,5,-3,4,uzbekistan
FK Olympic,4,1,0,3,4,6,-2,3,uzbekistan
Sogdiana,4,0,0,4,5,11,-6,0,uzbekistan
Turan,4,0,0,4,0,11,-11,0,uzbekistan
D. Tachira,4,3,1,0,6,3,3,10,venezuela
Rayo Zuliano,4,2,1,1,5,3,2,7,venezuela
Zamora,4,2,1,1,6,7,-1,7,venezuela
Carabobo,4,1,2,1,3,2,1,5,venezuela
Portuguesa,4,1,2,1,6,8,-2,5,venezuela
Caracas,4,0,4,0,2,2,0,4,venezuela
Angostura,4,1,1,2,4,6,-2,4,venezuela
UCV,4,0,3,1,1,2,-1,3,venezuela
Puerto Cabello,4,1,0,3,5,7,-2,3,venezuela
E. Merida,4,1,0,3,2,4,-2,3,venezuela
D. La Guaira,4,0,2,2,6,8,-2,2,venezuela
H. Colmenares,4,0,2,2,2,4,-2,2,venezuela
Monagas,4,0,1,3,3,7,-4,1,venezuela
Metropolitanos,4,0,1,3,4,10,-6,1,venezuela
M. de Guayana,4,0,1,3,1,7,-6,1,venezuela
Cong An Nhan,4,3,0,1,6,2,4,9,vietnam
Ha Noi,4,2,1,1,8,6,2,7,vietnam
The Cong,4,2,1,1,4,3,1,7,vietnam
Thanh Hoa,4,1,3,0,4,1,3,6,vietnam
Nam Dinh,4,2,0,2,4,4,0,6,vietnam
Song Lam Nghe,4,2,0,2,3,6,-3,6,vietnam
Binh Duong,4,1,2,1,3,2,1,5,vietnam
Da Nang,4,1,1,2,3,3,0,4,vietnam
Hai Phong,4,1,1,2,3,5,-2,4,vietnam
Binh Dinh,4,1,1,2,4,7,-3,4,vietnam
Ho Chi Minh,4,1,1,2,1,5,-4,4,vietnam
H. A. Gia Lai,4,1,0,3,3,6,-3,3,vietnam
S. Khanh Hoa,4,0,2,2,0,4,-4,2,vietnam
Hong Linh Ha T.,4,0,2,2,2,8,-6,2,vietnam
Pho Hien,4,3,0,1,10,4,6,9,vietnam2
Long An,4,1,3,0,5,3,2,6,vietnam2
Binh Thuan,4,2,0,2,5,13,-8,6,vietnam2
Quang Nam,4,1,1,2,10,6,4,4,vietnam2
Hoa Binh,4,1,1,2,3,5,-2,4,vietnam2
Phu Dong,4,1,1,2,4,7,-3,4,vietnam2
Phu Tho,4,0,2,2,5,8,-3,2,vietnam2
Hue,4,0,1,3,2,8,-6,1,vietnam2
Ba Ria Vung Tau,4,0,1,3,1,8,-7,1,vietnam2
Binh Phuoc,4,0,0,4,2,8,-6,0,vietnam2
The New Saints,4,4,0,0,18,5,13,12,wales
Connah`s Quay,4,3,1,0,11,3,8,10,wales
Newtown,4,3,0,1,10,4,6,9,wales
Caernarfon Town,4,2,0,2,9,9,0,6,wales
Colwyn Bay,4,1,0,3,3,5,-2,3,wales
Penybont,4,1,0,3,7,10,-3,3,wales
Aberystwyth,4,1,0,3,2,9,-7,3,wales
Bala Town,4,0,2,2,2,5,-3,2,wales
Haverfordwest,4,0,1,3,2,10,-8,1,wales
Cardiff MU,4,0,1,3,4,13,-9,1,wales
Barry Town,4,0,0,4,1,6,-5,0,wales
Pontypridd Town,4,0,0,4,0,9,-9,0,wales
