Equipe,GP,W,D,L,GF,GA,GD,Pts,albania2
Bylis,4,4,0,0,8,3,5,12,albania2
Vora,4,3,0,1,7,5,2,9,albania2
Apolonia Fier,4,2,1,1,7,2,5,7,albania2
Lushnja,4,2,1,1,5,3,2,7,albania2
Flamurtari,4,2,1,1,4,3,1,7,albania2
AF Elbasani,4,2,0,2,8,4,4,6,albania2
Burreli,4,2,0,2,5,4,1,6,albania2
Korabi Peshkopi,4,2,0,2,3,3,0,6,albania2
Besa Kavaje,4,1,1,2,6,8,-2,4,albania2
Kastrioti Kruje,4,1,0,3,5,9,-4,3,albania2
Tomori Berat,4,0,2,2,3,10,-7,2,albania2
Luzi 2008,4,0,0,4,1,8,-7,0,albania2
MC Alger,4,3,0,1,12,5,7,9,algeria
Khenchela,4,3,0,1,6,6,0,9,algeria
Paradou AC,3,2,1,0,6,0,6,7,algeria
ASO Chlef,4,2,1,1,5,3,2,7,algeria
JS Kabylie,4,2,1,1,3,2,1,7,algeria
JS Saoura,4,2,1,1,3,4,-1,7,algeria
CR Belouizdad,3,2,0,1,6,3,3,6,algeria
CS Constantine,4,2,0,2,5,3,2,6,algeria
El Bayadh,4,2,0,2,3,4,-1,6,algeria
NC Magra,4,1,1,2,2,3,-1,4,algeria
US Souf,4,1,1,2,2,6,-4,4,algeria
USM Alger,3,1,0,2,3,2,1,3,algeria
ES Setif,3,1,0,2,5,7,-2,3,algeria
MC Oran,4,0,3,1,1,3,-2,3,algeria
US Biskra,4,1,0,3,4,9,-5,3,algeria
Ben Aknoun,4,0,1,3,2,8,-6,1,algeria
Mostaganem,3,3,0,0,7,1,6,9,algeria2
GC Mascara,3,2,1,0,5,2,3,7,algeria2
Khemis El K.,3,2,1,0,3,0,3,7,algeria2
MSP Batna,3,2,1,0,3,1,2,7,algeria2
RC Kouba,3,2,1,0,3,1,2,7,algeria2
Oued Akbou,3,2,0,1,9,4,5,6,algeria2
ASM Oran,3,2,0,1,6,2,4,6,algeria2
Koléa,3,2,0,1,5,1,4,6,algeria2
CA Batna,3,1,2,0,4,1,3,5,algeria2
Bordj Menaïel,3,1,2,0,3,1,2,5,algeria2
El Eulma,3,1,2,0,2,0,2,5,algeria2
Teleghma,2,1,1,0,3,2,1,4,algeria2
WA Boufarik,3,1,1,1,3,2,1,4,algeria2
MO Constantine,3,1,1,1,3,3,0,4,algeria2
Hussein Dey,3,1,1,1,2,2,0,4,algeria2
Temouchent,3,1,1,1,1,1,0,4,algeria2
Chelghoum,3,1,1,1,3,4,-1,4,algeria2
RB Ouargla,3,1,1,1,1,2,-1,4,algeria2
Olympique Medea,3,1,1,1,2,5,-3,4,algeria2
Tiaret,3,1,1,1,2,5,-3,4,algeria2
Khemis Melina,3,1,0,2,7,5,2,3,algeria2
WA Mostaganem,3,1,0,2,5,6,-1,3,algeria2
Oued Sly,3,1,0,2,2,6,-4,3,algeria2
Mechria,3,0,2,1,2,3,-1,2,algeria2
Khroub,3,0,2,1,1,2,-1,2,algeria2
El Ghozlane,3,0,2,1,2,4,-2,2,algeria2
Annaba,3,0,2,1,1,6,-5,2,algeria2
Mlila,2,0,1,1,0,1,-1,1,algeria2
Ghir Abadla,3,0,1,2,1,4,-3,1,algeria2
UE Santa Coloma,4,4,0,0,10,3,7,12,andorra
FC Santa Coloma,4,3,0,1,11,1,10,9,andorra
Inter Escaldes,4,3,0,1,12,5,7,9,andorra
Penya Encarnada,4,3,0,1,7,5,2,9,andorra
A. Escaldes,4,2,0,2,10,4,6,6,andorra
Ordino,4,2,0,2,9,3,6,6,andorra
Pas de la Casa,4,2,0,2,7,10,-3,6,andorra
Esperanca,4,1,0,3,4,12,-8,3,andorra
A. America,4,0,0,4,1,10,-9,0,andorra
Carroi,4,0,0,4,2,20,-18,0,andorra
Boca Juniors,4,4,0,0,8,2,6,12,argentina
A. Tucuman,4,3,1,0,5,0,5,10,argentina
Tigre,4,3,0,1,6,2,4,9,argentina
River Plate,4,2,2,0,8,5,3,8,argentina
Estudiantes,4,2,1,1,8,5,3,7,argentina
Argentinos Jrs,4,2,1,1,5,3,2,7,argentina
Rosario Central,4,1,3,0,6,4,2,6,argentina
Banfield,4,1,3,0,4,2,2,6,argentina
Union Santa Fe,4,1,3,0,2,0,2,6,argentina
T. de Cordoba,4,1,3,0,4,3,1,6,argentina
Instituto,4,2,0,2,6,6,0,6,argentina
Huracan,4,2,0,2,2,2,0,6,argentina
Defensa y J.,4,1,2,1,7,6,1,5,argentina
Lanus,4,1,2,1,7,6,1,5,argentina
Racing Club,4,1,2,1,5,4,1,5,argentina
Newells,4,1,2,1,4,3,1,5,argentina
Godoy Cruz,4,1,2,1,7,7,0,5,argentina
Arsenal Sarandi,4,1,2,1,2,2,0,5,argentina
Platense,4,1,2,1,2,2,0,5,argentina
Barracas C.,4,1,2,1,1,2,-1,5,argentina
San Lorenzo,4,1,1,2,1,4,-3,4,argentina
Velez Sarsfield,4,0,3,1,2,3,-1,3,argentina
Independiente,4,1,0,3,1,5,-4,3,argentina
Gimnasia,4,0,2,2,4,8,-4,2,argentina
Sarmiento,4,0,2,2,1,5,-4,2,argentina
Belgrano,4,0,2,2,0,5,-5,2,argentina
Colon Santa Fe,4,0,1,3,1,6,-5,1,argentina
Central Cordoba,4,0,0,4,1,8,-7,0,argentina
Atletico Mitre,4,4,0,0,8,1,7,12,argentina3
CA Guemes,4,3,1,0,6,2,4,10,argentina3
Chaco For Ever,4,3,1,0,6,2,4,10,argentina3
E. Rio Cuarto,4,3,0,1,6,3,3,9,argentina3
Racing Cordoba,4,3,0,1,6,4,2,9,argentina3
Agropecuario,4,2,2,0,6,2,4,8,argentina3
Almirante Brown,4,2,2,0,3,0,3,8,argentina3
I. Rivadavia,4,2,2,0,3,1,2,8,argentina3
G. Mendoza,4,2,1,1,11,6,5,7,argentina3
Quilmes,4,2,1,1,9,5,4,7,argentina3
SM San Juan,4,2,1,1,7,4,3,7,argentina3
D. Riestra,4,2,1,1,5,2,3,7,argentina3
Nueva Chicago,4,2,1,1,4,3,1,7,argentina3
Ferro Carril,4,1,3,0,5,3,2,6,argentina3
Chacarita J.,4,1,3,0,6,5,1,6,argentina3
San Telmo,4,2,0,2,6,6,0,6,argentina3
D. de Belgrano,4,2,0,2,4,4,0,6,argentina3
Gimnasia Jujuy,4,2,0,2,4,4,0,6,argentina3
Tristan Suarez,4,2,0,2,6,7,-1,6,argentina3
Guillermo Brown,4,2,0,2,4,7,-3,6,argentina3
Deportivo Maipu,4,1,2,1,4,4,0,5,argentina3
Flandria,4,1,2,1,3,5,-2,5,argentina3
Almagro,4,1,1,2,6,7,-1,4,argentina3
Alvarado,4,1,1,2,6,7,-1,4,argentina3
All Boys,4,1,1,2,3,4,-1,4,argentina3
Defensores U.,4,1,1,2,6,8,-2,4,argentina3
Patronato,4,1,1,2,4,6,-2,4,argentina3
Temperley,4,1,1,2,4,6,-2,4,argentina3
Deportivo Moron,4,0,3,1,2,3,-1,3,argentina3
Pyunik,4,3,1,0,13,4,9,10,armenia
Ararat-Armenia,4,3,1,0,11,2,9,10,armenia
Noah,4,3,0,1,8,3,5,9,armenia
Shirak,4,2,1,1,7,5,2,7,armenia
Alashkert,4,2,0,2,6,6,0,6,armenia
Ararat Yerevan,4,2,0,2,4,5,-1,6,armenia
Urartu,4,1,1,2,5,7,-2,4,armenia
BKMA,4,1,0,3,4,8,-4,3,armenia
West Armenia,4,1,0,3,4,10,-6,3,armenia
Van,4,1,0,3,3,11,-8,3,armenia
Wellington,3,2,1,0,7,3,4,7,australia
Macarthur FC,3,2,1,0,4,2,2,7,australia
Adelaide Utd,2,2,0,0,9,0,9,6,australia
Melbourne V.,2,2,0,0,7,3,4,6,australia
Western Sydney,2,1,1,0,5,0,5,4,australia
Brisbane Roar,3,1,1,1,6,6,0,4,australia
Melbourne City,3,1,0,2,3,8,-5,3,australia
Western United,3,1,0,2,2,7,-5,3,australia
Perth Glory,2,0,1,1,3,4,-1,1,australia
Newcastle Jets,2,0,1,1,5,7,-2,1,australia
Central Coast,2,0,0,2,1,5,-4,0,australia
Sydney FC,3,0,0,3,0,7,-7,0,australia
Austria Wien,4,3,1,0,7,0,7,10,austria
Sturm Graz,4,3,0,1,5,3,2,9,austria
A. Klagenfurt,4,2,2,0,6,4,2,8,austria
Salzburg,4,2,1,1,9,3,6,7,austria
Hartberg,4,2,1,1,8,2,6,7,austria
LASK Linz,4,2,1,1,6,5,1,7,austria
Rapid Wien,4,1,2,1,10,6,4,5,austria
BW Linz,4,1,2,1,2,4,-2,5,austria
Wolfsberger AC,4,1,1,2,3,5,-2,4,austria
Altach,4,0,2,2,0,4,-4,2,austria
A. Lustenau,4,0,1,3,0,13,-13,1,austria
Tirol,4,0,0,4,0,7,-7,0,austria
Ried,4,3,1,0,13,4,9,10,austria2
Stripfing,4,3,1,0,11,3,8,10,austria2
Grazer AK,4,3,1,0,6,2,4,10,austria2
Kapfenberger,4,2,2,0,7,4,3,8,austria2
Leoben,4,2,2,0,8,6,2,8,austria2
Bregenz,4,2,1,1,6,4,2,7,austria2
First Vienna,4,2,1,1,8,8,0,7,austria2
Sturm Graz B,4,2,1,1,9,10,-1,7,austria2
Admira Wacker,4,1,2,1,4,4,0,5,austria2
Floridsdorfer,4,1,2,1,4,4,0,5,austria2
Lafnitz,4,1,1,2,6,7,-1,4,austria2
Liefering,4,0,3,1,4,6,-2,3,austria2
SV Horn,4,1,0,3,3,7,-4,3,austria2
Amstetten,4,0,2,2,5,7,-2,2,austria2
St. Polten,4,0,1,3,4,10,-6,1,austria2
Dornbirn,4,0,0,4,6,11,-5,0,austria2
Araz,4,3,1,0,8,3,5,10,azerbaijan
Qarabag,4,2,1,1,10,4,6,7,azerbaijan
Sabah,4,2,1,1,5,3,2,7,azerbaijan
Sebail,4,2,1,1,7,7,0,7,azerbaijan
Sumqayit,4,2,1,1,3,3,0,7,azerbaijan
Neftci,4,2,0,2,5,5,0,6,azerbaijan
Zira,4,1,2,1,4,4,0,5,azerbaijan
Turan,4,1,1,2,8,6,2,4,azerbaijan
Qabala,4,1,1,2,2,5,-3,4,azerbaijan
Kapaz,4,0,1,3,0,6,-6,1,azerbaijan
B. Police,4,4,0,0,15,5,10,12,bangladesh
Bashundhara K.,4,4,0,0,12,6,6,12,bangladesh
Mohammedan,4,3,0,1,11,3,8,9,bangladesh
Sheikh Russel,4,2,2,0,6,3,3,8,bangladesh
Abahani,4,2,1,1,5,2,3,7,bangladesh
Chittagong,4,1,2,1,7,7,0,5,bangladesh
Fortis,4,1,1,2,4,4,0,4,bangladesh
Sheikh Jamal,4,1,0,3,4,10,-6,3,bangladesh
Rahmatgonj,4,0,2,2,3,7,-4,2,bangladesh
A. Uttara,4,0,1,3,2,11,-9,1,bangladesh
Muktijoddha S.,4,0,0,4,5,13,-8,0,bangladesh
Dinamo Minsk,4,3,0,1,7,3,4,9,belarus
BATE Borisov,4,3,0,1,8,5,3,9,belarus
Isloch,4,2,2,0,7,2,5,8,belarus
Neman Grodno,4,2,2,0,7,3,4,8,belarus
T. Zhodino,4,2,2,0,4,2,2,8,belarus
S. Soligorsk,4,2,1,1,9,5,4,7,belarus
Dinamo Brest,4,2,1,1,8,6,2,7,belarus
Gomel,4,2,0,2,7,6,1,6,belarus
Energetik-BGU,4,2,0,2,6,8,-2,6,belarus
Slutsk,4,1,2,1,4,4,0,5,belarus
FC Minsk,4,1,1,2,3,4,-1,4,belarus
Naftan,4,1,1,2,6,8,-2,4,belarus
Slavia Mozyr,4,1,1,2,4,6,-2,4,belarus
Smorgon,4,1,0,3,5,10,-5,3,belarus
Belshina,4,0,0,4,2,12,-10,0,belarus
Vitebsk,4,3,1,0,9,1,8,10,belarus2
Dnepr Mogilev,4,3,1,0,8,1,7,10,belarus2
Arsenal D.,4,3,0,1,13,5,8,9,belarus2
Zhodino Yuzhnoe,4,3,0,1,12,4,8,9,belarus2
Volna Pinsk,4,2,1,1,9,6,3,7,belarus2
Niva,4,2,1,1,7,7,0,7,belarus2
Bumprom,4,2,1,1,5,7,-2,7,belarus2
S.Petrikov,4,2,0,2,6,6,0,6,belarus2
Molodechno-DYuS,4,1,2,1,7,7,0,5,belarus2
Orsha,4,1,1,2,7,6,1,4,belarus2
Slonim,4,1,1,2,4,8,-4,4,belarus2
Baranovichi,4,1,0,3,4,8,-4,3,belarus2
Maxline,4,1,0,3,8,13,-5,3,belarus2
Lokomotiv Gomel,4,0,2,2,2,7,-5,2,belarus2
FC Ostrovets,4,0,2,2,1,7,-6,2,belarus2
Lida,4,0,2,2,6,13,-7,2,belarus2
Osipovichy,4,0,0,4,1,7,-6,0,belarus2
Royale Union SG,4,4,0,0,14,3,11,12,belgium
Anderlecht,4,3,0,1,13,6,7,9,belgium
Cercle Brugge,4,3,0,1,8,4,4,9,belgium
Standard Liege,4,3,0,1,8,7,1,9,belgium
KRC Genk,4,2,2,0,11,4,7,8,belgium
Charleroi,4,2,0,2,6,8,-2,6,belgium
Kortrijk,4,2,0,2,3,5,-2,6,belgium
Gent,4,1,2,1,5,5,0,5,belgium
Westerlo,4,1,2,1,6,7,-1,5,belgium
Antwerp,4,1,1,2,7,6,1,4,belgium
Club Brugge,4,1,1,2,4,5,-1,4,belgium
Eupen,4,1,1,2,5,9,-4,4,belgium
Sint-Truiden,4,1,1,2,3,10,-7,4,belgium
OH Leuven,4,1,0,3,8,10,-2,3,belgium
RWDM,4,0,2,2,4,6,-2,2,belgium
KV Mechelen,4,0,1,3,1,9,-8,1,belgium
Real Tomayapo,4,4,0,0,8,3,5,12,bolivia
The Strongest,4,3,1,0,9,3,6,10,bolivia
Bolivar,4,3,0,1,13,6,7,9,bolivia
Oriente P.,4,2,2,0,8,2,6,8,bolivia
Wilstermann,4,2,1,1,6,3,3,7,bolivia
Santa Cruz,4,2,1,1,6,4,2,7,bolivia
Libertad,4,2,1,1,7,6,1,7,bolivia
U. de Vinto,4,1,3,0,3,1,2,6,bolivia
Aurora,4,1,2,1,5,5,0,5,bolivia
A. Palmaflor,4,1,1,2,5,6,-1,4,bolivia
Guabira,4,1,1,2,4,5,-1,4,bolivia
Vaca Diez,4,1,1,2,4,5,-1,4,bolivia
Nacional Potosi,4,1,1,2,7,9,-2,4,bolivia
Always Ready,4,1,1,2,3,8,-5,4,bolivia
Royal Pari,4,0,3,1,6,7,-1,3,bolivia
I. Petrolero,4,1,0,3,4,8,-4,3,bolivia
Blooming,4,0,1,3,3,7,-4,1,bolivia
Guabira,4,3,0,1,7,5,2,9,bolivia2
Santa Cruz,4,3,0,1,7,7,0,9,bolivia2
I. Petrolero,4,2,2,0,8,5,3,8,bolivia2
The Strongest,4,2,1,1,13,9,4,7,bolivia2
Royal Pari,4,2,1,1,6,4,2,7,bolivia2
U. de Vinto,4,2,1,1,5,3,2,7,bolivia2
Nacional Potosi,4,2,0,2,11,8,3,6,bolivia2
Always Ready,4,2,0,2,5,5,0,6,bolivia2
Bolivar,4,1,2,1,9,8,1,5,bolivia2
Oriente P.,4,1,2,1,8,8,0,5,bolivia2
Real Tomayapo,4,1,2,1,3,3,0,5,bolivia2
Blooming,4,1,2,1,2,2,0,5,bolivia2
Wilstermann,4,1,0,3,3,6,-3,3,bolivia2
Aurora,4,0,2,2,3,6,-3,2,bolivia2
A. Palmaflor,4,0,2,2,4,10,-6,2,bolivia2
U. Sucre,4,0,1,3,5,10,-5,1,bolivia2
Palmeiras,4,4,0,0,12,3,9,12,brazil
Atletico MG,4,3,0,1,7,3,4,9,brazil
Bragantino,4,3,0,1,7,3,4,9,brazil
Gremio,4,3,0,1,9,9,0,9,brazil
Corinthians,4,2,2,0,4,2,2,8,brazil
Internacional,4,2,1,1,13,7,6,7,brazil
Sao Paulo,4,2,1,1,5,6,-1,7,brazil
Santos,4,2,1,1,6,10,-4,7,brazil
Flamengo,4,2,0,2,6,5,1,6,brazil
Cruzeiro,4,2,0,2,4,3,1,6,brazil
Bahia,4,2,0,2,3,4,-1,6,brazil
Athletico PR,4,1,2,1,5,5,0,5,brazil
Vasco da Gama,4,1,1,2,4,4,0,4,brazil
Botafogo,4,1,1,2,6,7,-1,4,brazil
Cuiaba,4,1,1,2,2,4,-2,4,brazil
Fluminense,4,1,0,3,5,7,-2,3,brazil
Coritiba,4,1,0,3,6,9,-3,3,brazil
Fortaleza,4,1,0,3,4,8,-4,3,brazil
America MG,4,0,2,2,7,9,-2,2,brazil
Goias,4,0,2,2,5,9,-4,2,brazil
Ludogorets,4,3,1,0,9,1,8,10,bulgaria
CSKA 1948 Sofia,4,2,2,0,4,2,2,8,bulgaria
CSKA Sofia,4,2,2,0,4,2,2,8,bulgaria
Botev Plovdiv,4,2,1,1,11,4,7,7,bulgaria
Hebar,4,2,1,1,7,5,2,7,bulgaria
Beroe,4,2,1,1,4,3,1,7,bulgaria
Slavia Sofia,4,2,0,2,3,3,0,6,bulgaria
Cherno More,4,1,2,1,4,4,0,5,bulgaria
Levski Sofia,4,1,2,1,3,3,0,5,bulgaria
L. Krumovgrad,4,1,2,1,1,2,-1,5,bulgaria
Lokomotiv Sofia,4,1,2,1,1,6,-5,5,bulgaria
Etar,4,1,1,2,4,7,-3,4,bulgaria
Lok. Plovdiv,4,0,3,1,4,5,-1,3,bulgaria
Arda,4,0,3,1,0,1,-1,3,bulgaria
Pirin Blag.,4,0,1,3,2,8,-6,1,bulgaria
Botev Vratsa,4,0,0,4,5,10,-5,0,bulgaria
Vancouver FC,4,3,0,1,6,4,2,9,canada
Cavalry,4,2,0,2,7,5,2,6,canada
Forge,4,2,0,2,5,5,0,6,canada
HFX Wanderers,4,2,0,2,4,4,0,6,canada
York Utd,4,2,0,2,4,6,-2,6,canada
A. Ottawa,4,1,0,3,3,5,-2,3,canada
Valour,4,1,0,3,2,4,-2,3,canada
Pacific,4,1,0,3,3,7,-4,3,canada
Huachipato,4,3,1,0,9,5,4,10,chile
Nublense,4,3,0,1,7,2,5,9,chile
Cobresal,4,3,0,1,7,10,-3,9,chile
Colo-Colo,4,2,1,1,9,3,6,7,chile
U. Catolica,4,2,1,1,7,4,3,7,chile
Copiapo,4,2,1,1,6,4,2,7,chile
Palestino,4,2,1,1,6,5,1,7,chile
Coquimbo Unido,4,2,0,2,8,8,0,6,chile
Audax Italiano,4,2,0,2,4,5,-1,6,chile
Everton,4,1,1,2,7,6,1,4,chile
U. de Chile,4,1,1,2,5,6,-1,4,chile
Union La Calera,4,1,1,2,5,7,-2,4,chile
Magallanes,4,1,0,3,4,7,-3,3,chile
O`Higgins,4,1,0,3,4,7,-3,3,chile
Union Espanola,4,0,2,2,6,9,-3,2,chile
Curico Unido,4,0,1,3,4,10,-6,1,chile
S. Morning,4,3,0,1,6,2,4,9,chile2
Cobreloa,4,3,0,1,5,3,2,9,chile2
San Marcos,4,2,2,0,11,9,2,8,chile2
Barnechea,4,2,1,1,8,5,3,7,chile2
D. Iquique,4,2,1,1,6,5,1,7,chile2
Deportes Temuco,4,2,1,1,5,4,1,7,chile2
Rangers,4,2,1,1,5,4,1,7,chile2
S. Wanderers,4,2,1,1,4,3,1,7,chile2
Recoleta,4,2,0,2,5,5,0,6,chile2
U. Concepcion,4,1,2,1,5,6,-1,5,chile2
Puerto Montt,4,1,2,1,3,5,-2,5,chile2
San Luis,4,1,1,2,8,5,3,4,chile2
La Serena,4,1,1,2,1,6,-5,4,chile2
CD Santa Cruz,4,0,1,3,5,8,-3,1,chile2
U. San Felipe,4,0,1,3,1,4,-3,1,chile2
Antofagasta,4,0,1,3,4,9,-5,1,chile2
Zhejiang,4,3,1,0,15,2,13,10,china
Chengdu,4,3,1,0,11,5,6,10,china
S. Shenhua,4,3,1,0,5,1,4,10,china
Tianjin T.,4,2,2,0,8,4,4,8,china
S. Taishan,4,2,2,0,6,2,4,8,china
Beijing Guoan,4,2,1,1,7,5,2,7,china
Wuhan Three T.,4,2,0,2,5,4,1,6,china
Henan SL,4,1,2,1,7,4,3,5,china
Changchun Yatai,4,1,2,1,3,5,-2,5,china
Meizhou Hakka,4,1,2,1,2,5,-3,5,china
Shanghai Port,4,1,1,2,4,5,-1,4,china
Qingdao Jonoon,4,1,1,2,6,8,-2,4,china
Nantong Zhiyun,4,1,0,3,5,5,0,3,china
Dalian P.,4,0,2,2,3,7,-4,2,china
Shenzhen,4,0,0,4,0,11,-11,0,china
Cangzhou,4,0,0,4,1,15,-14,0,china
Sichuan Jiuniu,4,4,0,0,9,0,9,12,china2
Guangxi Baoyun,4,2,2,0,7,3,4,8,china2
Hebei Kungfu,4,2,2,0,5,3,2,8,china2
Qingdao Y. I.,4,2,1,1,5,2,3,7,china2
Yanbian Longdin,4,2,1,1,6,4,2,7,china2
Dantong Hantong,4,2,1,1,5,4,1,7,china2
Wuxi Wugou,4,2,1,1,5,7,-2,7,china2
Jiangxi L.,4,2,0,2,7,6,1,6,china2
Jinan Xingzhou,4,1,2,1,3,3,0,5,china2
Shenyang Urban,4,1,1,2,4,5,-1,4,china2
Nanjing,4,1,1,2,1,2,-1,4,china2
Shanghai Jiadin,4,1,1,2,3,6,-3,4,china2
Heilongjiang L.,4,1,0,3,3,5,-2,3,china2
Guangzhou FC,4,1,0,3,3,6,-3,3,china2
Dongguan United,4,1,0,3,1,6,-5,3,china2
Suzhou Dongwu,4,0,1,3,1,6,-5,1,china2
I. Medelin,4,3,1,0,5,1,4,10,colombia2
Junior,4,3,0,1,6,3,3,9,colombia2
Deportes Tolima,4,3,0,1,4,3,1,9,colombia2
R. Aguilas,4,2,2,0,7,2,5,8,colombia2
America de Cali,4,2,2,0,3,1,2,8,colombia2
La Equidad,4,2,1,1,5,4,1,7,colombia2
Deportivo Cali,4,2,1,1,4,3,1,7,colombia2
A. Nacional,4,2,0,2,7,5,2,6,colombia2
A. Bucaramanga,4,2,0,2,5,5,0,6,colombia2
Millonarios,4,1,2,1,5,5,0,5,colombia2
Envigado,4,1,1,2,9,9,0,4,colombia2
Deportivo Pasto,4,1,1,2,3,3,0,4,colombia2
Boyaca Chico,4,1,1,2,4,6,-2,4,colombia2
D. Pereira,4,1,1,2,1,3,-2,4,colombia2
Jaguares de C.,4,1,1,2,1,3,-2,4,colombia2
A. Petrolera,4,1,0,3,1,6,-5,3,colombia2
Once Caldas,4,0,2,2,2,4,-2,2,colombia2
Atletico Huila,4,0,2,2,5,8,-3,2,colombia2
Union Magdalena,4,0,1,3,4,8,-4,1,colombia2
Santa Fe,4,0,1,3,4,11,-7,1,colombia2
Saprissa,4,3,0,1,10,4,6,9,costarica
Herediano,4,3,0,1,8,3,5,9,costarica
Alajuelense,4,3,0,1,5,2,3,9,costarica
Santos DG,4,2,2,0,4,1,3,8,costarica
M. Liberia,4,2,1,1,8,7,1,7,costarica
Sporting SJ,4,2,1,1,6,5,1,7,costarica
Guanacasteca,4,2,1,1,4,6,-2,7,costarica
Cartagines,4,2,0,2,8,8,0,6,costarica
AD Grecia,4,1,1,2,5,5,0,4,costarica
San Carlos,4,1,0,3,6,8,-2,3,costarica
Zeledon,4,1,0,3,3,8,-5,3,costarica
Puntarenas,4,0,0,4,4,10,-6,0,costarica
Slavia Prague,4,3,1,0,7,2,5,10,czechrepublic
Sparta Prague,4,3,0,1,10,5,5,9,czechrepublic
Karvina,4,3,0,1,7,3,4,9,czechrepublic
Mlada Boleslav,4,3,0,1,14,11,3,9,czechrepublic
Banik Ostrava,4,2,1,1,5,2,3,7,czechrepublic
Jablonec,4,2,0,2,5,4,1,6,czechrepublic
Pardubice,4,1,3,0,4,3,1,6,czechrepublic
Sigma Olomouc,4,1,2,1,5,4,1,5,czechrepublic
Slovan Liberec,4,1,1,2,8,9,-1,4,czechrepublic
Hradec Kralove,4,1,1,2,3,5,-2,4,czechrepublic
Slovacko,4,1,1,2,3,5,-2,4,czechrepublic
Bohemians,4,1,1,2,2,4,-2,4,czechrepublic
C. Budejovice,4,1,1,2,2,6,-4,4,czechrepublic
Zlin,4,0,3,1,6,10,-4,3,czechrepublic
Viktoria Plzen,4,1,0,3,4,8,-4,3,czechrepublic
Teplice,4,0,1,3,0,4,-4,1,czechrepublic
Brondby IF,4,3,1,0,8,3,5,10,denmark
FC Midtjylland,4,3,1,0,8,4,4,10,denmark
Silkeborg,4,2,1,1,7,2,5,7,denmark
FC Kobenhavn,4,2,1,1,7,4,3,7,denmark
AGF Aarhus,4,2,1,1,6,4,2,7,denmark
Vejle BK,4,1,2,1,5,4,1,5,denmark
Randers FC,4,1,2,1,6,6,0,5,denmark
Nordsjaelland,4,1,1,2,3,3,0,4,denmark
Odense BK,4,1,1,2,3,4,-1,4,denmark
Viborg,4,1,1,2,3,5,-2,4,denmark
Lyngby,4,1,0,3,3,10,-7,3,denmark
Hvidovre,4,0,0,4,2,12,-10,0,denmark
SonderjyskE,4,4,0,0,11,1,10,12,denmark2
Aalborg BK,4,4,0,0,10,3,7,12,denmark2
Hillerod,4,2,2,0,7,2,5,8,denmark2
Vendsyssel,4,2,1,1,5,5,0,7,denmark2
Hobro,4,2,0,2,3,3,0,6,denmark2
Kolding IF,4,2,0,2,6,8,-2,6,denmark2
Fredericia,4,1,2,1,9,7,2,5,denmark2
Naestved,4,1,1,2,5,8,-3,4,denmark2
AC Horsens,4,1,0,3,7,10,-3,3,denmark2
HB Koge,4,1,0,3,6,11,-5,3,denmark2
Helsingor,4,0,1,3,3,6,-3,1,denmark2
B 93,4,0,0,4,1,13,-12,0,denmark2
Cuniburo,4,3,1,0,10,5,5,10,ecuador3
America de Q.,4,3,1,0,7,3,4,10,ecuador3
Chacaritas,4,3,0,1,8,4,4,9,ecuador3
Nueve Octubre,4,2,1,1,5,3,2,7,ecuador3
Imbabura,4,1,3,0,7,3,4,6,ecuador3
Vargas Torres,4,1,2,1,3,3,0,5,ecuador3
Manta,4,1,1,2,5,5,0,4,ecuador3
I. Juniors,4,1,1,2,6,8,-2,4,ecuador3
Macara,4,0,0,4,3,11,-8,0,ecuador3
Guayaquil,4,0,0,4,2,11,-9,0,ecuador3
Al Masry,4,3,0,1,7,4,3,9,egypt
Future FC,4,3,0,1,6,3,3,9,egypt
Pyramids FC,4,3,0,1,5,4,1,9,egypt
Al Ittihad,4,2,2,0,8,6,2,8,egypt
Ceramica C.,4,2,1,1,8,3,5,7,egypt
ENPPI,4,2,1,1,5,3,2,7,egypt
Al Ahly,2,2,0,0,7,1,6,6,egypt
Zamalek,4,2,0,2,9,6,3,6,egypt
ZED FC,4,1,3,0,9,8,1,6,egypt
Baladiyyat,4,1,2,1,7,7,0,5,egypt
El Gouna,4,1,2,1,4,4,0,5,egypt
Ismaily,4,1,1,2,4,5,-1,4,egypt
Pharco,4,1,1,2,3,4,-1,4,egypt
El Geish,4,1,1,2,1,3,-2,4,egypt
Smouha,4,1,1,2,4,8,-4,4,egypt
Al Mokawloon,4,0,2,2,7,9,-2,2,egypt
El Daklyeh,4,0,1,3,2,9,-7,1,egypt
National Bank,4,0,0,4,3,8,-5,0,egypt
Tottenham,4,4,0,0,7,2,5,12,england
Aston Villa,4,3,1,0,14,4,10,10,england
Arsenal,4,3,1,0,12,2,10,10,england
Newcastle Utd,4,2,2,0,10,4,6,8,england
Wolverhampton,4,2,2,0,7,5,2,8,england
Liverpool,4,2,1,1,8,4,4,7,england
Brentford,4,2,1,1,7,3,4,7,england
Chelsea,4,2,1,1,8,5,3,7,england
Manchester City,4,2,0,2,6,4,2,6,england
Everton,4,2,0,2,5,4,1,6,england
Manchester Utd,4,2,0,2,4,6,-2,6,england
West Ham Utd,4,1,1,2,5,7,-2,4,england
Fulham,4,1,1,2,4,6,-2,4,england
Crystal Palace,4,1,1,2,2,6,-4,4,england
Nottm Forest,4,0,3,1,3,6,-3,3,england
Burnley,4,1,0,3,4,10,-6,3,england
Bournemouth,4,1,0,3,3,10,-7,3,england
Brighton,4,0,2,2,5,11,-6,2,england
Luton Town,4,0,1,3,4,8,-4,1,england
Sheffield Utd,4,0,0,4,2,12,-10,0,england
Ipswich Town,4,4,0,0,11,4,7,12,england2
Blackburn,4,3,0,1,7,2,5,9,england2
Leeds Utd,4,3,0,1,8,4,4,9,england2
Middlesbrough,4,3,0,1,7,3,4,9,england2
Leicester City,4,3,0,1,6,3,3,9,england2
Stoke City,4,3,0,1,5,3,2,9,england2
Southampton,4,2,2,0,8,5,3,8,england2
Watford,4,2,2,0,5,3,2,8,england2
Cardiff City,4,2,1,1,7,2,5,7,england2
Hull City,4,2,1,1,6,4,2,7,england2
West Brom,4,2,1,1,5,3,2,7,england2
Swansea City,4,2,0,2,5,5,0,6,england2
Plymouth,4,1,1,2,6,6,0,4,england2
Rotherham,4,1,1,2,4,5,-1,4,england2
Sheffield Wed,4,1,1,2,2,4,-2,4,england2
Huddersfield,4,1,1,2,3,9,-6,4,england2
Millwall,4,0,3,1,6,7,-1,3,england2
Birmingham City,4,1,0,3,4,7,-3,3,england2
Bristol City,4,1,0,3,2,5,-3,3,england2
Sunderland,4,1,0,3,4,8,-4,3,england2
Preston,4,0,2,2,5,8,-3,2,england2
Norwich City,4,0,1,3,5,9,-4,1,england2
Coventry City,4,0,1,3,1,6,-5,1,england2
QP Rangers,4,0,0,4,2,10,-8,0,england2
Peterborough,4,3,1,0,9,4,5,10,england3
Portsmouth,4,3,1,0,6,2,4,10,england3
Wigan Athletic,4,3,0,1,8,3,5,9,england3
Bolton,4,3,0,1,9,6,3,9,england3
Barnsley,4,2,2,0,7,3,4,8,england3
Burton Albion,4,2,1,1,6,3,3,7,england3
Cheltenham,4,2,1,1,6,5,1,7,england3
Lincoln City,4,2,1,1,5,4,1,7,england3
Derby County,4,2,0,2,7,4,3,6,england3
Charlton,4,2,0,2,8,7,1,6,england3
Leyton Orient,4,1,3,0,4,3,1,6,england3
Fleetwood,4,1,2,1,7,7,0,5,england3
Oxford Utd,4,1,2,1,5,5,0,5,england3
Cambridge Utd,4,1,2,1,1,1,0,5,england3
Blackpool,4,1,2,1,9,10,-1,5,england3
Stevenage,4,1,2,1,4,5,-1,5,england3
Bristol Rovers,4,1,1,2,5,8,-3,4,england3
Shrewsbury,4,1,1,2,2,6,-4,4,england3
Wycombe,4,0,3,1,6,8,-2,3,england3
Carlisle Utd,4,1,0,3,2,4,-2,3,england3
Port Vale,4,0,1,3,1,5,-4,1,england3
Exeter City,4,0,1,3,1,6,-5,1,england3
Northampton,4,0,1,3,4,10,-6,1,england3
Reading,4,0,0,4,4,11,-7,0,england3
Stockport,4,4,0,0,10,3,7,12,england4
Mansfield,4,3,1,0,10,3,7,10,england4
Wrexham,4,3,1,0,8,4,4,10,england4
Morecambe,4,3,0,1,8,4,4,9,england4
Accrington,4,3,0,1,7,3,4,9,england4
Crewe Alexandra,4,3,0,1,7,4,3,9,england4
Doncaster,4,3,0,1,7,5,2,9,england4
Barrow,4,2,2,0,3,0,3,8,england4
Milton Keynes,4,2,1,1,9,6,3,7,england4
Forest Green,4,2,0,2,8,5,3,6,england4
Notts County,4,2,0,2,6,7,-1,6,england4
Colchester Utd,4,2,0,2,5,9,-4,6,england4
Walsall,4,1,2,1,9,7,2,5,england4
Salford City,4,1,2,1,7,5,2,5,england4
Swindon Town,4,1,1,2,6,6,0,4,england4
Newport,4,1,1,2,5,8,-3,4,england4
Bradford,4,1,1,2,4,7,-3,4,england4
Sutton Utd,4,1,0,3,6,10,-4,3,england4
Harrogate,4,1,0,3,4,9,-5,3,england4
Gillingham,4,1,0,3,3,8,-5,3,england4
Crawley Town,4,0,1,3,4,8,-4,1,england4
AFC Wimbledon,4,0,1,3,3,9,-6,1,england4
Grimsby,4,0,0,4,4,9,-5,0,england4
Tranmere,4,0,0,4,1,7,-6,0,england4
Chesterfield,4,4,0,0,11,1,10,12,england5
Southend Utd,4,3,1,0,11,1,10,10,england5
Barnet,4,3,1,0,9,5,4,10,england5
Bromley,4,3,1,0,8,4,4,10,england5
Halifax Town,4,3,1,0,7,3,4,10,england5
Aldershot Town,4,3,0,1,8,5,3,9,england5
Altrincham,4,2,2,0,7,4,3,8,england5
AFC Fylde,4,2,1,1,8,4,4,7,england5
Dagenham & R.,4,2,1,1,5,5,0,7,england5
Rochdale,4,1,2,1,10,10,0,5,england5
Boreham Wood,4,1,2,1,5,5,0,5,england5
Oldham,4,1,2,1,7,9,-2,5,england5
Wealdstone,4,1,1,2,4,4,0,4,england5
Maidenhead Utd,4,1,1,2,9,11,-2,4,england5
Kidderminster,4,1,1,2,4,6,-2,4,england5
Gateshead FC,4,1,1,2,4,9,-5,4,england5
Solihull Moors,4,1,1,2,2,7,-5,4,england5
Hartlepool,4,1,0,3,7,8,-1,3,england5
Eastleigh,4,1,0,3,6,8,-2,3,england5
Dorking,4,1,0,3,5,7,-2,3,england5
Oxford City,4,1,0,3,5,8,-3,3,england5
Woking,4,1,0,3,2,5,-3,3,england5
York City,4,0,2,2,4,10,-6,2,england5
Ebbsfleet Utd,4,0,1,3,1,7,-6,1,england5
Flora,4,4,0,0,11,4,7,12,estonia
Tallinna Kalev,4,3,0,1,11,4,7,9,estonia
Paide,4,2,1,1,9,5,4,7,estonia
Levadia,4,2,1,1,7,6,1,7,estonia
Narva Trans,4,2,0,2,5,5,0,6,estonia
Kuressaare,4,2,0,2,2,4,-2,6,estonia
Nomme Kalju,4,1,2,1,9,9,0,5,estonia
Vaprus,4,0,3,1,1,2,-1,3,estonia
Harju Jalgpalli,4,0,1,3,2,9,-7,1,estonia
Tammeka,4,0,0,4,3,12,-9,0,estonia
Viimsi,4,4,0,0,12,3,9,12,estonia2
Nomme Utd,4,3,1,0,10,3,7,10,estonia2
Flora B,4,2,0,2,11,7,4,6,estonia2
Elva,4,2,0,2,6,7,-1,6,estonia2
Paide B,4,2,0,2,6,9,-3,6,estonia2
FC Tallinn,4,1,1,2,6,7,-1,4,estonia2
Levadia B,4,1,0,3,5,8,-3,3,estonia2
Alliance,4,1,0,3,6,10,-4,3,estonia2
Legion,4,1,0,3,8,14,-6,3,estonia2
Tabasalu,4,1,0,3,5,11,-6,3,estonia2
Vikingur,4,4,0,0,19,1,18,12,faroeislands
HB Torshavn,4,3,1,0,10,4,6,10,faroeislands
07 Vestur,4,2,0,2,4,6,-2,6,faroeislands
Klaksvik,4,1,2,1,7,3,4,5,faroeislands
AB Argir,4,1,2,1,7,7,0,5,faroeislands
IF Fuglafjordur,4,1,2,1,1,5,-4,5,faroeislands
B36 Torshavn,4,1,1,2,5,10,-5,4,faroeislands
Streymur,4,1,1,2,1,9,-8,4,faroeislands
B68 Toftir,4,0,3,1,5,8,-3,3,faroeislands
TB Tvoroyri,4,0,0,4,1,7,-6,0,faroeislands
Klaksvik B,4,4,0,0,22,1,21,12,faroeislands2
Skala,4,4,0,0,16,1,15,12,faroeislands2
B71 Sandur,4,3,1,0,11,3,8,10,faroeislands2
Hoyvik,4,3,0,1,5,2,3,9,faroeislands2
Vikingur B,4,2,0,2,9,7,2,6,faroeislands2
B36 Torshavn B,4,1,0,3,9,11,-2,3,faroeislands2
NSI Runavik,4,1,0,3,4,10,-6,3,faroeislands2
Streymur B,4,1,0,3,2,18,-16,3,faroeislands2
HB B,4,0,1,3,2,17,-15,1,faroeislands2
B68 Toftir B,4,0,0,4,3,15,-12,0,faroeislands2
Ilves,4,4,0,0,13,4,9,12,finland
VPS,4,3,1,0,9,3,6,10,finland
KuPS,4,3,1,0,7,3,4,10,finland
Haka,4,2,1,1,6,3,3,7,finland
Mariehamn,4,2,1,1,5,3,2,7,finland
HJK Helsinki,4,2,0,2,9,7,2,6,finland
Oulu,4,1,1,2,6,6,0,4,finland
SJK,4,1,1,2,5,7,-2,4,finland
Lahti,4,1,1,2,3,8,-5,4,finland
Honka,4,1,0,3,4,9,-5,3,finland
Inter Turku,4,0,1,3,2,7,-5,1,finland
KTP,4,0,0,4,0,9,-9,0,finland
Ekenas IF,4,3,1,0,9,4,5,10,finland2
JaPS,4,2,1,1,7,3,4,7,finland2
HIFK,4,2,1,1,10,8,2,7,finland2
Jaro,4,2,1,1,8,6,2,7,finland2
KaPa,4,2,1,1,6,4,2,7,finland2
Gnistan,4,1,3,0,9,8,1,6,finland2
KPV Kokkola,4,2,0,2,6,8,-2,6,finland2
SJK Akatemia,4,1,1,2,7,8,-1,4,finland2
SalPa,4,1,1,2,5,6,-1,4,finland2
Mikkelin,4,1,1,2,5,7,-2,4,finland2
JJK,4,1,0,3,3,8,-5,3,finland2
TPS,4,0,1,3,5,10,-5,1,finland2
Paris SG,4,4,0,0,12,3,9,12,france
Lille,4,3,1,0,6,1,5,10,france
Nice,4,3,1,0,3,0,3,10,france
Monaco,4,3,0,1,8,6,2,9,france
Lens,4,2,2,0,6,1,5,8,france
Reims,4,2,1,1,5,4,1,7,france
Montpellier,4,2,0,2,6,5,1,6,france
Nantes,4,2,0,2,5,8,-3,6,france
Toulouse,4,1,2,1,5,5,0,5,france
Rennes,4,1,1,2,6,7,-1,4,france
Clermont,4,1,1,2,3,4,-1,4,france
Lorient,4,1,1,2,5,8,-3,4,france
Marseille,4,1,0,3,5,8,-3,3,france
Brest,4,0,2,2,3,5,-2,2,france
Le Havre,4,0,2,2,0,5,-5,2,france
Lyon,4,0,1,3,4,8,-4,1,france
Strasbourg,4,0,1,3,2,7,-5,1,france
Metz,4,0,1,3,1,6,-5,1,france
Saint-Etienne,4,3,1,0,5,0,5,10,france2
Angers,4,3,0,1,8,3,5,9,france2
Auxerre,4,2,1,1,6,3,3,7,france2
AC Ajaccio,4,2,1,1,5,2,3,7,france2
Laval,4,2,1,1,2,1,1,7,france2
Concarneau,4,2,1,1,6,6,0,7,france2
Pau FC,4,2,1,1,6,6,0,7,france2
Guingamp,4,1,3,0,5,4,1,6,france2
Grenoble,4,1,2,1,9,8,1,5,france2
Rodez Aveyron,4,1,2,1,9,9,0,5,france2
Paris FC,4,1,2,1,7,7,0,5,france2
Annecy,4,1,2,1,6,6,0,5,france2
Quevilly Rouen,4,1,2,1,6,6,0,5,france2
SC Bastia,4,1,2,1,3,4,-1,5,france2
Valenciennes,4,0,3,1,6,7,-1,3,france2
Troyes,4,0,3,1,3,4,-1,3,france2
Caen,4,0,3,1,7,9,-2,3,france2
USL Dunkerque,4,1,0,3,5,9,-4,3,france2
Bordeaux,4,0,2,2,3,6,-3,2,france2
Amiens,4,0,2,2,2,6,-4,2,france2
Red Star,4,3,1,0,7,2,5,10,france3
Dijon,4,2,2,0,6,2,4,8,france3
Rouen,4,2,2,0,5,1,4,8,france3
Martigues,4,2,1,1,6,3,3,7,france3
Avranches,4,2,1,1,5,3,2,7,france3
Orleans,4,2,1,1,7,6,1,7,france3
Sochaux,4,1,3,0,9,7,2,6,france3
Niort,4,2,0,2,6,5,1,6,france3
Nimes,4,1,2,1,3,4,-1,5,france3
Marignane G.,4,0,4,0,2,2,0,4,france3
Versailles,4,1,1,2,5,6,-1,4,france3
G. O. A. L.,4,1,1,2,3,4,-1,4,france3
Epinal,4,1,1,2,6,8,-2,4,france3
Villefranche,4,1,1,2,5,7,-2,4,france3
Chateauroux,4,0,3,1,3,6,-3,3,france3
Cholet,4,1,0,3,3,6,-3,3,france3
Le Mans,4,1,0,3,3,8,-5,3,france3
Nancy,4,0,2,2,2,4,-2,2,france3
Torpedo Kutaisi,4,3,1,0,5,1,4,10,georgia
Dinamo Batumi,4,2,2,0,7,2,5,8,georgia
Dinamo Tbilisi,4,2,0,2,7,5,2,6,georgia
Gagra,4,2,0,2,6,6,0,6,georgia
Saburtalo,4,1,2,1,2,4,-2,5,georgia
Samgurali,4,1,1,2,6,4,2,4,georgia
Dila Gori,4,1,1,2,5,5,0,4,georgia
Samtredia,4,1,1,2,4,7,-3,4,georgia
Telavi,4,1,1,2,4,7,-3,4,georgia
Shukura,4,1,0,3,2,13,-11,3,georgia
Kolkheti Poti,4,4,0,0,12,0,12,12,georgia2
Gareji Sagarejo,4,3,1,0,13,2,11,10,georgia2
WIT Georgia,4,2,2,0,7,3,4,8,georgia2
L. Tbilisi,4,2,2,0,8,5,3,8,georgia2
Bolnisi,4,1,1,2,10,8,2,4,georgia2
Spaeri,4,1,1,2,8,10,-2,4,georgia2
Kolkheti Khobi,4,1,1,2,3,5,-2,4,georgia2
Merani Tbilisi,4,0,2,2,6,17,-11,2,georgia2
D. Tbilisi B,4,0,1,3,1,6,-5,1,georgia2
Merani Martvili,4,0,1,3,7,19,-12,1,georgia2
Leverkusen,4,4,0,0,10,2,8,12,germany
Bayern Munich,4,3,1,0,16,3,13,10,germany
Dortmund,4,3,1,0,11,6,5,10,germany
Stuttgart,4,3,0,1,10,4,6,9,germany
RB Leipzig,4,2,2,0,11,3,8,8,germany
E. Frankfurt,4,2,1,1,8,6,2,7,germany
Monchengladbach,4,2,1,1,8,7,1,7,germany
FC Augsburg,4,2,0,2,9,8,1,6,germany
Freiburg,4,2,0,2,5,6,-1,6,germany
Hoffenheim,4,2,0,2,8,10,-2,6,germany
Bochum,4,1,2,1,5,5,0,5,germany
Werder Bremen,4,1,0,3,6,8,-2,3,germany
Wolfsburg,4,1,0,3,6,8,-2,3,germany
Heidenheim,4,1,0,3,4,9,-5,3,germany
FC Koln,4,1,0,3,3,12,-9,3,germany
Darmstadt,4,1,0,3,4,14,-10,3,germany
FSV Mainz,4,0,2,2,5,10,-5,2,germany
Union Berlin,4,0,0,4,2,10,-8,0,germany
Sankt Pauli,4,3,1,0,11,4,7,10,germany2
Wehen Wiesbaden,4,3,1,0,7,2,5,10,germany2
FC Nurnberg,4,3,0,1,7,6,1,9,germany2
Hamburger SV,4,2,2,0,7,4,3,8,germany2
Greuther Furth,4,2,1,1,6,3,3,7,germany2
Dusseldorf,4,2,1,1,10,8,2,7,germany2
Paderborn,4,2,1,1,9,7,2,7,germany2
Elversberg,4,2,1,1,6,4,2,7,germany2
Holstein Kiel,4,2,1,1,6,4,2,7,germany2
Hannover 96,4,2,0,2,7,7,0,6,germany2
Hertha Berlin,4,2,0,2,7,7,0,6,germany2
Kaiserslautern,4,1,2,1,11,10,1,5,germany2
Karlsruher SC,4,1,1,2,5,5,0,4,germany2
Hansa Rostock,4,1,0,3,2,5,-3,3,germany2
Schalke 04,4,1,0,3,5,10,-5,3,germany2
Osnabruck,4,0,2,2,3,9,-6,2,germany2
Magdeburg,4,0,1,3,3,6,-3,1,germany2
Braunschweig,4,0,0,4,2,11,-9,0,germany2
Regensburg,4,4,0,0,10,5,5,12,germany3
Bielefeld,4,3,1,0,10,3,7,10,germany3
Dynamo Dresden,4,3,1,0,6,3,3,10,germany3
RW Essen,4,3,0,1,6,8,-2,9,germany3
Verl,4,2,2,0,10,5,5,8,germany3
Ulm,4,2,0,2,8,8,0,6,germany3
1860 Munchen,4,1,2,1,4,3,1,5,germany3
Viktoria Koln,4,1,2,1,7,7,0,5,germany3
Sandhausen,4,1,2,1,5,5,0,5,germany3
Saarbrucken,4,1,1,2,8,7,1,4,germany3
Preuss. Munster,4,1,1,2,6,5,1,4,germany3
Dortmund B,4,1,1,2,7,7,0,4,germany3
Erzgebirge Aue,4,1,1,2,5,6,-1,4,germany3
Unterhaching,4,1,1,2,3,4,-1,4,germany3
MSV Duisburg,4,1,1,2,2,3,-1,4,germany3
FC Ingolstadt,4,1,1,2,7,10,-3,4,germany3
Hallescher,4,1,0,3,6,10,-4,3,germany3
Freiburg B,4,1,0,3,1,5,-4,3,germany3
VfB Lubeck,4,1,0,3,4,9,-5,3,germany3
Mannheim,4,0,1,3,3,10,-7,1,germany3
Panathinaikos,4,3,1,0,15,2,13,10,greece
Lamia,4,3,1,0,5,2,3,10,greece
AEK Athens,4,3,0,1,8,2,6,9,greece
Olympiakos,4,3,0,1,9,4,5,9,greece
PAOK,4,2,1,1,7,4,3,7,greece
Aris,4,2,1,1,5,5,0,7,greece
Panserraikos,4,2,0,2,5,8,-3,6,greece
OFI Crete,4,1,2,1,3,3,0,5,greece
Atromitos,4,1,1,2,3,9,-6,4,greece
Kifisia,4,0,3,1,3,4,-1,3,greece
Panaitolikos,4,1,0,3,4,7,-3,3,greece
Volos,4,1,0,3,3,8,-5,3,greece
Asteras T.,4,0,1,3,1,8,-7,1,greece
PAS Giannina,4,0,0,4,3,10,-7,0,greece
Achuapa,4,3,1,0,7,3,4,10,guatemala
Comunicaciones,4,3,0,1,11,5,6,9,guatemala
Municipal,4,2,2,0,8,5,3,8,guatemala
Mixco,4,2,1,1,7,5,2,7,guatemala
Xelaju,4,2,1,1,3,2,1,7,guatemala
Guastatoya,4,2,0,2,6,3,3,6,guatemala
Zacapa Tellioz,4,2,0,2,8,7,1,6,guatemala
Xinabajul,4,2,0,2,4,5,-1,6,guatemala
Antigua GFC,4,1,2,1,9,8,1,5,guatemala
Coban Imperial,4,1,2,1,7,7,0,5,guatemala
Coatepecano IB,4,0,1,3,0,5,-5,1,guatemala
Malacateco,4,0,1,3,5,12,-7,1,guatemala
Marathon,4,4,0,0,7,3,4,12,honduras
Olimpia,4,3,1,0,8,2,6,10,honduras
Génesis,4,2,2,0,4,2,2,8,honduras
Motagua,4,2,0,2,8,6,2,6,honduras
UPNFM,4,2,0,2,4,5,-1,6,honduras
Olancho,4,1,2,1,3,3,0,5,honduras
Real Espana,4,1,1,2,5,7,-2,4,honduras
Victoria,4,0,2,2,1,3,-2,2,honduras
Real Sociedad,4,0,1,3,1,4,-3,1,honduras
Vida,4,0,1,3,2,8,-6,1,honduras
Wofoo Tai Po,4,4,0,0,6,0,6,12,hongkong
LM Warriors,4,3,1,0,13,5,8,10,hongkong
Kitchee,4,3,0,1,16,5,11,9,hongkong
Eastern,4,2,1,1,5,3,2,7,hongkong
HK Rangers,4,2,0,2,13,6,7,6,hongkong
Southern D.,4,2,0,2,10,5,5,6,hongkong
North District,2,1,1,0,5,2,3,4,hongkong
Hong Kong FC,4,1,1,2,2,11,-9,4,hongkong
Resources C.,4,1,0,3,2,13,-11,3,hongkong
HK U23,4,0,2,2,1,11,-10,2,hongkong
Sham Shui Po,4,0,0,4,2,9,-7,0,hongkong
Ferencvaros,4,3,1,0,13,4,9,10,hungary
Paks,4,3,1,0,11,5,6,10,hungary
MOL Fehervar,4,3,0,1,11,4,7,9,hungary
Ujpest,4,3,0,1,9,7,2,9,hungary
Puskas Akad.,4,2,2,0,8,2,6,8,hungary
Debrecen,4,1,2,1,7,6,1,5,hungary
Kecskemeti TE,4,1,1,2,8,10,-2,4,hungary
Zalaegerszegi,4,1,1,2,6,10,-4,4,hungary
Mezokovesd,4,1,0,3,4,6,-2,3,hungary
Kisvarda,4,1,0,3,4,8,-4,3,hungary
Diosgyor VTK,4,1,0,3,4,9,-5,3,hungary
MTK,4,0,0,4,1,15,-14,0,hungary
Gyori ETO,4,3,1,0,12,3,9,10,hungary2
Gyirmot,4,3,1,0,8,3,5,10,hungary2
Nyiregyhaza,4,3,0,1,7,4,3,9,hungary2
BVSC,4,3,0,1,4,3,1,9,hungary2
Kozarmisleny,4,2,1,1,9,6,3,7,hungary2
Vasas,4,2,1,1,9,6,3,7,hungary2
Kazincbarcika,4,2,1,1,4,3,1,7,hungary2
Szeged,4,1,3,0,4,3,1,6,hungary2
Tiszakecske,4,1,2,1,5,4,1,5,hungary2
Soroksar,4,1,2,1,3,4,-1,5,hungary2
Pecsi MFC,4,1,2,1,1,4,-3,5,hungary2
Honved,4,1,1,2,3,3,0,4,hungary2
Csakvari,4,1,1,2,3,4,-1,4,hungary2
Haladas,4,1,1,2,3,4,-1,4,hungary2
Siofok,4,1,0,3,3,5,-2,3,hungary2
MTE,4,1,0,3,3,10,-7,3,hungary2
Budafoki,4,0,1,3,2,8,-6,1,hungary2
Ajka,4,0,0,4,1,7,-6,0,hungary2
Stjarnan,4,4,0,0,10,2,8,12,iceland
KA Akureyri,4,3,0,1,7,4,3,9,iceland
Fylkir,4,2,1,1,12,8,4,7,iceland
Valur,4,2,1,1,11,10,1,7,iceland
Fram,4,2,1,1,7,8,-1,7,iceland
Vikingur R.,4,2,0,2,9,8,1,6,iceland
IBV,4,1,2,1,5,5,0,5,iceland
KR Reykjavik,4,1,1,2,7,10,-3,4,iceland
Keflavik,4,1,1,2,5,8,-3,4,iceland
Breidablik,4,1,0,3,8,11,-3,3,iceland
Hafnarfjordur,4,1,0,3,6,10,-4,3,iceland
HK Kopavogur,4,0,1,3,3,6,-3,1,iceland
IR Reykjavik,4,3,1,0,12,3,9,10,iceland3
Dalvik / Reynir,4,3,1,0,10,3,7,10,iceland3
Fjardabyggd,4,3,0,1,11,6,5,9,iceland3
Throttur Vogar,4,3,0,1,10,5,5,9,iceland3
V. Olafsvik,4,2,1,1,10,10,0,7,iceland3
Fjallabyggd,4,2,0,2,9,10,-1,6,iceland3
Haukar,4,2,0,2,6,7,-1,6,iceland3
Hottur / Huginn,4,2,0,2,5,9,-4,6,iceland3
KFG,4,1,0,3,8,9,-1,3,iceland3
Volsungur,4,1,0,3,6,8,-2,3,iceland3
Sindri,4,0,1,3,5,13,-8,1,iceland3
KV Reykjavik,4,0,0,4,3,12,-9,0,iceland3
Bengaluru,4,4,0,0,8,3,5,12,india
Jamshedpur,4,3,1,0,7,2,5,10,india
Chennaiyin,4,3,0,1,9,6,3,9,india
Odisha FC,4,2,1,1,7,5,2,7,india
ATK Mohun Bagan,4,2,1,1,4,2,2,7,india
Hyderabad,4,2,0,2,5,6,-1,6,india
Mumbai City,4,1,1,2,7,7,0,4,india
East Bengal,4,1,1,2,4,7,-3,4,india
Kerala Blasters,4,1,0,3,3,5,-2,3,india
NorthEast Utd,4,0,1,3,7,12,-5,1,india
Goa,4,0,1,3,6,11,-5,1,india
Bali Utd,4,4,0,0,9,2,7,12,indonesia
Borneo,4,3,1,0,8,2,6,10,indonesia
Persib,4,3,1,0,9,4,5,10,indonesia
R. Nusantara,4,2,2,0,6,4,2,8,indonesia
PSIS Semarang,4,2,1,1,7,6,1,7,indonesia
Dewa United,4,2,0,2,9,7,2,6,indonesia
Persik Kediri,4,1,2,1,8,7,1,5,indonesia
Persis Solo,4,1,2,1,7,7,0,5,indonesia
PSM,4,1,1,2,6,6,0,4,indonesia
Barito Putera,4,0,4,0,4,4,0,4,indonesia
Persija,4,1,1,2,6,7,-1,4,indonesia
Madura Utd,4,1,1,2,4,6,-2,4,indonesia
Arema,4,1,1,2,3,6,-3,4,indonesia
Persita,4,1,1,2,4,11,-7,4,indonesia
Bhayangkara S.,4,0,2,2,4,6,-2,2,indonesia
TIRA Persikabo,4,0,2,2,5,8,-3,2,indonesia
PSS Sleman,4,0,1,3,4,10,-6,1,indonesia
Persebaya S.,4,0,1,3,4,11,-7,1,indonesia
Esteghlal,4,3,1,0,7,4,3,10,iran
Mes Rafsanjan,4,3,0,1,6,2,4,9,iran
Persepolis,4,2,2,0,6,3,3,8,iran
Malavan,4,2,2,0,5,3,2,8,iran
Sepahan,4,2,1,1,10,6,4,7,iran
Shams A. Qazvin,4,2,1,1,7,6,1,7,iran
Zob Ahan,4,2,1,1,5,4,1,7,iran
Tractor Sazi,4,2,0,2,9,4,5,6,iran
Foolad,4,2,0,2,2,4,-2,6,iran
Paykan,4,1,1,2,2,4,-2,4,iran
Aluminium Arak,4,1,1,2,2,6,-4,4,iran
Gol Gohar,4,0,3,1,5,6,-1,3,iran
Sanat Naft,4,0,3,1,5,8,-3,3,iran
Havadar,4,0,2,2,5,7,-2,2,iran
E. Khuzestan,4,0,2,2,2,4,-2,2,iran
N. Mazandaran,4,0,1,3,1,6,-5,1,iran
Al Quwa Al J.,3,3,0,0,5,2,3,9,iraq
Duhok,2,2,0,0,3,0,3,6,iraq
Al Shorta,3,2,0,1,5,3,2,6,iraq
Al-Qasim,3,2,0,1,3,2,1,6,iraq
Al Najaf,3,1,2,0,3,1,2,5,iraq
Al Karkh,3,1,1,1,5,3,2,4,iraq
Al Kahrabaa,3,1,1,1,4,3,1,4,iraq
Al Hudod,2,1,1,0,3,2,1,4,iraq
Al Naft,2,1,1,0,3,2,1,4,iraq
Erbil,3,1,1,1,3,3,0,4,iraq
Al Zawraa,3,1,1,1,2,3,-1,4,iraq
Naft Al-Janoob,2,1,0,1,4,2,2,3,iraq
Newroz SC,3,1,0,2,3,3,0,3,iraq
Al Talaba,2,1,0,1,2,2,0,3,iraq
Naft Maysan,2,0,2,0,1,1,0,2,iraq
Karbala,2,0,1,1,3,4,-1,1,iraq
Zakho,2,0,1,1,2,3,-1,1,iraq
Naft Al-Wasat,3,0,1,2,2,5,-3,1,iraq
Baghdad,3,0,1,2,1,5,-4,1,iraq
Al Minaa Basra,3,0,0,3,2,10,-8,0,iraq
Shamrock Rovers,4,3,1,0,11,2,9,10,ireland
Shelbourne,4,3,1,0,8,4,4,10,ireland
Dundalk,4,3,0,1,9,2,7,9,ireland
Derry City,4,2,2,0,4,0,4,8,ireland
Bohemians,4,2,0,2,6,5,1,6,ireland
St. Patricks,4,2,0,2,3,5,-2,6,ireland
Cork City,4,1,1,2,2,5,-3,4,ireland
Drogheda Utd,4,0,2,2,2,9,-7,2,ireland
Sligo Rovers,4,0,1,3,2,7,-5,1,ireland
UC Dublin,4,0,0,4,4,12,-8,0,ireland
Galway Utd,4,4,0,0,15,2,13,12,ireland2
Bray Wanderers,4,2,2,0,6,4,2,8,ireland2
Finn Harps,4,2,1,1,7,5,2,7,ireland2
Treaty Utd,4,2,0,2,6,8,-2,6,ireland2
Cobh Ramblers,4,1,2,1,7,6,1,5,ireland2
Waterford,4,1,2,1,4,4,0,5,ireland2
Wexford,4,1,2,1,5,6,-1,5,ireland2
Kerry,4,0,2,2,4,6,-2,2,ireland2
Longford Town,4,0,2,2,4,7,-3,2,ireland2
Athlone Town,4,0,1,3,1,11,-10,1,ireland2
M. Tel Aviv,4,3,1,0,11,1,10,10,israel
M. Petah Tikva,4,2,2,0,11,6,5,8,israel
M. Bnei Raina,4,2,2,0,6,4,2,8,israel
Hapoel Haifa,4,2,1,1,7,5,2,7,israel
Maccabi Haifa,4,2,1,1,8,7,1,7,israel
Hapoel Tel Aviv,4,2,1,1,5,5,0,7,israel
B. Jerusalem,4,2,0,2,5,6,-1,6,israel
H. Beer Sheva,4,1,2,1,4,2,2,5,israel
Bnei Sakhnin,4,1,2,1,5,8,-3,5,israel
Maccabi Netanya,4,1,1,2,7,7,0,4,israel
H. Petah Tikva,4,1,1,2,3,7,-4,4,israel
Hapoel Hadera,4,1,0,3,2,7,-5,3,israel
Ashdod,4,0,1,3,2,6,-4,1,israel
H. Jerusalem,4,0,1,3,3,8,-5,1,israel
Kiryat Shmona,4,3,0,1,12,3,9,9,israel2
Bnei Yehuda,4,3,0,1,9,3,6,9,israel2
Ramat Hasharon,4,2,2,0,11,6,5,8,israel2
H. Ramat Gan,4,2,2,0,9,4,5,8,israel2
Kafr Qasim,4,2,2,0,6,3,3,8,israel2
Ironi Tiberias,4,2,1,1,6,6,0,7,israel2
H. Nof Hagalil,4,2,1,1,4,4,0,7,israel2
Maccabi Jaffa,4,2,0,2,9,8,1,6,israel2
M. Herziliya,4,1,1,2,4,8,-4,4,israel2
Nes Tziona,4,1,1,2,5,11,-6,4,israel2
H. Umm al-Fahm,4,0,3,1,4,5,-1,3,israel2
Hapoel Afula,4,0,3,1,3,7,-4,3,israel2
H. Kfar Saba,4,1,0,3,3,8,-5,3,israel2
Hapoel Akko,4,0,2,2,2,4,-2,2,israel2
H. Ironi Rishon,4,0,2,2,2,5,-3,2,israel2
Ihud B. Shfaram,4,0,0,4,3,10,-7,0,israel2
Inter Milan,4,3,1,0,10,2,8,10,italy
Juventus,4,3,1,0,4,0,4,10,italy
AS Roma,4,3,0,1,7,2,5,9,italy
Lazio,4,3,0,1,6,3,3,9,italy
Bologna,4,2,2,0,6,4,2,8,italy
Napoli,4,2,1,1,10,6,4,7,italy
Atalanta,4,2,1,1,7,3,4,7,italy
Monza,4,2,1,1,5,2,3,7,italy
AC Milan,4,2,1,1,5,3,2,7,italy
Fiorentina,4,2,0,2,6,4,2,6,italy
Udinese,4,0,4,0,4,4,0,4,italy
Genoa,4,1,1,2,3,5,-2,4,italy
Empoli,4,1,1,2,2,6,-4,4,italy
Torino,4,1,1,2,1,5,-4,4,italy
Cagliari,4,1,1,2,7,12,-5,4,italy
Frosinone,4,1,0,3,6,9,-3,3,italy
Sassuolo,4,0,2,2,2,5,-3,2,italy
Lecce,4,0,2,2,2,7,-5,2,italy
Hellas Verona,4,0,1,3,2,6,-4,1,italy
Salernitana,4,0,1,3,2,10,-8,1,italy
Catanzaro,4,3,0,1,6,2,4,9,italy2
Parma,4,3,0,1,9,6,3,9,italy2
Venezia,4,3,0,1,8,5,3,9,italy2
Palermo,4,2,1,1,7,5,2,7,italy2
Cosenza,4,2,1,1,5,3,2,7,italy2
Reggiana,4,2,1,1,5,4,1,7,italy2
Modena,4,2,1,1,4,4,0,7,italy2
Cremonese,4,2,0,2,6,5,1,6,italy2
Bari,4,1,3,0,5,4,1,6,italy2
Sudtirol,4,2,0,2,5,4,1,6,italy2
Spezia,4,1,3,0,4,3,1,6,italy2
Lecco,4,2,0,2,4,7,-3,6,italy2
Ascoli,4,1,2,1,5,5,0,5,italy2
Ternana,4,1,1,2,6,5,1,4,italy2
Cittadella,4,1,1,2,6,7,-1,4,italy2
Sampdoria,4,1,1,2,5,6,-1,4,italy2
Pisa,4,1,1,2,4,5,-1,4,italy2
Brescia,4,1,1,2,3,4,-1,4,italy2
Como,4,1,1,2,4,6,-2,4,italy2
FeralpiSalo,4,0,1,3,2,9,-7,1,italy2
Arnett Gardens,4,4,0,0,10,1,9,12,jamaica
Dunbeholden,4,3,0,1,13,4,9,9,jamaica
Cavalier,4,3,0,1,8,6,2,9,jamaica
Waterhouse,4,2,2,0,5,1,4,8,jamaica
Mount Pleasant,4,2,1,1,14,4,10,7,jamaica
Humble Lions,4,1,3,0,6,2,4,6,jamaica
Portmore Utd,4,1,2,1,5,4,1,5,jamaica
Harbour View,4,1,2,1,2,4,-2,5,jamaica
Molynes Utd,4,1,1,2,7,11,-4,4,jamaica
Tivoli Gardens,4,1,0,3,9,11,-2,3,jamaica
Montego Bay,4,1,0,3,5,9,-4,3,jamaica
Faulkland,4,0,2,2,6,9,-3,2,jamaica
Vere Utd,4,0,2,2,2,9,-7,2,jamaica
Chapelton,4,0,1,3,5,22,-17,1,jamaica
Vissel Kobe,4,3,1,0,7,2,5,10,japan
Albirex Niigata,4,3,1,0,8,4,4,10,japan
Yokohama M.,4,3,0,1,10,4,6,9,japan
Urawa RD,4,2,2,0,6,2,4,8,japan
K. Frontale,4,2,1,1,9,6,3,7,japan
S. Hiroshima,4,2,1,1,5,3,2,7,japan
Shonan Bellmare,4,2,1,1,4,3,1,7,japan
FC Tokyo,4,2,0,2,7,5,2,6,japan
Sagan Tosu,4,1,2,1,7,7,0,5,japan
Nagoya G.,4,1,2,1,4,5,-1,5,japan
Yokohama FC,4,1,1,2,4,6,-2,4,japan
Cerezo Osaka,4,1,1,2,1,3,-2,4,japan
C. Sapporo,4,1,1,2,5,8,-3,4,japan
Kashiwa Reysol,4,1,1,2,4,7,-3,4,japan
Avispa Fukuoka,4,1,1,2,5,9,-4,4,japan
Kyoto Sanga,4,1,0,3,3,5,-2,3,japan
Kashima Antlers,4,0,2,2,2,5,-3,2,japan
Gamba Osaka,4,0,0,4,1,8,-7,0,japan
M. Yamagata,4,4,0,0,8,2,6,12,japan2
Machida Zelvia,4,3,1,0,9,4,5,10,japan2
Shimizu S-Pulse,4,3,0,1,13,4,9,9,japan2
Ventforet Kofu,4,2,2,0,8,4,4,8,japan2
Tokyo Verdy,4,2,2,0,5,3,2,8,japan2
Jubilo Iwata,4,2,1,1,9,2,7,7,japan2
JEF Utd Chiba,4,2,1,1,9,4,5,7,japan2
V-V. Nagasaki,4,2,1,1,9,5,4,7,japan2
Fujieda MYFC,4,2,1,1,8,4,4,7,japan2
Tokushima V.,4,2,1,1,3,4,-1,7,japan2
Omiya Ardija,4,2,0,2,5,9,-4,6,japan2
R. Yamaguchi,4,1,2,1,7,7,0,5,japan2
Oita Trinita,4,1,2,1,5,5,0,5,japan2
Vegalta Sendai,4,1,2,1,5,5,0,5,japan2
Kusatsu,4,1,1,2,4,8,-4,4,japan2
Blaublitz Akita,4,1,0,3,4,5,-1,3,japan2
R. Kumamoto,4,1,0,3,3,7,-4,3,japan2
Fagiano Okayama,4,0,3,1,3,8,-5,3,japan2
Tochigi SC,4,0,2,2,3,6,-3,2,japan2
Z. Kanazawa,4,0,1,3,2,6,-4,1,japan2
Mito Hollyhock,4,0,1,3,2,9,-7,1,japan2
Iwaki,4,0,1,3,4,13,-9,1,japan2
Al Hussein,4,4,0,0,9,0,9,12,jordan
Al Wihdat,4,4,0,0,7,2,5,12,jordan
Al Faysali,4,3,0,1,11,4,7,9,jordan
Moghayer Al S.,4,2,1,1,7,5,2,7,jordan
Al Salt,4,2,1,1,5,3,2,7,jordan
Al Ramtha,4,2,0,2,8,3,5,6,jordan
Al Ahli,4,1,1,2,4,5,-1,4,jordan
Maan,4,1,1,2,3,6,-3,4,jordan
Al Jalil,4,1,1,2,3,7,-4,4,jordan
Aqaba,4,1,1,2,3,8,-5,4,jordan
Shabab Al Ordon,4,1,0,3,3,6,-3,3,jordan
Sahab,4,0,2,2,3,9,-6,2,jordan
Ordabasy,4,3,0,1,6,3,3,9,kazakhstan
Kaisar K.,4,3,0,1,5,3,2,9,kazakhstan
FC Astana,4,2,1,1,8,6,2,7,kazakhstan
Kairat Almaty,4,1,3,0,5,2,3,6,kazakhstan
Aktobe,4,1,3,0,5,3,2,6,kazakhstan
Tobol,4,1,2,1,6,4,2,5,kazakhstan
Atyrau,4,1,2,1,2,1,1,5,kazakhstan
Kaspiy Aktau,4,1,2,1,4,5,-1,5,kazakhstan
Maqtaaral,4,1,2,1,4,5,-1,5,kazakhstan
S. Karagandy,4,1,2,1,4,5,-1,5,kazakhstan
Okzhetpes,4,1,2,1,6,8,-2,5,kazakhstan
Zhetysu,4,1,1,2,6,7,-1,4,kazakhstan
Aksu,4,1,0,3,3,9,-6,3,kazakhstan
Kyzylzhar,4,0,1,3,3,6,-3,1,kazakhstan
Ballkani,4,3,1,0,9,2,7,10,kosovo
Drita,4,2,1,1,5,3,2,7,kosovo
Dukagjini,4,1,3,0,7,6,1,6,kosovo
Gjilani,4,2,0,2,4,5,-1,6,kosovo
Fushe Kosova,4,1,2,1,3,2,1,5,kosovo
Llapi,4,1,2,1,3,2,1,5,kosovo
Prishtina,4,1,2,1,3,3,0,5,kosovo
Feronikeli,4,1,1,2,4,5,-1,4,kosovo
Malisheva,4,1,1,2,5,7,-2,4,kosovo
Liria,4,0,2,2,4,9,-5,2,kosovo
Kazma,4,3,0,1,8,4,4,9,kuwait
Al Kuwait,4,2,2,0,10,4,6,8,kuwait
Al Qadsia,4,2,2,0,6,2,4,8,kuwait
Al Arabi SC,4,2,1,1,7,7,0,7,kuwait
Al Nasar,4,2,0,2,7,6,1,6,kuwait
Al Shabab,4,2,0,2,6,7,-1,6,kuwait
Al Salmiyah,4,2,0,2,5,6,-1,6,kuwait
Al Fahaheel,4,1,1,2,6,8,-2,4,kuwait
Al Jahra,4,0,1,3,3,7,-4,1,kuwait
Khaitan,4,0,1,3,1,10,-9,1,kuwait
RFS,4,4,0,0,14,6,8,12,latvia
Riga FC,4,3,1,0,8,1,7,10,latvia
Liepaja,4,1,2,1,4,5,-1,5,latvia
FS Jelgava,4,1,2,1,3,4,-1,5,latvia
Super Nova,4,1,2,1,3,4,-1,5,latvia
Daugavpils,4,1,1,2,5,7,-2,4,latvia
Valmiera,4,1,1,2,5,7,-2,4,latvia
Auda,4,1,1,2,3,5,-2,4,latvia
Metta / LU,4,1,0,3,6,7,-1,3,latvia
Tukums,4,1,0,3,7,12,-5,3,latvia
Kauno Zalgiris,4,3,1,0,10,2,8,10,lithuania
Suduva,4,2,1,1,4,2,2,7,lithuania
Riteriai,4,2,1,1,5,4,1,7,lithuania
Hegelmann L.,4,2,1,1,4,6,-2,7,lithuania
Panevezys,4,1,3,0,4,2,2,6,lithuania
Zalgiris,4,1,1,2,4,6,-2,4,lithuania
FA Siauliai,4,0,3,1,3,5,-2,3,lithuania
Banga,4,1,0,3,3,6,-3,3,lithuania
Dainava,4,0,2,2,2,4,-2,2,lithuania
Dziugas Telsiai,4,0,2,2,0,3,-3,2,lithuania
Neptuna K.,4,3,1,0,12,1,11,10,lithuania2
TransINVEST,4,3,1,0,13,4,9,10,lithuania2
Be1 NFA,4,3,1,0,7,2,5,10,lithuania2
BFA Vilnius,4,3,0,1,9,5,4,9,lithuania2
Kauno Z. B,4,2,1,1,4,2,2,7,lithuania2
FA Siauliai B,4,2,1,1,9,8,1,7,lithuania2
Minija,4,2,0,2,8,7,1,6,lithuania2
Ekranas,4,2,0,2,7,6,1,6,lithuania2
Garliava,4,1,3,0,5,4,1,6,lithuania2
Zalgiris B,4,1,2,1,9,8,1,5,lithuania2
Panevezys B,4,1,1,2,7,6,1,4,lithuania2
Riteriai B,4,1,1,2,8,10,-2,4,lithuania2
Nevezis,4,1,1,2,5,7,-2,4,lithuania2
Jonava,4,1,0,3,5,10,-5,3,lithuania2
Babrungas,4,1,0,3,5,13,-8,3,lithuania2
Marijampole C.,4,0,1,3,4,13,-9,1,lithuania2
Hesperang,4,3,1,0,10,1,9,10,luxembourg
V. Rosport,4,3,1,0,8,4,4,10,luxembourg
Petange,4,3,0,1,7,3,4,9,luxembourg
Differdange,4,2,2,0,11,4,7,8,luxembourg
Niedercorn,4,2,2,0,10,7,3,8,luxembourg
Dudelange,4,2,2,0,6,4,2,8,luxembourg
Wiltz,4,2,1,1,6,6,0,7,luxembourg
Mondorf,4,1,2,1,5,6,-1,5,luxembourg
Racing,4,1,1,2,6,6,0,4,luxembourg
Marisca Mersch,4,1,1,2,5,6,-1,4,luxembourg
UN Käerjéng,4,1,1,2,2,3,-1,4,luxembourg
Jeunesse Esch,4,0,2,2,5,8,-3,2,luxembourg
UNA Strassen,4,0,2,2,3,6,-3,2,luxembourg
Schifflange,4,0,2,2,2,8,-6,2,luxembourg
Mondercange,4,0,2,2,5,15,-10,2,luxembourg
Fola Esch,4,0,0,4,3,7,-4,0,luxembourg
Selangor,4,4,0,0,21,2,19,12,malaysia
Johor Darul,4,3,1,0,14,3,11,10,malaysia
Kedah,4,3,1,0,9,4,5,10,malaysia
Sabah,4,3,0,1,9,9,0,9,malaysia
Terengganu,4,2,1,1,12,6,6,7,malaysia
Pahang,4,2,1,1,10,7,3,7,malaysia
PDRM,4,2,1,1,6,5,1,7,malaysia
Perak,4,2,0,2,9,9,0,6,malaysia
Kelantan United,4,2,0,2,4,8,-4,6,malaysia
Kuala Lumpur,4,1,0,3,6,6,0,3,malaysia
Kelantan,4,1,0,3,4,27,-23,3,malaysia
Kuching,4,0,2,2,4,6,-2,2,malaysia
Pulau Pinang,4,0,1,3,1,6,-5,1,malaysia
Negeri Sembilan,4,0,0,4,1,11,-10,0,malaysia
Hamrun Spartans,4,3,1,0,11,1,10,10,malta
Birkirkara,4,3,0,1,12,5,7,9,malta
Mosta,4,3,0,1,11,5,6,9,malta
Sirens,4,2,2,0,5,3,2,8,malta
Valletta,4,2,1,1,8,4,4,7,malta
Floriana,4,2,1,1,10,7,3,7,malta
Hibernians,4,2,1,1,10,9,1,7,malta
Gzira Utd,4,2,0,2,8,5,3,6,malta
Balzan,4,2,0,2,5,9,-4,6,malta
Santa Lucia,4,1,1,2,3,5,-2,4,malta
Pieta Hotspurs,4,1,1,2,5,8,-3,4,malta
Gudja Utd,4,0,1,3,2,6,-4,1,malta
Marsaxlokk,4,0,1,3,5,11,-6,1,malta
Zebbug Rangers,4,0,0,4,1,18,-17,0,malta
CF America,4,4,0,0,10,4,6,12,mexico
Mazatlan,4,3,0,1,10,4,6,9,mexico
Monterrey,4,3,0,1,7,4,3,9,mexico
Guadalajara,4,3,0,1,8,6,2,9,mexico
Pachuca,4,2,2,0,5,2,3,8,mexico
Tigres,4,2,1,1,7,4,3,7,mexico
Puebla,4,2,1,1,7,7,0,7,mexico
Toluca,4,2,0,2,6,4,2,6,mexico
Tijuana,4,2,0,2,5,4,1,6,mexico
Cruz Azul,4,2,0,2,5,6,-1,6,mexico
Pumas UNAM,4,1,1,2,5,4,1,4,mexico
A. San Luis,4,1,0,3,7,7,0,3,mexico
Santos Laguna,4,1,0,3,9,10,-1,3,mexico
Queretaro,4,1,0,3,3,8,-5,3,mexico
Juarez,4,1,0,3,4,10,-6,3,mexico
Necaxa,4,1,0,3,2,9,-7,3,mexico
Club Leon,4,0,2,2,6,8,-2,2,mexico
Atlas,4,0,1,3,2,8,-6,1,mexico
Guadalajara,4,4,0,0,9,2,7,12,mexico2
CF America,4,3,1,0,7,3,4,10,mexico2
Pachuca,4,3,0,1,8,6,2,9,mexico2
Atlas,4,2,2,0,8,3,5,8,mexico2
Toluca,4,2,1,1,7,5,2,7,mexico2
Queretaro,4,2,1,1,4,2,2,7,mexico2
Pumas UNAM,4,2,1,1,8,7,1,7,mexico2
Monterrey,4,2,0,2,8,5,3,6,mexico2
Club Leon,4,1,2,1,3,2,1,5,mexico2
Puebla,4,1,1,2,7,6,1,4,mexico2
A. San Luis,4,1,1,2,4,5,-1,4,mexico2
Cruz Azul,4,1,1,2,5,7,-2,4,mexico2
Tijuana,4,1,1,2,5,8,-3,4,mexico2
Tigres,4,1,1,2,2,5,-3,4,mexico2
Santos Laguna,4,1,0,3,5,10,-5,3,mexico2
Mazatlan,4,1,0,3,4,9,-5,3,mexico2
Juarez,4,0,2,2,2,5,-3,2,mexico2
Necaxa,4,0,1,3,2,8,-6,1,mexico2
Deren,4,4,0,0,17,4,13,12,mongolia
Tuv Buganuud,4,4,0,0,20,9,11,12,mongolia
SP Falcons,4,4,0,0,9,0,9,12,mongolia
Khangarid,4,2,0,2,15,7,8,6,mongolia
FC Ulaanbaatar,4,2,0,2,8,3,5,6,mongolia
Khoromkhon,4,2,0,2,8,11,-3,6,mongolia
Erchim,4,1,1,2,7,12,-5,4,mongolia
Bavarians,4,0,1,3,6,17,-11,1,mongolia
Khovd,4,0,0,4,4,15,-11,0,mongolia
Bayanzurkh S.,4,0,0,4,3,19,-16,0,mongolia
Decic,4,4,0,0,10,3,7,12,montenegro
Buducnost,4,3,0,1,6,3,3,9,montenegro
Mornar,4,2,1,1,5,4,1,7,montenegro
Rudar,4,2,1,1,4,4,0,7,montenegro
Jezero,4,1,2,1,5,6,-1,5,montenegro
Petrovac,4,1,1,2,4,4,0,4,montenegro
Sutjeska,4,1,1,2,3,3,0,4,montenegro
Jedinstvo,4,1,1,2,7,9,-2,4,montenegro
Arsenal Tivat,4,0,3,1,6,7,-1,3,montenegro
Mladost DG,4,0,0,4,2,9,-7,0,montenegro
Wydad,4,3,1,0,7,1,6,10,morocco
Moghreb Tetouan,4,3,0,1,7,2,5,9,morocco
FUS Rabat,4,3,0,1,7,3,4,9,morocco
Maghreb de Fes,4,2,2,0,7,2,5,8,morocco
Raja Casablanca,4,2,2,0,5,3,2,8,morocco
FAR Rabat,4,2,1,1,5,2,3,7,morocco
Berkane,4,1,3,0,3,1,2,6,morocco
C. Mohammedia,4,1,2,1,5,4,1,5,morocco
Olympic Safi,4,1,2,1,5,5,0,5,morocco
R. Zemamra,4,1,2,1,7,8,-1,5,morocco
Union Touarga,4,1,1,2,5,6,-1,4,morocco
Youssoufia B.,4,1,1,2,4,6,-2,4,morocco
Ittihad Tanger,4,1,1,2,4,7,-3,4,morocco
Hassania Agadir,4,0,2,2,4,8,-4,2,morocco
Mouloudia Oujda,4,0,2,2,2,7,-5,2,morocco
Salmi,4,0,1,3,3,12,-9,1,morocco
Meknes,4,4,0,0,5,0,5,12,morocco2
Stade Marocain,4,2,2,0,7,3,4,8,morocco2
Rapide Oued Z.,4,2,2,0,4,2,2,8,morocco2
Kawkab M.,4,2,1,1,6,4,2,7,morocco2
R. Beni Mellal,4,1,3,0,6,5,1,6,morocco2
Dcheira,4,1,2,1,4,3,1,5,morocco2
RAC Casablanca,4,1,2,1,5,5,0,5,morocco2
USM Oujda,4,1,2,1,3,3,0,5,morocco2
Difaa El Jadida,4,0,4,0,1,1,0,4,morocco2
AS Salé,4,1,1,2,5,6,-1,4,morocco2
C. Benguerir,4,1,1,2,1,2,-1,4,morocco2
Ittifaq M.,4,1,1,2,1,4,-3,4,morocco2
Wydad Fès,4,0,3,1,3,4,-1,3,morocco2
Chabab Atlas K.,4,0,2,2,2,5,-3,2,morocco2
El Massira,4,0,2,2,3,7,-4,2,morocco2
Khouribga,4,0,1,3,1,4,-3,1,morocco2
Shan Utd,4,4,0,0,16,4,12,12,myanmar
Hantharwady,4,4,0,0,10,3,7,12,myanmar
Yangon Utd,4,3,1,0,8,2,6,10,myanmar
Myawady,4,2,0,2,5,5,0,6,myanmar
Ispe FC,4,1,2,1,7,6,1,5,myanmar
Dagon,4,1,2,1,3,4,-1,5,myanmar
Rakhine Utd,4,1,1,2,7,8,-1,4,myanmar
Ayeyawady,4,1,1,2,4,8,-4,4,myanmar
Chinland,4,1,1,2,4,10,-6,4,myanmar
Sagaing Utd,4,0,3,1,0,3,-3,3,myanmar
Yadanarbon,4,0,2,2,1,6,-5,2,myanmar
Kachin Utd,4,0,0,4,3,8,-5,0,myanmar
PSV Eindhoven,4,4,0,0,15,4,11,12,netherlands
AZ Alkmaar,4,3,1,0,10,2,8,10,netherlands
FC Twente,4,3,1,0,8,3,5,10,netherlands
Feyenoord,4,3,0,1,10,3,7,9,netherlands
Almere City,4,2,2,0,4,1,3,8,netherlands
FC Volendam,4,2,0,2,5,5,0,6,netherlands
RKC Waalwijk,4,2,0,2,3,4,-1,6,netherlands
Go Ahead Eagles,4,1,2,1,5,3,2,5,netherlands
NEC Nijmegen,4,1,2,1,6,5,1,5,netherlands
Vitesse Arnhem,4,1,2,1,4,6,-2,5,netherlands
PEC Zwolle,4,1,1,2,6,7,-1,4,netherlands
Heerenveen,4,1,1,2,4,5,-1,4,netherlands
FC Utrecht,4,1,1,2,4,6,-2,4,netherlands
Excelsior,4,1,1,2,5,8,-3,4,netherlands
Sparta,4,1,1,2,3,6,-3,4,netherlands
Heracles Almelo,4,1,1,2,4,10,-6,4,netherlands
Ajax Amsterdam,4,1,0,3,8,11,-3,3,netherlands
Fortuna Sittard,4,0,1,3,1,10,-9,1,netherlands
Willem II,4,4,0,0,11,3,8,12,netherlands2
FC Dordrecht,4,3,1,0,15,4,11,10,netherlands2
De Graafschap,4,3,0,1,5,5,0,9,netherlands2
ADO Den Haag,4,2,2,0,7,5,2,8,netherlands2
Helmond Sport,4,2,2,0,5,3,2,8,netherlands2
Jong AZ,4,2,1,1,9,4,5,7,netherlands2
NAC Breda,4,2,1,1,7,5,2,7,netherlands2
FC Emmen,4,2,1,1,6,4,2,7,netherlands2
Roda JC,4,2,1,1,6,4,2,7,netherlands2
VVV,4,1,3,0,7,6,1,6,netherlands2
FC Eindhoven,4,2,0,2,7,7,0,6,netherlands2
Telstar,4,2,0,2,4,5,-1,6,netherlands2
MVV Maastricht,4,1,2,1,6,6,0,5,netherlands2
Jong Ajax,4,1,1,2,4,6,-2,4,netherlands2
Cambuur,4,1,1,2,7,10,-3,4,netherlands2
TOP Oss,4,1,0,3,3,6,-3,3,netherlands2
Jong PSV,4,1,0,3,9,13,-4,3,netherlands2
Jong Utrecht,4,0,2,2,2,8,-6,2,netherlands2
FC Groningen,4,0,1,3,4,7,-3,1,netherlands2
FC Den Bosch,4,0,0,4,3,11,-8,0,netherlands2
Diriangen,4,3,1,0,5,2,3,10,nicaragua
UNAN Managua,4,3,0,1,8,4,4,9,nicaragua
Real Esteli,4,2,1,1,7,3,4,7,nicaragua
Jalapa,4,2,1,1,9,6,3,7,nicaragua
Export Sebaco,4,2,1,1,4,7,-3,7,nicaragua
Managua FC,4,1,2,1,8,5,3,5,nicaragua
Matagalpa,4,1,0,3,6,7,-1,3,nicaragua
D. Ocotal,4,1,0,3,5,6,-1,3,nicaragua
Walter Ferreti,4,1,0,3,4,9,-5,3,nicaragua
O. Masachapa,4,1,0,3,5,12,-7,3,nicaragua
Remo Stars,4,3,1,0,8,2,6,10,nigeria
Akwa Utd,4,3,0,1,6,2,4,9,nigeria
Enyimba,4,2,2,0,7,1,6,8,nigeria
Rivers Utd,4,2,2,0,5,2,3,8,nigeria
Wikki Tourist,4,2,1,1,7,4,3,7,nigeria
Sunshine Stars,4,2,0,2,6,3,3,6,nigeria
Enugu Rangers,4,1,3,0,5,2,3,6,nigeria
Bayelsa Utd,4,2,0,2,6,5,1,6,nigeria
Bendel,4,1,3,0,4,3,1,6,nigeria
Abia Warriors,4,2,0,2,5,7,-2,6,nigeria
Shooting Stars,4,1,2,1,4,2,2,5,nigeria
Plateau Utd,4,1,2,1,5,5,0,5,nigeria
Nasarawa Utd,4,1,1,2,2,3,-1,4,nigeria
Lobi Stars,4,1,1,2,2,4,-2,4,nigeria
Doma Utd,4,1,1,2,2,5,-3,4,nigeria
Kwara Utd,4,1,1,2,3,8,-5,4,nigeria
Niger Tornadoes,4,1,0,3,3,5,-2,3,nigeria
Dakkada,4,0,2,2,2,8,-6,2,nigeria
El Kanemi,4,0,1,3,3,7,-4,1,nigeria
Gombe Utd,4,0,1,3,0,9,-9,1,nigeria
Linfield,4,4,0,0,10,2,8,12,northernireland
Larne,4,3,1,0,6,2,4,10,northernireland
Crusaders,4,2,2,0,7,3,4,8,northernireland
Glentoran,4,2,1,1,10,4,6,7,northernireland
Coleraine,4,2,0,2,8,6,2,6,northernireland
Cliftonville,4,2,0,2,4,4,0,6,northernireland
Ballymena Utd,4,1,1,2,4,5,-1,4,northernireland
Newry City,4,1,0,3,4,7,-3,3,northernireland
Carrick Rangers,4,1,0,3,6,10,-4,3,northernireland
Glenavon,4,1,0,3,5,9,-4,3,northernireland
Loughgall,4,1,0,3,7,16,-9,3,northernireland
Dungannon,4,0,2,2,2,10,-8,2,northernireland
Dundela,4,4,0,0,10,4,6,12,northernireland2
Portadown,4,3,0,1,11,6,5,9,northernireland2
Institute,4,3,0,1,10,6,4,9,northernireland2
Ballinamallard,4,2,2,0,5,1,4,8,northernireland2
Ballyclare,4,2,1,1,11,6,5,7,northernireland2
Dergview,4,2,1,1,6,6,0,7,northernireland2
H&W Welders,4,2,0,2,9,9,0,6,northernireland2
Bangor,4,2,0,2,8,9,-1,6,northernireland2
Annagh Utd,4,1,1,2,4,8,-4,4,northernireland2
Newington Youth,4,1,0,3,4,7,-3,3,northernireland2
Ards,4,0,1,3,8,13,-5,1,northernireland2
Knockbreda,4,0,0,4,4,13,-9,0,northernireland2
Shkupi,4,3,1,0,7,1,6,10,northmacedonia
Struga,4,3,0,1,10,2,8,9,northmacedonia
Skendija,4,2,2,0,5,2,3,8,northmacedonia
Gostivar,4,2,2,0,6,4,2,8,northmacedonia
Sileks,4,2,1,1,5,4,1,7,northmacedonia
Vardar,4,2,0,2,2,6,-4,6,northmacedonia
Bregalnica Stip,4,1,2,1,2,2,0,5,northmacedonia
Voska Sport,4,1,2,1,6,7,-1,5,northmacedonia
Makedonija,4,1,1,2,3,6,-3,4,northmacedonia
Rabotnicki,4,1,0,3,2,6,-4,3,northmacedonia
Tikves,4,0,2,2,2,4,-2,2,northmacedonia
A. Pandev,4,0,1,3,1,4,-3,1,northmacedonia
Bodo / Glimt,4,4,0,0,12,5,7,12,norway
Haugesund,4,3,1,0,11,2,9,10,norway
Brann,4,3,1,0,8,4,4,10,norway
Tromso,4,3,0,1,10,6,4,9,norway
Stabaek,4,2,2,0,9,5,4,8,norway
Aalesund,4,2,1,1,7,10,-3,7,norway
Stromsgodset,4,2,0,2,4,4,0,6,norway
Sarpsborg 08,4,1,2,1,10,8,2,5,norway
Odd,4,1,2,1,5,5,0,5,norway
Rosenborg,4,1,1,2,6,10,-4,4,norway
Molde,4,1,0,3,8,10,-2,3,norway
Lillestrom,4,1,0,3,3,6,-3,3,norway
Valerenga,4,1,0,3,4,8,-4,3,norway
HamKam,4,1,0,3,3,10,-7,3,norway
Sandefjord,4,0,1,3,5,8,-3,1,norway
Viking,4,0,1,3,4,10,-6,1,norway
Kristiansund,4,4,0,0,11,3,8,12,norway2
KFUM Oslo,4,3,1,0,6,0,6,10,norway2
Mjondalen,4,3,1,0,6,1,5,10,norway2
Fredrikstad,4,3,0,1,11,4,7,9,norway2
Kongsvinger,4,2,0,2,8,5,3,6,norway2
Bryne,4,2,0,2,4,4,0,6,norway2
Start,4,2,0,2,4,4,0,6,norway2
Ranheim,4,2,0,2,5,7,-2,6,norway2
Asane,4,2,0,2,6,9,-3,6,norway2
Hodd,4,1,1,2,3,6,-3,4,norway2
Sogndal,4,1,1,2,6,10,-4,4,norway2
Moss,4,1,0,3,5,5,0,3,norway2
Skeid,4,1,0,3,3,4,-1,3,norway2
Jerv,4,1,0,3,4,9,-5,3,norway2
Sandnes Ulf,4,1,0,3,3,10,-7,3,norway2
Raufoss,4,0,2,2,0,4,-4,2,norway2
Al Seeb,4,3,1,0,8,0,8,10,oman
Oman Club,4,3,1,0,4,1,3,10,oman
Ibri,4,3,0,1,6,2,4,9,oman
Al-Nahda,4,2,2,0,8,5,3,8,oman
Sohar,4,2,1,1,6,3,3,7,oman
Al Wehda,4,2,0,2,2,6,-4,6,oman
Al Nasr,4,1,2,1,5,4,1,5,oman
Al-Rustaq,4,1,2,1,3,3,0,5,oman
Al-Shabab Club,4,1,1,2,5,6,-1,4,oman
Sur,4,0,1,3,4,7,-3,1,oman
Dhofar,4,0,1,3,4,9,-5,1,oman
Bahla,4,0,0,4,1,11,-10,0,oman
UMECIT,4,3,1,0,5,1,4,10,panama
San Miguelito,4,3,0,1,4,1,3,9,panama
Plaza Amador,4,2,1,1,5,3,2,7,panama
Costa del Este,4,2,1,1,6,5,1,7,panama
Independiente,4,2,0,2,9,5,4,6,panama
Herrera,4,1,2,1,4,2,2,5,panama
Universitario,4,1,2,1,2,2,0,5,panama
San Francisco,4,1,2,1,1,3,-2,5,panama
Arabe Unido,4,1,1,2,4,3,1,4,panama
Alianza,4,1,1,2,2,5,-3,4,panama
Tauro,4,1,0,3,1,5,-4,3,panama
A. Chiriqui,4,0,1,3,2,10,-8,1,panama
Independiente,4,4,0,0,16,4,12,12,panama2
San Francisco,4,3,0,1,11,4,7,9,panama2
Arabe Unido,4,2,2,0,7,4,3,8,panama2
Alianza,4,2,2,0,5,2,3,8,panama2
San Miguelito,4,2,2,0,4,1,3,8,panama2
Herrera,4,2,1,1,14,5,9,7,panama2
Tauro,4,1,2,1,4,5,-1,5,panama2
Universitario,4,1,1,2,5,8,-3,4,panama2
UMECIT,4,1,0,3,7,8,-1,3,panama2
Costa del Este,4,0,1,3,6,10,-4,1,panama2
Plaza Amador,4,0,1,3,2,6,-4,1,panama2
A. Chiriqui,4,0,0,4,2,25,-23,0,panama2
S. Trinidense,4,3,1,0,8,3,5,10,paraguay
Nacional,4,3,0,1,6,3,3,9,paraguay
Libertad,4,2,1,1,4,3,1,7,paraguay
G. Caballero,4,2,1,1,3,3,0,7,paraguay
Olimpia,4,2,0,2,7,6,1,6,paraguay
S. Ameliano,4,1,2,1,5,4,1,5,paraguay
Guairena,4,1,2,1,5,5,0,5,paraguay
Cerro Porteno,4,1,1,2,6,6,0,4,paraguay
S. Luqueno,4,1,1,2,5,6,-1,4,paraguay
Tacuary,4,1,1,2,5,6,-1,4,paraguay
Resistencia,4,1,0,3,2,8,-6,3,paraguay
Guarani,4,0,2,2,3,6,-3,2,paraguay
Cerro Porteno,4,3,1,0,11,3,8,10,paraguay2
Libertad,4,2,2,0,8,2,6,8,paraguay2
Nacional,4,2,2,0,6,1,5,8,paraguay2
Olimpia,4,2,2,0,4,2,2,8,paraguay2
S. Luqueno,4,2,1,1,3,3,0,7,paraguay2
Tacuary,4,2,0,2,8,6,2,6,paraguay2
Guairena,4,1,2,1,3,2,1,5,paraguay2
S. Ameliano,4,1,1,2,3,6,-3,4,paraguay2
S. Trinidense,4,0,2,2,6,10,-4,2,paraguay2
G. Caballero,4,0,2,2,0,4,-4,2,paraguay2
Guarani,4,0,2,2,0,5,-5,2,paraguay2
Resistencia,4,0,1,3,3,11,-8,1,paraguay2
S. Cristal,4,3,1,0,9,5,4,10,peru
FBC Melgar,4,3,1,0,8,5,3,10,peru
Sport Boys,4,3,0,1,6,4,2,9,peru
Atletico Grau,4,2,1,1,11,5,6,7,peru
Alianza Lima,4,2,0,2,11,7,4,6,peru
Universitario,4,2,0,2,5,2,3,6,peru
Binacional,4,2,0,2,10,8,2,6,peru
Cusco,4,2,0,2,6,5,1,6,peru
D. Municipal,4,2,0,2,4,4,0,6,peru
Sport Huancayo,4,2,0,2,4,4,0,6,peru
Cajamarca,4,2,0,2,5,6,-1,6,peru
D. Garcilaso,4,1,2,1,8,8,0,5,peru
ADT,4,1,2,1,7,7,0,5,peru
Union Comercio,4,1,2,1,8,12,-4,5,peru
Alianza A.,4,1,1,2,6,7,-1,4,peru
Cesar Vallejo,4,1,1,2,5,9,-4,4,peru
Cienciano,4,1,0,3,3,9,-6,3,peru
AD Cantolao,4,0,2,2,2,6,-4,2,peru
Carlos Manucci,4,0,1,3,2,7,-5,1,peru
Universitario,4,3,1,0,7,1,6,10,peru2
FBC Melgar,4,3,1,0,7,3,4,10,peru2
ADT,4,2,2,0,4,0,4,8,peru2
Alianza Lima,4,2,2,0,3,1,2,8,peru2
Cesar Vallejo,4,2,1,1,6,3,3,7,peru2
Sport Boys,4,2,1,1,5,4,1,7,peru2
D. Municipal,4,2,0,2,7,6,1,6,peru2
S. Cristal,4,2,0,2,6,5,1,6,peru2
Cienciano,4,2,0,2,5,6,-1,6,peru2
Sport Huancayo,4,2,0,2,3,4,-1,6,peru2
Atletico Grau,4,1,1,2,5,4,1,4,peru2
Cusco,4,1,1,2,7,7,0,4,peru2
Carlos Manucci,4,1,1,2,5,6,-1,4,peru2
Alianza A.,4,1,1,2,4,6,-2,4,peru2
D. Garcilaso,4,1,1,2,2,4,-2,4,peru2
Union Comercio,4,1,1,2,4,7,-3,4,peru2
AD Cantolao,4,1,1,2,2,6,-4,4,peru2
Cajamarca,4,0,3,1,3,6,-3,3,peru2
Binacional,4,0,1,3,6,9,-3,1,peru2
D. Coopsol,4,3,1,0,9,2,7,10,peru3
Comerciantes U.,4,3,1,0,9,3,6,10,peru3
Santa Rosa,4,3,0,1,20,4,16,9,peru3
Llacuabamba,4,2,2,0,10,2,8,8,peru3
A. Huanuco,4,2,1,1,3,2,1,7,peru3
Comerciantes,4,2,1,1,5,7,-2,7,peru3
Ayacucho,4,1,3,0,6,5,1,6,peru3
Santos FC,4,1,2,1,6,5,1,5,peru3
U. San Martin,4,1,1,2,3,4,-1,4,peru3
Alfonso Ugarte,4,0,3,1,1,4,-3,3,peru3
Carlos Stein,4,1,0,3,5,13,-8,3,peru3
Juan Aurich,4,0,2,2,1,4,-3,2,peru3
Huaral,4,0,1,3,3,7,-4,1,peru3
M. El Pirata,4,0,0,4,1,20,-19,0,peru3
Kaya,4,3,1,0,15,4,11,10,philippines
Mendiola,4,3,0,1,8,3,5,9,philippines
Stallion,4,3,0,1,8,3,5,9,philippines
Cebu FC,4,2,2,0,5,1,4,8,philippines
United City,4,1,2,1,7,7,0,5,philippines
Maharlika,4,1,0,3,5,8,-3,3,philippines
Azkals,4,0,0,4,0,12,-12,0,philippines
Pogon Szczecin,4,3,1,0,10,1,9,10,poland
Lech Poznan,4,2,2,0,11,6,5,8,poland
Slask Wroclaw,4,2,2,0,8,3,5,8,poland
Jagiellonia,4,2,1,1,11,5,6,7,poland
Gornik Zabrze,4,2,1,1,8,4,4,7,poland
Rakow C.,4,2,1,1,7,4,3,7,poland
Radomiak Radom,4,2,1,1,7,6,1,7,poland
Korona Kielce,4,1,3,0,7,5,2,6,poland
Cracovia Krakow,4,1,2,1,6,6,0,5,poland
Widzew Lodz,4,1,2,1,5,5,0,5,poland
Warta Poznan,4,1,2,1,3,3,0,5,poland
Piast Gliwice,4,0,4,0,2,2,0,4,poland
Zaglebie Lubin,4,1,1,2,5,7,-2,4,poland
Stal Mielec,4,1,0,3,3,7,-4,3,poland
Puszcza Niepolo,4,0,2,2,7,12,-5,2,poland
Ruch Chorzow,4,0,2,2,7,12,-5,2,poland
Legia Warsaw,4,0,0,4,2,11,-9,0,poland
LKS Lodz,4,0,0,4,1,13,-12,0,poland
Arka Gdynia,4,4,0,0,9,1,8,12,poland2
Polonia Warszaw,4,3,0,1,6,1,5,9,poland2
Tychy,4,3,0,1,6,3,3,9,poland2
Lechia Gdansk,4,2,2,0,4,2,2,8,poland2
Wisla Krakow,4,2,1,1,11,5,6,7,poland2
Miedz Legnica,4,2,1,1,9,4,5,7,poland2
Stal Rzeszow,4,2,1,1,4,3,1,7,poland2
Odra Opole,4,2,1,1,3,3,0,7,poland2
Resovia Rzeszow,4,2,0,2,6,7,-1,6,poland2
Motor Lublin,4,2,0,2,4,5,-1,6,poland2
T. Nieciecza,4,1,2,1,4,2,2,5,poland2
Wisla Plock,4,1,1,2,2,8,-6,4,poland2
Gornik Leczna,4,0,3,1,3,6,-3,3,poland2
Podbeskidzie,4,1,0,3,2,7,-5,3,poland2
Chrobry Glogow,4,0,2,2,2,4,-2,2,poland2
Katowice,4,0,2,2,1,4,-3,2,poland2
Z. Sosnowiec,4,0,2,2,0,3,-3,2,poland2
Znicz Pruszkow,4,0,1,3,4,11,-7,1,poland2
Stalowa Wola,4,3,0,1,7,3,4,9,poland3
K. Kolobrzeg,4,3,0,1,7,5,2,9,poland3
Pogon Siedlce,4,3,0,1,7,5,2,9,poland3
Chojniczanka,4,2,2,0,5,3,2,8,poland3
Sandecja Nowy,4,2,1,1,7,8,-1,7,poland3
SKRA Czestochow,4,2,0,2,9,6,3,6,poland3
Hutnik Krakow,4,2,0,2,6,6,0,6,poland3
Jastrzebie,4,1,2,1,5,5,0,5,poland3
Kalisz,4,1,2,1,3,3,0,5,poland3
Radunia Stezyca,4,1,2,1,3,3,0,5,poland3
Olimpia Elblag,4,1,1,2,5,4,1,4,poland3
O. Grudziadz,4,1,1,2,5,6,-1,4,poland3
Polonia Bytom,4,1,1,2,5,6,-1,4,poland3
Stomil Olsztyn,4,1,1,2,6,9,-3,4,poland3
Lech Poznan B,4,1,0,3,6,11,-5,3,poland3
Zaglebie L. B,4,0,2,2,6,8,-2,2,poland3
LKS Lodz B,4,0,2,2,4,7,-3,2,poland3
Wisla Pulawy,4,0,2,2,6,10,-4,2,poland3
Sporting CP,4,4,0,0,9,3,6,12,portugal
Guimaraes,4,3,1,0,11,3,8,10,portugal
Sporting Braga,4,3,1,0,13,7,6,10,portugal
Moreirense,4,3,1,0,7,1,6,10,portugal
Benfica,4,3,1,0,6,2,4,10,portugal
Estrela Amadora,4,2,1,1,6,6,0,7,portugal
Chaves,4,2,1,1,8,9,-1,7,portugal
FC Porto,4,2,0,2,3,2,1,6,portugal
Portimonense,4,2,0,2,5,6,-1,6,portugal
Gil Vicente,4,1,1,2,8,9,-1,4,portugal
Farense,4,1,1,2,6,7,-1,4,portugal
Famalicao,4,1,1,2,4,6,-2,4,portugal
Estoril,4,1,0,3,3,5,-2,3,portugal
Vizela,4,0,2,2,4,7,-3,2,portugal
Casa Pia,4,0,2,2,1,4,-3,2,portugal
Boavista,4,0,2,2,4,9,-5,2,portugal
Arouca,4,0,0,4,1,6,-5,0,portugal
Rio Ave,4,0,0,4,4,12,-8,0,portugal
AVS,4,4,0,0,7,2,5,12,portugal2
Nacional,4,3,1,0,11,2,9,10,portugal2
Tondela,4,2,2,0,10,7,3,8,portugal2
Uniao de Leiria,4,2,1,1,11,6,5,7,portugal2
FC Porto B,4,2,1,1,10,5,5,7,portugal2
Maritimo,4,2,1,1,7,5,2,7,portugal2
Mafra,4,2,0,2,6,4,2,6,portugal2
Santa Clara,4,1,3,0,4,2,2,6,portugal2
Pacos Ferreira,4,2,0,2,5,4,1,6,portugal2
Feirense,4,2,0,2,5,5,0,6,portugal2
Leixoes,4,2,0,2,6,8,-2,6,portugal2
Torreense,4,1,2,1,7,6,1,5,portugal2
Benfica B,4,1,1,2,7,7,0,4,portugal2
Penafiel,4,1,1,2,2,5,-3,4,portugal2
Academico Viseu,4,0,2,2,4,7,-3,2,portugal2
Oliveirense,4,0,2,2,4,12,-8,2,portugal2
Os Belenense,4,0,1,3,3,10,-7,1,portugal2
Vilaverdense,4,0,0,4,1,13,-12,0,portugal2
Al Sadd,4,4,0,0,14,1,13,12,qatar
Al Wakrah,4,4,0,0,9,3,6,12,qatar
Al Duhail,4,3,0,1,9,7,2,9,qatar
Al Gharafa,4,3,0,1,14,13,1,9,qatar
Qatar SC,4,2,0,2,8,4,4,6,qatar
Umm Salal,4,2,0,2,7,6,1,6,qatar
Al Ahli Doha,4,2,0,2,10,10,0,6,qatar
Al Rayyan,4,1,0,3,9,10,-1,3,qatar
Al Arabi,4,1,0,3,7,9,-2,3,qatar
Al Shamal,4,1,0,3,5,8,-3,3,qatar
Al Markhiya,4,1,0,3,3,12,-9,3,qatar
Al Muaidar,4,0,0,4,5,14,-9,0,qatar
CFR Cluj,4,2,2,0,7,2,5,8,romania
U. Cluj,4,2,2,0,7,3,4,8,romania
Rapid Bucharest,4,2,2,0,8,5,3,8,romania
Hermannstadt,4,1,3,0,7,3,4,6,romania
Sepsi OSK,4,2,0,2,7,4,3,6,romania
Petrolul,4,1,3,0,5,3,2,6,romania
UTA Arad,4,1,3,0,7,6,1,6,romania
FCSB,4,1,3,0,5,4,1,6,romania
P. Iasi,4,1,3,0,3,2,1,6,romania
Farul Constanta,4,1,2,1,5,6,-1,5,romania
Univ. Craiova,4,1,1,2,6,6,0,4,romania
Otelul,4,0,3,1,2,3,-1,3,romania
Voluntari,4,0,3,1,0,2,-2,3,romania
U Craiova 1948,4,0,2,2,4,7,-3,2,romania
Din. Bucharest,4,0,2,2,1,6,-5,2,romania
Botosani,4,0,0,4,3,14,-11,0,romania
Fakel Voronezh,4,3,1,0,6,1,5,10,russia
Zenit,4,3,0,1,8,5,3,9,russia
CSKA Moscow,4,2,2,0,4,2,2,8,russia
Rostov,4,2,1,1,8,5,3,7,russia
FC Krasnodar,4,2,1,1,7,5,2,7,russia
Rubin Kazan,4,2,1,1,2,2,0,7,russia
Dinamo Moscow,4,1,3,0,3,2,1,6,russia
Nizhny Novgorod,4,2,0,2,3,3,0,6,russia
Lokomotiv M.,4,1,2,1,3,3,0,5,russia
Krylya Sovetov,4,1,1,2,6,6,0,4,russia
Orenburg,4,1,1,2,5,5,0,4,russia
Baltika,4,1,1,2,3,4,-1,4,russia
Spartak Moscow,4,1,1,2,4,8,-4,4,russia
PFC Sochi,4,1,0,3,4,6,-2,3,russia
Ural,4,0,2,2,6,10,-4,2,russia
Akhmat Grozny,4,0,1,3,2,7,-5,1,russia
Akron,4,4,0,0,6,1,5,12,russia2
Tyumen,4,3,1,0,4,0,4,10,russia2
Arsenal Tula,4,2,2,0,8,3,5,8,russia2
Khimki,4,2,2,0,6,4,2,8,russia2
Yenisey,4,2,1,1,8,5,3,7,russia2
Neftekhimik,4,2,1,1,6,5,1,7,russia2
Urozhay,4,2,1,1,6,6,0,7,russia2
V. Astrakhan,4,2,0,2,3,6,-3,6,russia2
Torpedo Moscow,4,1,2,1,4,3,1,5,russia2
A. Vladikavkaz,4,1,2,1,4,4,0,5,russia2
Rodina Moskva,4,1,1,2,4,2,2,4,russia2
Kamaz,4,1,1,2,7,6,1,4,russia2
Chernomorets,4,1,1,2,3,4,-1,4,russia2
Makhachkala,4,1,1,2,1,2,-1,4,russia2
SKA Khabarovsk,4,1,1,2,3,6,-3,4,russia2
Shinnik,4,0,2,2,3,9,-6,2,russia2
Sokol Saratov,4,0,1,3,5,11,-6,1,russia2
Leningradets,4,0,0,4,2,6,-4,0,russia2
Al Hilal,4,4,0,0,9,1,8,12,saudiarabia
Al Nassr,4,3,1,0,9,5,4,10,saudiarabia
Damak,4,3,0,1,9,3,6,9,saudiarabia
Al Fateh,4,3,0,1,8,5,3,9,saudiarabia
Al Taawon,4,2,2,0,8,3,5,8,saudiarabia
Al Shabab,4,2,1,1,6,4,2,7,saudiarabia
Al Riyadh,4,2,1,1,6,5,1,7,saudiarabia
Al Ahli Jeddah,4,2,1,1,5,4,1,7,saudiarabia
Al Feiha,4,1,2,1,7,8,-1,5,saudiarabia
Al Ittifaq,4,1,1,2,4,5,-1,4,saudiarabia
Abha,4,1,1,2,5,8,-3,4,saudiarabia
Al Hazm,4,1,1,2,8,12,-4,4,saudiarabia
Al Tai,4,1,1,2,6,10,-4,4,saudiarabia
Al Akhdoud,4,1,0,3,3,8,-5,3,saudiarabia
Al Ittihad,4,0,2,2,3,5,-2,2,saudiarabia
Al Khaleej,4,0,2,2,1,4,-3,2,saudiarabia
Al Raed,4,0,1,3,5,8,-3,1,saudiarabia
Al Wahda,4,0,1,3,5,12,-7,1,saudiarabia
Al Orubah,4,4,0,0,8,2,6,12,saudiarabia2
Al Adalh,4,3,0,1,9,7,2,9,saudiarabia2
Al Jabalain,4,2,1,1,6,3,3,7,saudiarabia2
Al Quadisiya,4,2,1,1,4,2,2,7,saudiarabia2
Jeddah,4,2,1,1,3,2,1,7,saudiarabia2
Al Taraji,4,2,1,1,4,5,-1,7,saudiarabia2
Al-Jndal,4,2,1,1,5,7,-2,7,saudiarabia2
Ohod,4,2,0,2,9,6,3,6,saudiarabia2
Al Najma,4,2,0,2,9,7,2,6,saudiarabia2
Al Bukayriyah,4,1,3,0,1,0,1,6,saudiarabia2
Al Batin,4,1,2,1,5,4,1,5,saudiarabia2
Al Faisaly,4,1,2,1,4,3,1,5,saudiarabia2
Al-Ain,4,1,1,2,6,6,0,4,saudiarabia2
Al Kholood,4,1,1,2,4,6,-2,4,saudiarabia2
Al Qaisoma,4,1,0,3,6,9,-3,3,saudiarabia2
Al Safa,4,1,0,3,4,10,-6,3,saudiarabia2
Hajer,4,0,1,3,2,9,-7,1,saudiarabia2
Al Arabi,4,0,0,4,4,8,-4,0,saudiarabia2
Rangers,4,4,0,0,14,1,13,12,scotland
Celtic,4,3,1,0,9,3,6,10,scotland
Aberdeen,4,2,1,1,7,5,2,7,scotland
Kilmarnock,4,2,0,2,7,6,1,6,scotland
St. Johnstone,4,1,2,1,3,6,-3,5,scotland
Dundee FC,4,1,2,1,2,5,-3,5,scotland
St. Mirren,4,1,1,2,6,6,0,4,scotland
Hearts,4,1,1,2,5,8,-3,4,scotland
Ross County,4,0,3,1,5,6,-1,3,scotland
Livingston,4,1,0,3,3,6,-3,3,scotland
Hibernian,4,0,3,1,4,8,-4,3,scotland
Motherwell,4,0,1,3,6,11,-5,1,scotland
Dundee Utd,4,3,1,0,14,1,13,10,scotland2
Raith Rovers,4,3,1,0,6,3,3,10,scotland2
Ayr Utd,4,2,1,1,5,4,1,7,scotland2
Inverness,4,2,1,1,4,3,1,7,scotland2
Arbroath,4,2,0,2,9,9,0,6,scotland2
Greenock Morton,4,1,1,2,3,4,-1,4,scotland2
Queen`s Park,4,0,3,1,4,7,-3,3,scotland2
Dunfermline,4,1,0,3,2,6,-4,3,scotland2
Partick Thistle,4,0,3,1,4,9,-5,3,scotland2
Airdrieonians,4,0,1,3,2,6,-4,1,scotland2
Falkirk,4,3,1,0,8,3,5,10,scotland3
Kelty Hearts,4,3,0,1,9,5,4,9,scotland3
Hamilton,4,2,2,0,9,1,8,8,scotland3
Cove Rangers,4,2,2,0,8,6,2,8,scotland3
Montrose,4,2,0,2,5,7,-2,6,scotland3
Edinburgh City,4,1,2,1,6,8,-2,5,scotland3
Stirling Albion,4,1,1,2,4,5,-1,4,scotland3
Alloa Athletic,4,1,1,2,5,7,-2,4,scotland3
Queen of South,4,1,0,3,2,5,-3,3,scotland3
Annan Athletic,4,0,0,4,4,12,-8,0,scotland3
Peterhead,4,4,0,0,12,2,10,12,scotland4
East Fife,4,2,2,0,9,3,6,8,scotland4
Stenhousemuir,4,2,2,0,9,3,6,8,scotland4
Spartans,4,2,2,0,10,7,3,8,scotland4
Dumbarton,4,2,0,2,7,4,3,6,scotland4
Forfar Athletic,4,1,2,1,6,6,0,5,scotland4
Bonnyrigg Rose,4,1,1,2,6,7,-1,4,scotland4
Clyde,4,1,1,2,6,10,-4,4,scotland4
Elgin City,4,1,1,2,4,9,-5,4,scotland4
Stranraer,4,0,0,4,4,13,-9,0,scotland4
Partizan,4,4,0,0,12,0,12,12,serbia
Red Star,4,3,1,0,10,7,3,10,serbia
Vojvodina,4,2,1,1,8,6,2,7,serbia
Novi Pazar,4,2,1,1,5,3,2,7,serbia
Radnicki 1923,4,2,0,2,10,10,0,6,serbia
Z. Pancevo,4,2,0,2,5,5,0,6,serbia
Javor Ivanjica,4,2,0,2,5,6,-1,6,serbia
Cukaricki,4,1,2,1,6,4,2,5,serbia
Radnicki Nis,4,1,2,1,4,4,0,5,serbia
Vozdovac,4,1,2,1,3,5,-2,5,serbia
Napredak,4,1,1,2,4,6,-2,4,serbia
Sp. Subotica,4,1,1,2,3,7,-4,4,serbia
Backa Topola,4,0,3,1,3,5,-2,3,serbia
IMT N. Beograd,4,0,1,3,4,8,-4,1,serbia
Rad. Surdulica,4,0,1,3,1,6,-5,1,serbia
Mladost Lucani,4,0,1,3,3,9,-6,1,serbia
OFK Beograd,4,3,1,0,6,2,4,10,serbia2
Dubocica,4,3,1,0,3,0,3,10,serbia2
Jedinstvo Ub,4,2,2,0,4,2,2,8,serbia2
Indija,4,2,1,1,5,3,2,7,serbia2
Kolubara,4,2,1,1,4,3,1,7,serbia2
OFK Vrac,4,2,1,1,4,3,1,7,serbia2
Novi Sad,4,2,0,2,5,4,1,6,serbia2
Sloboda Uzice,4,2,0,2,5,4,1,6,serbia2
S. Mitrovica,4,2,0,2,4,4,0,6,serbia2
Radnicki B.,4,1,1,2,5,6,-1,4,serbia2
Semendrija 1924,4,1,1,2,3,4,-1,4,serbia2
Tekstilac Odzac,4,1,1,2,1,2,-1,4,serbia2
Graficar,4,0,2,2,2,4,-2,2,serbia2
Macva Sabac,4,0,2,2,1,3,-2,2,serbia2
Mladost Novi S.,4,0,2,2,1,5,-4,2,serbia2
Metalac GM,4,0,2,2,0,4,-4,2,serbia2
A. Niigata (S),4,4,0,0,19,4,15,12,singapore
Lion City,4,4,0,0,21,7,14,12,singapore
DPMM FC,4,1,2,1,5,4,1,5,singapore
Tanjong Pagar,4,1,2,1,9,9,0,5,singapore
Tampines Rovers,4,1,1,2,10,14,-4,4,singapore
Hougang,4,1,1,2,6,16,-10,4,singapore
Khalsa,4,1,0,3,10,15,-5,3,singapore
Geylang,4,1,0,3,7,15,-8,3,singapore
Young Lions,4,0,0,4,4,14,-10,0,singapore
S. Bratislava,4,4,0,0,13,2,11,12,slovakia
Zilina,4,3,1,0,13,5,8,10,slovakia
Spartak Trnava,4,3,0,1,7,5,2,9,slovakia
DAC Streda,4,3,0,1,9,8,1,9,slovakia
Podbrezova,4,2,1,1,14,8,6,7,slovakia
Skalica,4,2,1,1,5,5,0,7,slovakia
Banska Bystrica,4,1,1,2,7,7,0,4,slovakia
Trencin,4,1,1,2,3,5,-2,4,slovakia
Ruzomberok,4,1,1,2,2,7,-5,4,slovakia
Z. Michalovce,4,0,2,2,5,10,-5,2,slovakia
Zlate Moravce,4,0,1,3,2,8,-6,1,slovakia
FC Kosice,4,0,0,4,2,12,-10,0,slovakia
Futura Humenne,4,4,0,0,14,4,10,12,slovakia2
Pohronie,4,3,1,0,9,2,7,10,slovakia2
Petrzalka,4,3,1,0,8,3,5,10,slovakia2
Komarno,4,3,0,1,6,3,3,9,slovakia2
Tatran Presov,4,2,2,0,6,2,4,8,slovakia2
P. Bystrica,4,2,2,0,6,3,3,8,slovakia2
Zilina B,4,2,1,1,10,6,4,7,slovakia2
OFK Malzenice,4,2,1,1,6,4,2,7,slovakia2
Samorin,4,1,1,2,6,7,-1,4,slovakia2
S. Bratislava B,4,1,1,2,5,7,-2,4,slovakia2
Dolny Kubin,4,1,1,2,4,11,-7,4,slovakia2
Slavoj Trebisov,4,0,1,3,4,8,-4,1,slovakia2
L. Mikulas,4,0,1,3,4,10,-6,1,slovakia2
Spartak Myjava,4,0,1,3,4,10,-6,1,slovakia2
Spisska Nova V.,4,0,0,4,4,10,-6,0,slovakia2
Puchov,4,0,0,4,2,12,-10,0,slovakia2
NK Celje,4,4,0,0,11,2,9,12,slovenia
NK Olimpija,4,2,2,0,5,1,4,8,slovenia
Bravo,4,2,1,1,7,6,1,7,slovenia
Koper,4,1,3,0,8,5,3,6,slovenia
Radomlje,4,1,3,0,5,3,2,6,slovenia
Maribor,4,2,0,2,6,5,1,6,slovenia
Aluminij,4,1,1,2,2,6,-4,4,slovenia
Domzale,4,1,0,3,6,8,-2,3,slovenia
Mura,4,0,2,2,4,8,-4,2,slovenia
Rogaska,4,0,0,4,1,11,-10,0,slovenia
Mamelodi S.,4,4,0,0,7,1,6,12,southafrica
Cape Town City,4,3,1,0,7,2,5,10,southafrica
Golden Arrows,4,3,1,0,5,2,3,10,southafrica
SuperSport Utd,4,3,0,1,8,5,3,9,southafrica
Chippa Utd,4,2,2,0,4,2,2,8,southafrica
Polokwane,4,2,2,0,3,1,2,8,southafrica
Moroka Swallows,4,2,1,1,4,2,2,7,southafrica
Stellenbosch,4,1,1,2,4,5,-1,4,southafrica
TS Galaxy,4,1,1,2,5,7,-2,4,southafrica
AmaZulu,4,0,3,1,2,3,-1,3,southafrica
Kaizer Chiefs,4,1,0,3,3,5,-2,3,southafrica
Cape Town Spurs,4,1,0,3,5,8,-3,3,southafrica
Orlando Pirates,4,0,2,2,2,4,-2,2,southafrica
Richards Bay,4,0,1,3,3,7,-4,1,southafrica
Royal AM,4,0,1,3,1,5,-4,1,southafrica
Sekhukhune,4,0,1,3,1,5,-4,1,southafrica
Gwangju,4,3,0,1,4,3,1,9,southkorea
Incheon Utd,4,2,2,0,5,1,4,8,southkorea
Jeonbuk Motors,4,2,1,1,6,5,1,7,southkorea
Seoul,4,2,1,1,7,7,0,7,southkorea
Daejeon Citizen,4,1,3,0,5,4,1,6,southkorea
Ulsan,4,1,2,1,2,1,1,5,southkorea
Jeju Utd,4,1,1,2,4,4,0,4,southkorea
Daegu,4,1,1,2,6,7,-1,4,southkorea
Suwon Bluewings,4,1,1,2,3,6,-3,4,southkorea
Suwon City,4,0,3,1,7,8,-1,3,southkorea
Pohang Steelers,4,0,3,1,2,3,-1,3,southkorea
Gangwon,4,0,2,2,3,5,-2,2,southkorea
Gimcheon Sangmu,4,4,0,0,15,5,10,12,southkorea2
Busan IPark,4,3,1,0,5,2,3,10,southkorea2
Gyeongnam,4,2,1,1,8,5,3,7,southkorea2
Gimpo,4,2,1,1,6,4,2,7,southkorea2
Jeonnam Dragons,4,2,0,2,8,7,1,6,southkorea2
Chungnam Asan,4,2,0,2,6,6,0,6,southkorea2
Anyang,4,1,2,1,5,5,0,5,southkorea2
Seongnam,4,1,1,2,4,5,-1,4,southkorea2
Cheonan City,4,1,1,2,4,6,-2,4,southkorea2
Bucheon FC,4,0,2,2,3,6,-3,2,southkorea2
Cheongju,4,0,2,2,3,7,-4,2,southkorea2
Ansan Greeners,4,0,1,3,8,15,-7,1,southkorea2
Seoul E-Land,4,0,0,4,4,11,-7,0,southkorea2
Real Madrid,4,3,1,0,10,2,8,10,spain
Atletico Madrid,4,3,0,1,8,4,4,9,spain
Girona,4,3,0,1,7,5,2,9,spain
Las Palmas,4,3,0,1,6,4,2,9,spain
Real Betis,4,2,2,0,7,3,4,8,spain
Real Sociedad,4,2,1,1,7,4,3,7,spain
FC Barcelona,4,2,1,1,5,4,1,7,spain
Rayo Vallecano,4,1,3,0,7,6,1,6,spain
Osasuna,4,2,0,2,5,6,-1,6,spain
Villarreal,4,1,2,1,5,5,0,5,spain
Valencia,4,1,2,1,5,6,-1,5,spain
Getafe,4,0,4,0,3,3,0,4,spain
Athletic Bilbao,4,1,1,2,5,6,-1,4,spain
Sevilla FC,4,0,3,1,5,6,-1,3,spain
Mallorca,4,0,3,1,3,4,-1,3,spain
Granada,4,0,2,2,7,10,-3,2,spain
Alaves,4,0,2,2,3,6,-3,2,spain
Cadiz,4,0,1,3,4,8,-4,1,spain
Celta Vigo,4,0,1,3,3,8,-5,1,spain
Almeria,4,0,1,3,6,13,-7,1,spain
Leganes,4,3,1,0,8,0,8,10,spain2
Elche,4,3,1,0,6,3,3,10,spain2
Racing,4,3,0,1,10,7,3,9,spain2
Eibar,4,2,2,0,11,6,5,8,spain2
Real Oviedo,4,2,2,0,5,0,5,8,spain2
Eldense,4,2,2,0,5,2,3,8,spain2
Sporting Gijon,4,2,1,1,9,6,3,7,spain2
Mirandes,4,2,1,1,8,5,3,7,spain2
Levante,4,2,1,1,3,2,1,7,spain2
FC Andorra,4,2,0,2,5,4,1,6,spain2
Valladolid,4,2,0,2,6,9,-3,6,spain2
Racing Ferrol,4,1,2,1,5,4,1,5,spain2
Tenerife,4,1,2,1,4,4,0,5,spain2
Espanyol,4,1,1,2,4,5,-1,4,spain2
Alcorcon,4,1,1,2,3,5,-2,4,spain2
Burgos,4,1,1,2,5,8,-3,4,spain2
Villarreal B,4,1,0,3,5,8,-3,3,spain2
Cartagena,4,0,2,2,5,7,-2,2,spain2
Huesca,4,0,2,2,1,3,-2,2,spain2
Real Zaragoza,4,0,2,2,5,8,-3,2,spain2
Albacete,4,0,1,3,1,8,-7,1,spain2
Amorebieta,4,0,1,3,1,10,-9,1,spain2
Elfsborg,4,4,0,0,10,2,8,12,sweden
Varnamo,4,4,0,0,11,5,6,12,sweden
Sirius,4,3,1,0,9,6,3,10,sweden
Djurgarden,4,3,1,0,4,1,3,10,sweden
Malmo FF,4,3,0,1,8,2,6,9,sweden
Hacken,4,2,1,1,9,5,4,7,sweden
Kalmar,4,2,0,2,5,5,0,6,sweden
Hammarby,4,0,4,0,5,5,0,4,sweden
Mjallby,4,1,1,2,5,6,-1,4,sweden
AIK,4,1,1,2,2,6,-4,4,sweden
Halmstad,4,0,3,1,2,3,-1,3,sweden
Norrkoping,4,1,0,3,3,7,-4,3,sweden
Degerfors,4,0,2,2,4,7,-3,2,sweden
IFK Goteborg,4,0,1,3,3,7,-4,1,sweden
Varberg BoIS,4,0,1,3,2,9,-7,1,sweden
Brommapojkarna,4,0,0,4,4,10,-6,0,sweden
Vasteras,4,4,0,0,9,2,7,12,sweden2
GAIS,4,3,0,1,10,3,7,9,sweden2
Brage,4,3,0,1,9,4,5,9,sweden2
Skovde AIK,4,2,1,1,9,6,3,7,sweden2
Ostersunds,4,2,1,1,7,6,1,7,sweden2
GIF Sundsvall,4,2,1,1,5,4,1,7,sweden2
Oster,4,2,0,2,5,3,2,6,sweden2
Helsingborg,4,1,2,1,4,2,2,5,sweden2
Landskrona,4,1,2,1,6,6,0,5,sweden2
Utsikten,4,1,2,1,4,5,-1,5,sweden2
Orgryte,4,1,1,2,3,5,-2,4,sweden2
Trelleborg,4,1,1,2,2,9,-7,4,sweden2
Jonkopings,4,0,3,1,6,8,-2,3,sweden2
Gefle,4,0,3,1,4,6,-2,3,sweden2
AFC Eskilstuna,4,0,2,2,3,8,-5,2,sweden2
Orebro,4,0,0,4,4,12,-8,0,sweden2
Servette,4,4,0,0,8,3,5,12,switzerland
FC Zurich,4,2,2,0,8,4,4,8,switzerland
BSC Young Boys,4,2,2,0,5,1,4,8,switzerland
Lausanne Sport,4,2,1,1,9,5,4,7,switzerland
St. Gallen,4,2,0,2,8,4,4,6,switzerland
Grasshopper,4,2,0,2,6,5,1,6,switzerland
Lausanne Ouchy,4,1,2,1,6,7,-1,5,switzerland
Winterthur,4,1,1,2,7,8,-1,4,switzerland
Lugano,4,1,1,2,5,6,-1,4,switzerland
Yverdon,4,1,1,2,3,6,-3,4,switzerland
Luzern,4,1,0,3,6,12,-6,3,switzerland
FC Basel,4,0,0,4,0,10,-10,0,switzerland
Al Ittihad,4,4,0,0,6,1,5,12,syria
Foutoua,4,3,1,0,8,3,5,10,syria
Teshrin,4,3,0,1,3,2,1,9,syria
Al Wahda,4,1,3,0,3,2,1,6,syria
Al Jaish,4,1,2,1,4,4,0,5,syria
Wathbah,4,1,1,2,3,4,-1,4,syria
Jabala,4,1,1,2,2,3,-1,4,syria
Taliya,4,0,3,1,2,3,-1,3,syria
Karama,4,0,3,1,1,2,-1,3,syria
Hottin,4,0,2,2,3,5,-2,2,syria
Al-Jazira,0,0,0,0,0,0,0,0,syria
Majd,4,0,0,4,1,9,-8,0,syria
Simba,4,4,0,0,10,3,7,12,tanzania
Dodoma Jiji,4,3,1,0,6,3,3,10,tanzania
Young Africans,4,3,0,1,9,4,5,9,tanzania
Kagera Sugar,4,2,1,1,4,2,2,7,tanzania
JKT Tanzania,4,2,1,1,4,3,1,7,tanzania
Azam,4,2,0,2,7,6,1,6,tanzania
Namungo,4,1,2,1,6,5,1,5,tanzania
Coastal Union,4,1,2,1,2,1,1,5,tanzania
KMC,4,1,2,1,3,3,0,5,tanzania
Tabora,4,1,2,1,2,2,0,5,tanzania
S. Big Star,4,1,1,2,6,8,-2,4,tanzania
T. Prisons,4,0,3,1,3,4,-1,3,tanzania
Mtibwa Sugar,4,1,0,3,4,6,-2,3,tanzania
Ihefu,4,0,2,2,3,5,-2,2,tanzania
Geita Gold,4,0,2,2,3,8,-5,2,tanzania
Mashujaa,4,0,1,3,0,6,-6,1,tanzania
Bangkok Utd,4,4,0,0,10,2,8,12,thailand
Pathum Utd,4,3,1,0,8,1,7,10,thailand
Port FC,4,3,0,1,15,6,9,9,thailand
Uthai Thani,4,3,0,1,9,8,1,9,thailand
Ratchaburi,4,2,1,1,8,6,2,7,thailand
Police Tero,4,2,1,1,6,6,0,7,thailand
Buriram Utd,4,1,3,0,4,3,1,6,thailand
Muang Thong Utd,4,2,0,2,7,7,0,6,thailand
Trat,4,2,0,2,6,9,-3,6,thailand
Chiangrai Utd,4,1,2,1,4,4,0,5,thailand
Chonburi,4,1,2,1,4,5,-1,5,thailand
Lamphun Warrior,4,1,1,2,5,7,-2,4,thailand
Nakhon Pathom,4,1,0,3,8,10,-2,3,thailand
Sukhothai,4,1,0,3,5,8,-3,3,thailand
Khon Kaen Utd,4,1,0,3,6,12,-6,3,thailand
Prachuap,4,0,1,3,3,7,-4,1,thailand
Suphanburi,4,3,1,0,8,2,6,10,thailand2
Nakhon Si Thamm,4,3,1,0,7,3,4,10,thailand2
N. Bua Pitchaya,4,3,0,1,9,7,2,9,thailand2
Ayutthaya Utd,4,2,2,0,6,3,3,8,thailand2
Lampang,4,2,2,0,5,3,2,8,thailand2
Rayong,4,2,1,1,8,3,5,7,thailand2
Chiangmai FC,4,2,0,2,10,5,5,6,thailand2
Kanchanaburi,4,2,0,2,9,6,3,6,thailand2
Phrae Utd,4,2,0,2,8,7,1,6,thailand2
Chiangmai Utd,4,1,2,1,7,6,1,5,thailand2
Samut Prakan,4,1,2,1,6,5,1,5,thailand2
Pattaya United,4,1,2,1,6,6,0,5,thailand2
N. Ratchasima,4,1,2,1,2,2,0,5,thailand2
Chainat,4,1,1,2,4,6,-2,4,thailand2
Chanthaburi,4,0,1,3,8,12,-4,1,thailand2
Kasetsart,4,0,1,3,5,14,-9,1,thailand2
Krabi,4,0,1,3,4,13,-9,1,thailand2
Customs Utd,4,0,1,3,3,12,-9,1,thailand2
Fenerbahce,4,4,0,0,16,2,14,12,turkey
Galatasaray,4,4,0,0,7,2,5,12,turkey
Adana Demirspor,4,3,0,1,8,2,6,9,turkey
Besiktas,4,3,0,1,7,2,5,9,turkey
Sivasspor,4,2,1,1,5,4,1,7,turkey
Trabzonspor,4,2,1,1,3,2,1,7,turkey
Kayserispor,4,2,1,1,5,5,0,7,turkey
Ankaragucu,4,2,0,2,7,4,3,6,turkey
Kasimpasa,4,2,0,2,5,5,0,6,turkey
Antalyaspor,4,2,0,2,3,4,-1,6,turkey
Gaziantep,4,2,0,2,3,5,-2,6,turkey
Basaksehir,4,1,2,1,2,1,1,5,turkey
F. Karagumruk,4,1,1,2,5,5,0,4,turkey
Hatayspor,4,1,1,2,6,7,-1,4,turkey
Istanbulspor,4,1,0,3,4,8,-4,3,turkey
Alanyaspor,4,1,0,3,3,8,-5,3,turkey
Pendikspor,4,1,0,3,5,11,-6,3,turkey
Rizespor,4,1,0,3,2,9,-7,3,turkey
Samsunspor,4,0,1,3,1,5,-4,1,turkey
Konyaspor,4,0,0,4,2,10,-8,0,turkey
Goztepe,4,4,0,0,7,0,7,12,turkey2
Genclerbirligi,4,2,2,0,8,4,4,8,turkey2
Kocaelispor,4,2,2,0,8,4,4,8,turkey2
Sakaryaspor,4,2,2,0,6,3,3,8,turkey2
Bandirmaspor,4,2,1,1,3,2,1,7,turkey2
Erzurum BB,4,2,1,1,3,2,1,7,turkey2
Umraniyespor,4,2,0,2,6,4,2,6,turkey2
Eyupspor,4,2,0,2,6,5,1,6,turkey2
Adanaspor,4,2,0,2,5,5,0,6,turkey2
Boluspor,4,2,0,2,3,4,-1,6,turkey2
Bodrumspor,4,2,0,2,5,7,-2,6,turkey2
Tuzlaspor,4,1,1,2,4,4,0,4,turkey2
Manisa BB,4,0,3,1,6,7,-1,3,turkey2
Keciorengucu,4,1,0,3,1,6,-5,3,turkey2
Corum,4,0,2,2,5,7,-2,2,turkey2
Giresunspor,4,0,2,2,2,5,-3,2,turkey2
Sanliurfaspor,4,0,2,2,2,6,-4,2,turkey2
Altay,4,0,1,3,1,8,-7,1,turkey2
Al Wasl,4,2,2,0,12,5,7,8,uae
Shabab Al Ahli,4,2,2,0,10,6,4,8,uae
Al Sharjah,4,2,1,1,11,5,6,7,uae
Al Bataeh,4,2,1,1,7,5,2,7,uae
Al Nasr,4,2,1,1,7,5,2,7,uae
Ittihad Kalba,4,2,0,2,9,9,0,6,uae
Al Ain,4,2,0,2,7,7,0,6,uae
Al Wahda,4,2,0,2,5,6,-1,6,uae
Al Jazira,4,1,2,1,7,7,0,5,uae
Al Khaleej,4,1,1,2,8,10,-2,4,uae
Bani Yas,4,1,1,2,4,9,-5,4,uae
Hatta,4,1,0,3,5,12,-7,3,uae
Ajman,4,0,2,2,5,13,-8,2,uae
Emirates,4,0,1,3,4,10,-6,1,uae
Polessya,4,3,1,0,7,2,5,10,ukraine
Kryvbas KR,4,3,0,1,8,4,4,9,ukraine
Dnipro-1,4,3,0,1,6,5,1,9,ukraine
Chornomorets,4,2,1,1,8,2,6,7,ukraine
Shakhtar,4,2,1,1,6,3,3,7,ukraine
Kolos Kovalivka,4,1,3,0,2,1,1,6,ukraine
Obolon,4,2,0,2,4,7,-3,6,ukraine
Rukh Lviv,4,1,2,1,5,4,1,5,ukraine
LNZ Cherkasy,4,1,2,1,3,3,0,5,ukraine
Zorya Luhansk,4,1,1,2,4,4,0,4,ukraine
Oleksandria,4,0,2,2,2,5,-3,2,ukraine
Vorskla Poltava,4,0,2,2,4,8,-4,2,ukraine
FC Minaj,4,0,2,2,0,4,-4,2,ukraine
Veres,4,0,2,2,2,7,-5,2,ukraine
Dynamo Kyiv,4,0,1,3,3,6,-3,1,ukraine
Metalist 1925,4,0,1,3,3,7,-4,1,ukraine
Nacional,4,3,1,0,10,2,8,10,uruguay
Penarol,4,3,1,0,7,2,5,10,uruguay
Liverpool M.,4,2,1,1,8,6,2,7,uruguay
La Luz,4,2,1,1,7,6,1,7,uruguay
Defensor S.,4,1,3,0,8,4,4,6,uruguay
Cerro Largo,4,1,3,0,4,3,1,6,uruguay
Cerro,4,1,3,0,3,2,1,6,uruguay
Fenix,4,2,0,2,5,5,0,6,uruguay
D. Maldonado,4,1,2,1,6,7,-1,5,uruguay
River Plate,4,1,2,1,5,7,-2,5,uruguay
Wanderers,4,1,1,2,3,5,-2,4,uruguay
Plaza Colonia,4,0,3,1,4,5,-1,3,uruguay
Boston River,4,0,3,1,5,7,-2,3,uruguay
Montevideo City,4,0,2,2,4,9,-5,2,uruguay
Racing CM,4,0,1,3,2,6,-4,1,uruguay
Danubio,4,0,1,3,3,8,-5,1,uruguay
Wanderers,4,3,1,0,9,3,6,10,uruguay2
Cerro,4,3,1,0,4,1,3,10,uruguay2
Defensor S.,4,3,0,1,7,3,4,9,uruguay2
Penarol,4,3,0,1,6,3,3,9,uruguay2
Nacional,4,2,1,1,7,4,3,7,uruguay2
Liverpool M.,4,2,1,1,6,5,1,7,uruguay2
Fenix,4,2,0,2,5,3,2,6,uruguay2
Cerro Largo,4,2,0,2,4,3,1,6,uruguay2
River Plate,4,1,2,1,1,4,-3,5,uruguay2
Montevideo City,4,1,1,2,4,5,-1,4,uruguay2
Danubio,4,1,1,2,2,3,-1,4,uruguay2
Racing CM,4,1,1,2,4,7,-3,4,uruguay2
D. Maldonado,4,1,0,3,6,8,-2,3,uruguay2
Boston River,4,1,0,3,2,4,-2,3,uruguay2
Plaza Colonia,4,0,2,2,4,9,-5,2,uruguay2
La Luz,4,0,1,3,3,9,-6,1,uruguay2
Orlando City,4,4,0,0,9,2,7,12,usa
Charlotte,4,3,1,0,8,2,6,10,usa
New York RB,4,3,0,1,6,2,4,9,usa
Sporting KC,4,3,0,1,9,8,1,9,usa
Houston Dynamo,4,2,2,0,9,3,6,8,usa
Seattle,4,2,2,0,4,1,3,8,usa
Columbus Crew,4,2,2,0,6,4,2,8,usa
Los Angeles FC,4,2,1,1,10,5,5,7,usa
New York City,4,2,1,1,5,3,2,7,usa
Cincinnati,4,2,1,1,7,6,1,7,usa
Real Salt Lake,4,2,1,1,6,5,1,7,usa
Dallas,4,1,3,0,6,3,3,6,usa
Vancouver,4,1,3,0,6,3,3,6,usa
Chicago Fire,4,2,0,2,5,4,1,6,usa
St. Louis City,4,2,0,2,6,7,-1,6,usa
Atlanta Utd,4,1,2,1,9,7,2,5,usa
Philadelphia,4,1,2,1,5,5,0,5,usa
Austin,4,1,1,2,6,6,0,4,usa
SJ Earthquakes,4,0,4,0,4,4,0,4,usa
CF Montreal,4,1,1,2,6,7,-1,4,usa
Nashville SC,4,1,1,2,3,4,-1,4,usa
Minnesota Utd,4,1,1,2,8,11,-3,4,usa
DC United,4,1,1,2,7,10,-3,4,usa
Portland,4,1,1,2,8,12,-4,4,usa
Colorado Rapids,4,1,1,2,3,7,-4,4,usa
New England,4,1,0,3,7,9,-2,3,usa
Inter Miami,4,0,1,3,3,8,-5,1,usa
LA Galaxy,4,0,1,3,6,13,-7,1,usa
Toronto,4,0,0,4,2,11,-9,0,usa
San Diego Loyal,4,3,1,0,10,3,7,10,usa2
Colorado S.,4,3,1,0,9,3,6,10,usa2
Pittsburgh,4,3,1,0,7,3,4,10,usa2
Orange County,4,3,1,0,6,2,4,10,usa2
New Mexico,4,3,0,1,9,4,5,9,usa2
Miami FC,4,3,0,1,6,2,4,9,usa2
Sacramento R.,4,3,0,1,6,4,2,9,usa2
Tampa Bay,4,3,0,1,6,4,2,9,usa2
Indy Eleven,4,2,1,1,8,5,3,7,usa2
El Paso,4,2,1,1,5,7,-2,7,usa2
Memphis,4,2,0,2,10,8,2,6,usa2
Charleston,4,2,0,2,6,6,0,6,usa2
Birmingham L.,4,2,0,2,4,4,0,6,usa2
San Antonio,4,1,2,1,9,6,3,5,usa2
Rio Grande,4,1,2,1,7,7,0,5,usa2
Louisville City,4,1,1,2,5,7,-2,4,usa2
Detroit City,4,1,1,2,3,6,-3,4,usa2
FC Tulsa,4,1,0,3,9,9,0,3,usa2
Phoenix Rising,4,0,2,2,3,6,-3,2,usa2
Hartford A.,4,0,2,2,5,10,-5,2,usa2
Oakland Roots,4,0,1,3,6,11,-5,1,usa2
Las Vegas L.,4,0,1,3,3,8,-5,1,usa2
Monterey Bay,4,0,1,3,3,9,-6,1,usa2
Loudoun Utd,4,0,0,4,2,8,-6,0,usa2
Union Omaha,4,3,1,0,10,2,8,10,usa3
North Carolina,4,3,1,0,6,2,4,10,usa3
N. Colorado,4,3,0,1,7,3,4,9,usa3
Chattanooga RW,4,2,1,1,11,9,2,7,usa3
Tormenta,4,2,1,1,3,5,-2,7,usa3
Charlotte,4,1,2,1,5,6,-1,5,usa3
Greenville,4,1,2,1,5,6,-1,5,usa3
Central Valley,4,1,0,3,8,11,-3,3,usa3
One Knoxville,4,0,2,2,4,6,-2,2,usa3
Lexington,4,0,2,2,6,9,-3,2,usa3
Richmond K.,4,0,1,3,7,10,-3,1,usa3
Forward Madison,4,0,1,3,2,7,-5,1,usa3
AMGK,4,4,0,0,8,4,4,12,uzbekistan
Nasaf Qarshi,4,3,1,0,6,1,5,10,uzbekistan
Navbahor,4,3,0,1,10,2,8,9,uzbekistan
Pakhtakor,4,2,1,1,5,2,3,7,uzbekistan
Andijan,4,2,0,2,3,5,-2,6,uzbekistan
Qizilqum,4,1,2,1,6,4,2,5,uzbekistan
Bunyodkor,4,1,2,1,5,5,0,5,uzbekistan
Metallurg,4,1,2,1,3,3,0,5,uzbekistan
FK Olympic,4,1,2,1,3,4,-1,5,uzbekistan
Termez Surkhon,4,1,1,2,4,5,-1,4,uzbekistan
Turan,4,1,1,2,3,6,-3,4,uzbekistan
Neftchi,4,0,1,3,2,6,-4,1,uzbekistan
Buxoro,4,0,1,3,0,7,-7,1,uzbekistan
Sogdiana,4,0,0,4,5,10,-5,0,uzbekistan
D. Tachira,4,3,1,0,4,1,3,10,venezuela
Puerto Cabello,4,3,0,1,8,4,4,9,venezuela
Zamora,4,2,1,1,8,5,3,7,venezuela
Rayo Zuliano,4,2,1,1,3,2,1,7,venezuela
Portuguesa,4,2,1,1,6,6,0,7,venezuela
Angostura,4,2,0,2,6,5,1,6,venezuela
M. de Guayana,4,2,0,2,4,5,-1,6,venezuela
Carabobo,4,1,2,1,4,3,1,5,venezuela
UCV,4,1,2,1,5,5,0,5,venezuela
E. Merida,4,1,2,1,4,4,0,5,venezuela
D. La Guaira,4,0,4,0,6,6,0,4,venezuela
Caracas,4,0,4,0,1,1,0,4,venezuela
Metropolitanos,4,1,1,2,7,10,-3,4,venezuela
H. Colmenares,4,0,2,2,2,5,-3,2,venezuela
Monagas,4,0,1,3,4,8,-4,1,venezuela
Cong An Nhan,4,3,1,0,8,3,5,10,vietnam
Ha Noi,4,3,0,1,10,6,4,9,vietnam
Binh Duong,4,2,1,1,6,2,4,7,vietnam
Ho Chi Minh,4,2,1,1,2,3,-1,7,vietnam
S. Khanh Hoa,4,2,0,2,7,7,0,6,vietnam
Nam Dinh,4,2,0,2,5,5,0,6,vietnam
H. A. Gia Lai,4,2,0,2,3,3,0,6,vietnam
Song Lam Nghe,4,2,0,2,3,5,-2,6,vietnam
Binh Dinh,4,1,2,1,4,4,0,5,vietnam
Hai Phong,4,1,1,2,4,5,-1,4,vietnam
The Cong,4,1,1,2,3,6,-3,4,vietnam
Da Nang,4,1,0,3,3,4,-1,3,vietnam
Hong Linh Ha T.,4,0,3,1,1,3,-2,3,vietnam
Thanh Hoa,4,0,2,2,2,5,-3,2,vietnam
Pho Hien,4,4,0,0,11,3,8,12,vietnam2
Long An,4,3,1,0,11,4,7,10,vietnam2
Quang Nam,4,3,0,1,17,5,12,9,vietnam2
Binh Phuoc,4,2,0,2,7,6,1,6,vietnam2
Hue,4,1,2,1,9,4,5,5,vietnam2
Hoa Binh,4,1,1,2,6,8,-2,4,vietnam2
Ba Ria Vung Tau,4,1,1,2,2,8,-6,4,vietnam2
Phu Tho,4,0,3,1,4,6,-2,3,vietnam2
Binh Thuan,4,1,0,3,5,19,-14,3,vietnam2
Phu Dong,4,0,0,4,3,12,-9,0,vietnam2
The New Saints,4,4,0,0,18,4,14,12,wales
Cardiff MU,4,3,0,1,8,8,0,9,wales
Connah`s Quay,4,2,2,0,11,3,8,8,wales
Newtown,4,2,1,1,7,3,4,7,wales
Bala Town,4,2,1,1,5,4,1,7,wales
Caernarfon Town,4,2,0,2,9,11,-2,6,wales
Barry Town,4,2,0,2,6,8,-2,6,wales
Haverfordwest,4,1,1,2,4,7,-3,4,wales
Aberystwyth,4,1,1,2,3,7,-4,4,wales
Pontypridd Town,4,1,0,3,3,8,-5,3,wales
Colwyn Bay,4,0,1,3,4,11,-7,1,wales
Penybont,4,0,0,4,5,13,-8,0,wales
