Equipe,GP,W,D,L,GF,GA,GD,Pts,albania2
Bylis,6,6,0,0,11,4,7,18,albania2
Apolonia Fier,7,3,3,1,10,4,6,12,albania2
Flamurtari,7,3,2,2,8,5,3,11,albania2
AF Elbasani,7,3,2,2,10,8,2,11,albania2
Vora,7,3,1,3,9,9,0,10,albania2
Korabi Peshkopi,8,1,4,3,3,5,-2,7,albania2
Lushnja,7,1,2,4,10,14,-4,5,albania2
Luzi 2008,8,1,1,6,8,12,-4,4,albania2
Burreli,8,1,1,6,2,12,-10,4,albania2
Besa Kavaje,7,0,3,4,7,15,-8,3,albania2
Kastrioti Kruje,7,0,2,5,4,12,-8,2,albania2
Tomori Berat,8,0,1,7,4,24,-20,1,albania2
MC Alger,4,3,0,1,7,5,2,9,algeria
Paradou AC,4,2,1,1,6,1,5,7,algeria
CR Belouizdad,3,2,0,1,5,2,3,6,algeria
JS Kabylie,5,2,0,3,5,5,0,6,algeria
US Biskra,5,1,2,2,5,6,-1,5,algeria
CS Constantine,4,1,1,2,4,5,-1,4,algeria
NC Magra,4,1,1,2,1,5,-4,4,algeria
JS Saoura,4,1,1,2,2,8,-6,4,algeria
Khenchela,4,1,0,3,3,8,-5,3,algeria
US Souf,4,1,0,3,2,9,-7,3,algeria
ASO Chlef,4,0,2,2,5,7,-2,2,algeria
El Bayadh,5,0,2,3,2,7,-5,2,algeria
MC Oran,3,0,1,2,0,3,-3,1,algeria
ES Setif,4,0,1,3,4,8,-4,1,algeria
Ben Aknoun,5,0,1,4,1,9,-8,1,algeria
USM Alger,4,0,0,4,1,5,-4,0,algeria
Koléa,5,3,1,1,6,3,3,10,algeria2
Oued Akbou,4,3,0,1,7,5,2,9,algeria2
Mostaganem,4,2,2,0,5,1,4,8,algeria2
MSP Batna,5,2,1,2,4,5,-1,7,algeria2
Tiaret,5,2,1,2,3,7,-4,7,algeria2
GC Mascara,3,2,0,1,5,3,2,6,algeria2
RC Kouba,3,2,0,1,3,2,1,6,algeria2
Bordj Menaïel,3,1,2,0,4,3,1,5,algeria2
Mechria,4,1,2,1,4,4,0,5,algeria2
MO Constantine,4,1,2,1,4,4,0,5,algeria2
Khemis El K.,5,1,2,2,3,5,-2,5,algeria2
Hussein Dey,5,1,2,2,3,7,-4,5,algeria2
ASM Oran,3,1,1,1,4,4,0,4,algeria2
Temouchent,4,1,1,2,3,4,-1,4,algeria2
El Ghozlane,4,1,1,2,4,6,-2,4,algeria2
Khemis Melina,5,1,1,3,5,8,-3,4,algeria2
CA Batna,3,0,3,0,0,0,0,3,algeria2
Teleghma,3,1,0,2,6,7,-1,3,algeria2
Olympique Medea,4,1,0,3,3,9,-6,3,algeria2
WA Mostaganem,4,0,2,2,2,4,-2,2,algeria2
Khroub,4,0,2,2,2,5,-3,2,algeria2
RB Ouargla,4,0,2,2,1,4,-3,2,algeria2
El Eulma,4,0,2,2,0,8,-8,2,algeria2
WA Boufarik,4,0,1,3,3,6,-3,1,algeria2
Oued Sly,3,0,1,2,0,3,-3,1,algeria2
El Harrach,5,0,1,4,4,8,-4,1,algeria2
Chelghoum,4,0,1,3,2,6,-4,1,algeria2
Mlila,5,0,1,4,1,6,-5,1,algeria2
Oued Magrane,3,0,0,3,1,5,-4,0,algeria2
UE Santa Coloma,6,6,0,0,14,4,10,18,andorra
Inter Escaldes,6,4,1,1,17,5,12,13,andorra
FC Santa Coloma,5,4,0,1,14,3,11,12,andorra
Penya Encarnada,6,3,1,2,9,6,3,10,andorra
Carroi,7,3,0,4,8,18,-10,9,andorra
A. Escaldes,6,2,1,3,8,6,2,7,andorra
Pas de la Casa,4,1,1,2,4,5,-1,4,andorra
Ordino,6,1,1,4,4,9,-5,4,andorra
A. America,4,0,1,3,2,14,-12,1,andorra
Esperanca,5,0,0,5,3,17,-14,0,andorra
T. de Cordoba,8,4,2,2,12,8,4,14,argentina
Argentinos Jrs,8,3,3,2,5,3,2,12,argentina
Estudiantes,8,3,3,2,8,8,0,12,argentina
A. Tucuman,8,3,2,3,8,8,0,11,argentina
Boca Juniors,8,3,2,3,8,9,-1,11,argentina
River Plate,8,2,4,2,13,11,2,10,argentina
Union Santa Fe,8,2,4,2,4,4,0,10,argentina
San Lorenzo,8,2,4,2,5,6,-1,10,argentina
Barracas C.,8,2,4,2,7,9,-2,10,argentina
Gimnasia,8,2,3,3,9,12,-3,9,argentina
Lanus,8,1,5,2,11,12,-1,8,argentina
Tigre,8,2,2,4,6,7,-1,8,argentina
Defensa y J.,8,2,2,4,8,11,-3,8,argentina
Racing Club,8,1,4,3,9,11,-2,7,argentina
Central Cordoba,8,1,4,3,8,11,-3,7,argentina
Godoy Cruz,8,1,4,3,6,9,-3,7,argentina
Sarmiento,8,2,1,5,4,10,-6,7,argentina
Newells,8,1,3,4,6,9,-3,6,argentina
Banfield,8,1,3,4,6,12,-6,6,argentina
Rosario Central,8,0,5,3,4,9,-5,5,argentina
Platense,8,1,2,5,5,11,-6,5,argentina
Independiente,8,1,2,5,6,13,-7,5,argentina
Huracan,8,1,1,6,1,7,-6,4,argentina
Velez Sarsfield,8,1,1,6,5,12,-7,4,argentina
Belgrano,8,1,1,6,2,12,-10,4,argentina
Instituto,8,1,1,6,6,17,-11,4,argentina
Colon Santa Fe,8,0,3,5,1,9,-8,3,argentina
Arsenal Sarandi,8,0,2,6,1,8,-7,2,argentina
Chacarita J.,8,5,1,2,8,6,2,16,argentina3
Quilmes,8,4,3,1,11,5,6,15,argentina3
A. Rafaela,8,4,2,2,14,10,4,14,argentina3
I. Rivadavia,8,3,4,1,7,4,3,13,argentina3
E. Rio Cuarto,8,4,1,3,6,4,2,13,argentina3
D. Riestra,8,3,3,2,6,5,1,12,argentina3
Deportivo Moron,8,3,2,3,9,10,-1,11,argentina3
CA Guemes,8,3,2,3,9,11,-2,11,argentina3
Almirante Brown,8,3,2,3,6,10,-4,11,argentina3
D. de Belgrano,8,3,1,4,10,10,0,10,argentina3
Nueva Chicago,8,3,1,4,7,7,0,10,argentina3
Temperley,8,2,4,2,8,9,-1,10,argentina3
Chaco For Ever,8,3,1,4,6,10,-4,10,argentina3
Agropecuario,8,2,3,3,6,8,-2,9,argentina3
Atletico Mitre,8,3,0,5,9,14,-5,9,argentina3
Alvarado,8,2,2,4,10,11,-1,8,argentina3
Deportivo Maipu,8,2,2,4,9,11,-2,8,argentina3
SM San Juan,8,2,2,4,8,11,-3,8,argentina3
Brown de A.,8,2,2,4,5,9,-4,8,argentina3
E. Caseros,8,1,4,3,8,11,-3,7,argentina3
SM Tucuman,8,1,4,3,5,8,-3,7,argentina3
San Telmo,8,2,1,5,5,9,-4,7,argentina3
D. Madryn,8,0,6,2,2,5,-3,6,argentina3
Tristan Suarez,8,1,3,4,9,14,-5,6,argentina3
Aldosivi,8,1,3,4,2,10,-8,6,argentina3
Racing Cordoba,8,1,2,5,8,13,-5,5,argentina3
Ferro Carril,8,1,2,5,7,13,-6,5,argentina3
All Boys,8,0,4,4,4,9,-5,4,argentina3
Atlanta,8,1,1,6,4,10,-6,4,argentina3
Pyunik,8,6,2,0,22,6,16,20,armenia
Noah,8,5,0,3,16,10,6,15,armenia
Ararat-Armenia,8,4,3,1,12,6,6,15,armenia
Urartu,8,3,2,3,15,15,0,11,armenia
West Armenia,8,3,1,4,10,17,-7,10,armenia
Ararat Yerevan,8,3,0,5,9,13,-4,9,armenia
Alashkert,8,2,1,5,10,16,-6,7,armenia
BKMA,8,2,0,6,6,15,-9,6,armenia
Shirak,8,1,2,5,6,16,-10,5,armenia
Van,8,0,0,8,4,28,-24,0,armenia
Melbourne V.,4,2,2,0,9,6,3,8,australia
Macarthur FC,3,2,1,0,7,4,3,7,australia
Newcastle Jets,5,2,1,2,10,10,0,7,australia
Brisbane Roar,4,2,1,1,7,7,0,7,australia
Melbourne City,4,2,0,2,4,8,-4,6,australia
Western Sydney,3,1,2,0,5,4,1,5,australia
Wellington,3,1,2,0,2,1,1,5,australia
Adelaide Utd,3,1,1,1,7,6,1,4,australia
Sydney FC,3,1,0,2,5,6,-1,3,australia
Western United,4,1,0,3,2,11,-9,3,australia
Perth Glory,4,0,0,4,4,9,-5,0,australia
Central Coast,2,0,0,2,0,5,-5,0,australia
Salzburg,8,5,3,0,18,6,12,18,austria
Sturm Graz,8,5,2,1,14,7,7,17,austria
A. Klagenfurt,8,4,3,1,12,9,3,15,austria
Rapid Wien,8,4,2,2,15,5,10,14,austria
Hartberg,8,3,3,2,15,9,6,12,austria
LASK Linz,8,3,3,2,12,10,2,12,austria
Wolfsberger AC,8,2,3,3,9,12,-3,9,austria
Austria Wien,8,2,1,5,7,11,-4,7,austria
Tirol,8,2,1,5,6,11,-5,7,austria
Altach,8,1,3,4,6,12,-6,6,austria
BW Linz,8,2,0,6,9,18,-9,6,austria
A. Lustenau,8,0,3,5,3,12,-9,3,austria
Grazer AK,8,6,1,1,15,11,4,19,austria2
Bregenz,8,5,1,2,16,7,9,16,austria2
St. Polten,7,4,2,1,15,10,5,14,austria2
Kapfenberger,8,4,2,2,12,11,1,14,austria2
First Vienna,8,4,1,3,10,12,-2,13,austria2
Ried,8,3,3,2,12,6,6,12,austria2
Floridsdorfer,7,3,3,1,14,9,5,12,austria2
Leoben,7,3,2,2,11,8,3,11,austria2
Stripfing,8,3,1,4,9,10,-1,10,austria2
Liefering,7,2,1,4,10,12,-2,7,austria2
Lafnitz,8,2,1,5,8,17,-9,7,austria2
Admira Wacker,8,1,3,4,13,13,0,6,austria2
SV Horn,8,2,0,6,7,17,-10,6,austria2
Sturm Graz B,8,1,2,5,10,20,-10,5,austria2
Dornbirn,7,1,1,5,3,15,-12,4,austria2
Amstetten,8,0,2,6,6,16,-10,2,austria2
Neftci,8,4,2,2,10,6,4,14,azerbaijan
Qarabag,7,4,1,2,16,9,7,13,azerbaijan
Sebail,8,3,3,2,12,12,0,12,azerbaijan
Zira,8,3,2,3,4,4,0,11,azerbaijan
Sumqayit,8,3,2,3,12,15,-3,11,azerbaijan
Sabah,7,3,1,3,8,8,0,10,azerbaijan
Araz,8,2,3,3,9,9,0,9,azerbaijan
Kapaz,8,2,3,3,8,15,-7,9,azerbaijan
Turan,8,2,1,5,9,14,-5,7,azerbaijan
Qabala,8,1,2,5,3,15,-12,5,azerbaijan
Bashundhara K.,8,6,1,1,21,9,12,19,bangladesh
Mohammedan,8,6,0,2,18,6,12,18,bangladesh
B. Police,8,4,2,2,16,9,7,14,bangladesh
Abahani,8,3,2,3,16,9,7,11,bangladesh
Sheikh Russel,8,3,2,3,9,10,-1,11,bangladesh
Sheikh Jamal,8,2,4,2,7,10,-3,10,bangladesh
Fortis,8,2,3,3,12,15,-3,9,bangladesh
Rahmatgonj,8,2,3,3,9,15,-6,9,bangladesh
Chittagong,8,1,5,2,9,11,-2,8,bangladesh
Muktijoddha S.,8,2,1,5,7,18,-11,7,bangladesh
A. Uttara,8,0,2,6,4,21,-17,2,bangladesh
Dinamo Minsk,8,7,1,0,23,5,18,22,belarus
Neman Grodno,8,5,1,2,20,10,10,16,belarus
BATE Borisov,8,5,1,2,14,6,8,16,belarus
Isloch,8,5,1,2,10,5,5,16,belarus
Gomel,8,4,3,1,12,6,6,15,belarus
T. Zhodino,8,4,2,2,7,5,2,14,belarus
Dinamo Brest,8,4,0,4,10,13,-3,12,belarus
Slavia Mozyr,8,2,3,3,12,13,-1,9,belarus
Energetik-BGU,8,2,3,3,9,12,-3,9,belarus
Slutsk,8,2,2,4,12,15,-3,8,belarus
Naftan,8,2,1,5,12,21,-9,7,belarus
S. Soligorsk,8,1,3,4,13,15,-2,6,belarus
FC Minsk,8,1,2,5,2,9,-7,5,belarus
Smorgon,8,1,2,5,10,21,-11,5,belarus
Belshina,8,0,2,6,9,22,-13,2,belarus
Arsenal D.,8,7,0,1,20,8,12,21,belarus2
Dnepr Mogilev,8,6,2,0,19,1,18,20,belarus2
Vitebsk,8,5,2,1,15,5,10,17,belarus2
Zhodino Yuzhnoe,8,5,0,3,19,11,8,15,belarus2
Maxline,8,5,0,3,22,16,6,15,belarus2
FC Ostrovets,8,4,1,3,19,12,7,13,belarus2
Lida,8,3,1,4,12,17,-5,10,belarus2
S.Petrikov,8,3,0,5,9,13,-4,9,belarus2
Niva,8,3,0,5,15,20,-5,9,belarus2
Lokomotiv Gomel,8,2,3,3,6,13,-7,9,belarus2
Bumprom,8,3,0,5,9,17,-8,9,belarus2
Volna Pinsk,8,2,2,4,9,13,-4,8,belarus2
Orsha,8,1,3,4,14,18,-4,6,belarus2
Baranovichi,8,1,2,5,6,14,-8,5,belarus2
Molodechno-DYuS,8,1,2,5,10,26,-16,5,belarus2
Slonim,8,0,3,5,7,17,-10,3,belarus2
Osipovichy,8,0,0,8,3,18,-15,0,belarus2
Royale Union SG,8,6,1,1,17,9,8,19,belgium
Anderlecht,8,4,3,1,16,9,7,15,belgium
KRC Genk,8,4,2,2,13,7,6,14,belgium
Gent,8,3,4,1,11,8,3,13,belgium
Sint-Truiden,8,2,5,1,13,14,-1,11,belgium
Antwerp,8,2,4,2,13,10,3,10,belgium
Cercle Brugge,8,3,1,4,8,7,1,10,belgium
Westerlo,8,2,3,3,12,12,0,9,belgium
Standard Liege,8,2,3,3,10,17,-7,9,belgium
Club Brugge,8,2,2,4,10,8,2,8,belgium
KV Mechelen,8,2,2,4,9,14,-5,8,belgium
Eupen,8,2,1,5,8,15,-7,7,belgium
RWDM,8,1,2,5,8,19,-11,5,belgium
OH Leuven,8,1,1,6,9,22,-13,4,belgium
Charleroi,8,0,2,6,4,14,-10,2,belgium
Kortrijk,8,0,2,6,4,19,-15,2,belgium
U. de Vinto,8,2,6,0,6,3,3,12,bolivia
Real Tomayapo,8,4,0,4,7,12,-5,12,bolivia
The Strongest,8,2,4,2,11,12,-1,10,bolivia
Aurora,8,2,4,2,7,8,-1,10,bolivia
Oriente P.,8,2,1,5,12,16,-4,7,bolivia
Bolivar,8,1,3,4,16,16,0,6,bolivia
Wilstermann,8,1,3,4,7,11,-4,6,bolivia
I. Petrolero,8,2,0,6,9,17,-8,6,bolivia
Always Ready,8,1,3,4,5,15,-10,6,bolivia
Santa Cruz,8,2,0,6,5,17,-12,6,bolivia
Royal Pari,8,1,2,5,10,20,-10,5,bolivia
Libertad,8,1,2,5,7,20,-13,5,bolivia
Blooming,8,1,1,6,6,14,-8,4,bolivia
Vaca Diez,8,1,1,6,6,17,-11,4,bolivia
Nacional Potosi,8,0,3,5,9,18,-9,3,bolivia
A. Palmaflor,8,0,1,7,3,19,-16,1,bolivia
Guabira,8,0,0,8,2,16,-14,0,bolivia
The Strongest,8,5,2,1,14,4,10,17,bolivia2
Always Ready,8,4,2,2,12,8,4,14,bolivia2
Bolivar,8,3,3,2,17,14,3,12,bolivia2
Aurora,8,2,3,3,8,10,-2,9,bolivia2
Oriente P.,8,2,1,5,7,12,-5,7,bolivia2
Guabira,8,2,1,5,11,17,-6,7,bolivia2
Nacional Potosi,8,2,1,5,10,18,-8,7,bolivia2
U. de Vinto,8,1,2,5,6,10,-4,5,bolivia2
I. Petrolero,8,1,2,5,11,16,-5,5,bolivia2
A. Palmaflor,8,0,5,3,6,13,-7,5,bolivia2
Real Tomayapo,8,1,2,5,6,14,-8,5,bolivia2
Wilstermann,8,0,4,4,4,8,-4,4,bolivia2
Blooming,8,1,1,6,5,16,-11,4,bolivia2
U. Sucre,8,0,3,5,7,16,-9,3,bolivia2
Santa Cruz,8,1,0,7,7,21,-14,3,bolivia2
Royal Pari,8,0,2,6,3,13,-10,2,bolivia2
Atletico MG,8,4,3,1,13,8,5,15,brazil
Flamengo,8,4,2,2,12,6,6,14,brazil
Santos,8,4,2,2,10,15,-5,14,brazil
Corinthians,8,4,1,3,13,10,3,13,brazil
Internacional,8,4,1,3,9,9,0,13,brazil
Gremio,8,4,1,3,16,19,-3,13,brazil
Cuiaba,8,3,2,3,8,5,3,11,brazil
Cruzeiro,8,3,2,3,3,3,0,11,brazil
Bragantino,8,3,1,4,9,7,2,10,brazil
Fortaleza,8,3,1,4,9,12,-3,10,brazil
Bahia,8,3,0,5,17,16,1,9,brazil
Botafogo,8,2,3,3,10,11,-1,9,brazil
Palmeiras,8,2,3,3,10,12,-2,9,brazil
Vasco da Gama,8,2,3,3,7,9,-2,9,brazil
Coritiba,8,3,0,5,13,16,-3,9,brazil
Athletico PR,8,1,3,4,5,11,-6,6,brazil
Sao Paulo,8,1,3,4,3,11,-8,6,brazil
Goias,8,1,2,5,8,13,-5,5,brazil
Fluminense,8,1,2,5,4,9,-5,5,brazil
America MG,8,0,3,5,8,16,-8,3,brazil
CSKA Sofia,8,7,1,0,17,4,13,22,bulgaria
Ludogorets,8,6,1,1,16,2,14,19,bulgaria
CSKA 1948 Sofia,8,4,2,2,11,6,5,14,bulgaria
Cherno More,8,3,4,1,11,6,5,13,bulgaria
Arda,8,4,1,3,8,4,4,13,bulgaria
Botev Plovdiv,8,3,2,3,12,10,2,11,bulgaria
Levski Sofia,8,2,4,2,9,8,1,10,bulgaria
Lok. Plovdiv,8,2,4,2,9,12,-3,10,bulgaria
Lokomotiv Sofia,8,3,1,4,7,14,-7,10,bulgaria
L. Krumovgrad,8,2,1,5,7,12,-5,7,bulgaria
Pirin Blag.,8,2,1,5,6,14,-8,7,bulgaria
Hebar,8,2,0,6,9,15,-6,6,bulgaria
Slavia Sofia,8,1,2,5,6,16,-10,5,bulgaria
Etar,8,1,1,6,4,11,-7,4,bulgaria
Beroe,8,1,1,6,5,17,-12,4,bulgaria
Botev Vratsa,8,1,1,6,3,15,-12,4,bulgaria
Forge,8,5,1,2,15,8,7,16,canada
York Utd,8,4,2,2,16,14,2,14,canada
Cavalry,8,4,1,3,13,9,4,13,canada
A. Ottawa,8,4,0,4,10,8,2,12,canada
HFX Wanderers,8,2,3,3,9,9,0,9,canada
Valour,8,2,2,4,7,11,-4,8,canada
Pacific,8,2,1,5,10,14,-4,7,canada
Vancouver FC,8,2,0,6,6,14,-8,6,canada
Everton,8,6,0,2,12,5,7,18,chile
Colo-Colo,8,4,3,1,9,6,3,15,chile
Palestino,8,4,2,2,12,9,3,14,chile
Union La Calera,8,4,2,2,11,8,3,14,chile
O`Higgins,8,4,1,3,15,12,3,13,chile
Huachipato,8,4,1,3,10,10,0,13,chile
Coquimbo Unido,8,3,3,2,14,13,1,12,chile
Cobresal,8,3,3,2,10,12,-2,12,chile
Nublense,8,3,2,3,12,10,2,11,chile
Magallanes,8,3,1,4,12,13,-1,10,chile
U. Catolica,8,2,3,3,12,12,0,9,chile
Audax Italiano,8,3,0,5,9,14,-5,9,chile
U. de Chile,8,2,1,5,12,17,-5,7,chile
Union Espanola,8,2,0,6,8,15,-7,6,chile
Copiapo,8,0,4,4,6,11,-5,4,chile
Curico Unido,8,0,4,4,5,16,-11,4,chile
D. Iquique,8,4,4,0,13,7,6,16,chile2
S. Wanderers,8,4,2,2,9,8,1,14,chile2
S. Morning,8,3,3,2,11,8,3,12,chile2
San Luis,8,3,2,3,8,7,1,11,chile2
Barnechea,8,3,2,3,11,11,0,11,chile2
U. Concepcion,8,3,2,3,12,14,-2,11,chile2
Deportes Temuco,8,2,4,2,9,9,0,10,chile2
Antofagasta,8,3,1,4,12,13,-1,10,chile2
Cobreloa,8,2,3,3,12,14,-2,9,chile2
Puerto Montt,8,2,3,3,7,9,-2,9,chile2
La Serena,8,3,0,5,10,14,-4,9,chile2
Recoleta,8,2,2,4,9,11,-2,8,chile2
U. San Felipe,8,2,2,4,7,10,-3,8,chile2
Rangers,8,2,2,4,10,16,-6,8,chile2
CD Santa Cruz,8,2,1,5,8,10,-2,7,chile2
San Marcos,8,1,3,4,11,18,-7,6,chile2
Zhejiang,8,5,2,1,18,10,8,17,china
Shanghai Port,8,5,1,2,21,9,12,16,china
Beijing Guoan,8,4,2,2,13,9,4,14,china
S. Taishan,8,3,4,1,10,6,4,13,china
Wuhan Three T.,8,4,1,3,15,13,2,13,china
Chengdu,8,3,2,3,12,11,1,11,china
Nantong Zhiyun,8,2,4,2,12,11,1,10,china
Tianjin T.,8,3,1,4,10,9,1,10,china
S. Shenhua,8,2,2,4,7,13,-6,8,china
Changchun Yatai,8,1,3,4,5,10,-5,6,china
Meizhou Hakka,8,1,2,5,8,19,-11,5,china
Henan SL,8,1,1,6,7,19,-12,4,china
Qingdao Jonoon,8,0,3,5,3,10,-7,3,china
Cangzhou,8,1,0,7,4,27,-23,3,china
Dalian P.,8,0,2,6,6,17,-11,2,china
Shenzhen,8,0,1,7,6,22,-16,1,china
Sichuan Jiuniu,8,8,0,0,18,3,15,24,china2
Hebei Kungfu,8,4,2,2,11,6,5,14,china2
Qingdao Y. I.,8,3,4,1,13,9,4,13,china2
Wuxi Wugou,8,3,2,3,12,16,-4,11,china2
Jinan Xingzhou,8,2,4,2,9,9,0,10,china2
Jiangxi L.,8,2,3,3,7,9,-2,9,china2
Dongguan United,8,3,0,5,6,10,-4,9,china2
Guangxi Baoyun,8,1,5,2,6,8,-2,8,china2
Nanjing,8,1,5,2,4,9,-5,8,china2
Guangzhou FC,8,2,0,6,7,13,-6,6,china2
Shanghai Jiadin,8,1,3,4,4,11,-7,6,china2
Shenyang Urban,8,1,3,4,6,16,-10,6,china2
Dantong Hantong,8,1,2,5,2,10,-8,5,china2
Suzhou Dongwu,8,0,3,5,5,17,-12,3,china2
Heilongjiang L.,8,0,2,6,7,14,-7,2,china2
Yanbian Longdin,8,0,2,6,5,13,-8,2,china2
Deportes Tolima,8,5,1,2,8,8,0,16,colombia2
R. Aguilas,8,3,5,0,12,5,7,14,colombia2
America de Cali,8,3,5,0,11,7,4,14,colombia2
I. Medelin,8,2,6,0,13,8,5,12,colombia2
Junior,8,3,2,3,10,6,4,11,colombia2
Millonarios,8,2,2,4,7,11,-4,8,colombia2
Union Magdalena,8,2,2,4,8,16,-8,8,colombia2
Once Caldas,8,2,1,5,7,10,-3,7,colombia2
Santa Fe,8,1,4,3,10,14,-4,7,colombia2
D. Pereira,8,2,1,5,8,12,-4,7,colombia2
A. Nacional,8,2,1,5,7,12,-5,7,colombia2
A. Bucaramanga,8,2,1,5,5,11,-6,7,colombia2
A. Petrolera,8,2,1,5,3,10,-7,7,colombia2
La Equidad,8,1,3,4,6,13,-7,6,colombia2
Deportivo Cali,8,1,2,5,8,16,-8,5,colombia2
Boyaca Chico,8,0,5,3,4,12,-8,5,colombia2
Atletico Huila,8,1,1,6,4,11,-7,4,colombia2
Deportivo Pasto,8,1,1,6,4,14,-10,4,colombia2
Envigado,8,0,2,6,5,17,-12,2,colombia2
Jaguares de C.,8,0,2,6,0,12,-12,2,colombia2
Guanacasteca,8,5,2,1,11,10,1,17,costarica
Saprissa,8,5,1,2,15,10,5,16,costarica
Alajuelense,8,4,2,2,14,12,2,14,costarica
Herediano,8,3,3,2,11,7,4,12,costarica
Sporting SJ,8,2,2,4,8,15,-7,8,costarica
Cartagines,8,2,1,5,8,9,-1,7,costarica
San Carlos,8,2,1,5,10,12,-2,7,costarica
AD Grecia,8,2,1,5,6,19,-13,7,costarica
Puntarenas,8,1,2,5,8,13,-5,5,costarica
M. Liberia,8,1,1,6,12,19,-7,4,costarica
Santos DG,8,0,3,5,3,14,-11,3,costarica
Zeledon,8,1,0,7,2,20,-18,3,costarica
Slavia Prague,8,6,2,0,14,5,9,20,czechrepublic
Sparta Prague,8,5,2,1,16,8,8,17,czechrepublic
Viktoria Plzen,8,4,1,3,19,12,7,13,czechrepublic
Banik Ostrava,8,4,1,3,12,10,2,13,czechrepublic
Sigma Olomouc,8,3,2,3,12,10,2,11,czechrepublic
Slovacko,8,3,2,3,7,11,-4,11,czechrepublic
Teplice,8,2,1,5,9,13,-4,7,czechrepublic
Mlada Boleslav,8,2,1,5,14,19,-5,7,czechrepublic
Pardubice,8,2,1,5,8,16,-8,7,czechrepublic
Bohemians,8,2,1,5,6,15,-9,7,czechrepublic
Jablonec,8,1,3,4,6,11,-5,6,czechrepublic
Slovan Liberec,7,0,5,2,8,13,-5,5,czechrepublic
Zlin,8,1,2,5,5,15,-10,5,czechrepublic
Hradec Kralove,8,0,3,5,4,14,-10,3,czechrepublic
Karvina,8,1,0,7,5,17,-12,3,czechrepublic
C. Budejovice,8,0,1,7,4,22,-18,1,czechrepublic
FC Kobenhavn,8,5,2,1,18,12,6,17,denmark
FC Midtjylland,8,5,1,2,17,13,4,16,denmark
Brondby IF,8,4,3,1,14,8,6,15,denmark
Odense BK,8,4,2,2,13,8,5,14,denmark
AGF Aarhus,8,2,5,1,9,7,2,11,denmark
Silkeborg,8,3,1,4,11,11,0,10,denmark
Nordsjaelland,8,2,3,3,10,8,2,9,denmark
Lyngby,8,2,1,5,6,15,-9,7,denmark
Vejle BK,8,1,3,4,7,10,-3,6,denmark
Randers FC,8,1,3,4,9,16,-7,6,denmark
Hvidovre,8,1,3,4,5,14,-9,6,denmark
Viborg,8,1,1,6,4,15,-11,4,denmark
SonderjyskE,8,7,1,0,25,10,15,22,denmark2
Aalborg BK,8,5,3,0,15,7,8,18,denmark2
Hobro,8,6,0,2,11,5,6,18,denmark2
Hillerod,8,4,2,2,18,10,8,14,denmark2
Vendsyssel,8,4,2,2,10,6,4,14,denmark2
Fredericia,8,3,4,1,14,10,4,13,denmark2
B 93,8,4,1,3,8,7,1,13,denmark2
Kolding IF,8,4,0,4,11,14,-3,12,denmark2
AC Horsens,8,3,1,4,8,12,-4,10,denmark2
HB Koge,8,1,1,6,9,18,-9,4,denmark2
Helsingor,8,0,3,5,5,15,-10,3,denmark2
Naestved,8,0,2,6,8,20,-12,2,denmark2
Imbabura,8,3,4,1,11,8,3,13,ecuador3
Cuniburo,8,3,2,3,12,12,0,11,ecuador3
I. Juniors,8,3,2,3,7,8,-1,11,ecuador3
Macara,8,3,2,3,8,10,-2,11,ecuador3
Chacaritas,8,3,1,4,7,10,-3,10,ecuador3
Manta,8,2,3,3,10,13,-3,9,ecuador3
Vargas Torres,8,2,1,5,6,15,-9,7,ecuador3
America de Q.,8,1,3,4,8,15,-7,6,ecuador3
Nueve Octubre,8,2,0,6,6,14,-8,6,ecuador3
Guayaquil,8,0,3,5,5,19,-14,3,ecuador3
Future FC,3,3,0,0,6,1,5,9,egypt
ZED FC,4,2,2,0,6,4,2,8,egypt
Zamalek,4,2,1,1,7,5,2,7,egypt
Al Ahly,3,2,1,0,5,3,2,7,egypt
El Geish,4,2,1,1,5,3,2,7,egypt
El Gouna,4,1,3,0,5,4,1,6,egypt
Pyramids FC,3,2,0,1,2,2,0,6,egypt
Al Masry,4,2,0,2,7,9,-2,6,egypt
Baladiyyat,3,1,2,0,5,3,2,5,egypt
Smouha,4,1,2,1,4,6,-2,5,egypt
Al Ittihad,3,1,1,1,4,5,-1,4,egypt
Ceramica C.,4,1,1,2,3,4,-1,4,egypt
National Bank,4,1,0,3,6,7,-1,3,egypt
Pharco,4,1,0,3,4,6,-2,3,egypt
ENPPI,4,1,0,3,3,6,-3,3,egypt
Al Mokawloon,4,0,2,2,5,7,-2,2,egypt
Ismaily,4,0,1,3,2,6,-4,1,egypt
El Daklyeh,4,0,1,3,1,8,-7,1,egypt
Arsenal,8,5,1,2,13,7,6,16,england
Tottenham,8,4,3,1,18,12,6,15,england
Liverpool,8,4,3,1,14,9,5,15,england
Manchester City,8,4,1,3,15,11,4,13,england
Everton,7,4,1,2,10,11,-1,13,england
Manchester Utd,7,4,0,3,8,7,1,12,england
West Ham Utd,8,4,0,4,13,19,-6,12,england
Crystal Palace,8,3,2,3,8,11,-3,11,england
Aston Villa,8,3,2,3,10,15,-5,11,england
Chelsea,8,3,1,4,13,13,0,10,england
Brighton,7,3,1,3,15,16,-1,10,england
Bournemouth,8,3,1,4,13,18,-5,10,england
Brentford,8,2,1,5,8,10,-2,7,england
Wolverhampton,8,2,1,5,10,13,-3,7,england
Fulham,8,1,3,4,9,17,-8,6,england
Newcastle Utd,8,1,2,5,14,17,-3,5,england
Burnley,8,1,2,5,6,14,-8,5,england
Nottm Forest,8,1,2,5,6,17,-11,5,england
Luton Town,8,1,1,6,7,18,-11,4,england
Sheffield Utd,7,0,1,6,4,20,-16,1,england
Leicester City,8,6,1,1,18,7,11,19,england2
Ipswich Town,8,4,3,1,10,7,3,15,england2
Leeds Utd,8,4,2,2,11,7,4,14,england2
Swansea City,8,4,1,3,13,11,2,13,england2
Blackburn,8,4,0,4,16,13,3,12,england2
Southampton,8,3,3,2,9,12,-3,12,england2
Middlesbrough,8,3,2,3,18,15,3,11,england2
West Brom,8,3,2,3,12,9,3,11,england2
Sunderland,8,3,2,3,11,8,3,11,england2
Hull City,8,3,2,3,11,13,-2,11,england2
Millwall,8,2,4,2,11,8,3,10,england2
Cardiff City,8,3,1,4,9,9,0,10,england2
Huddersfield,8,2,3,3,8,13,-5,9,england2
Watford,8,2,3,3,7,12,-5,9,england2
QP Rangers,8,2,2,4,6,7,-1,8,england2
Stoke City,8,2,2,4,10,13,-3,8,england2
Bristol City,8,2,2,4,6,9,-3,8,england2
Preston,8,2,2,4,7,14,-7,8,england2
Coventry City,8,2,1,5,12,13,-1,7,england2
Norwich City,8,2,1,5,13,20,-7,7,england2
Sheffield Wed,8,1,1,6,2,11,-9,4,england2
Plymouth,8,0,2,6,6,17,-11,2,england2
Rotherham,8,0,2,6,2,19,-17,2,england2
Birmingham City,8,0,0,8,5,19,-14,0,england2
Portsmouth,8,5,3,0,14,6,8,18,england3
Bolton,8,5,2,1,14,5,9,17,england3
Barnsley,8,5,2,1,15,8,7,17,england3
Stevenage,8,5,1,2,15,8,7,16,england3
Oxford Utd,8,5,0,3,14,11,3,15,england3
Derby County,8,4,1,3,12,8,4,13,england3
Wycombe,8,3,2,3,13,12,1,11,england3
Leyton Orient,8,2,5,1,7,6,1,11,england3
Lincoln City,8,3,2,3,7,6,1,11,england3
Blackpool,8,2,3,3,11,12,-1,9,england3
Peterborough,8,2,3,3,11,12,-1,9,england3
Northampton,8,3,0,5,7,11,-4,9,england3
Port Vale,8,2,3,3,6,10,-4,9,england3
Wigan Athletic,8,2,2,4,11,11,0,8,england3
Fleetwood,8,2,2,4,8,13,-5,8,england3
Burton Albion,8,2,2,4,5,12,-7,8,england3
Charlton,8,1,4,3,9,12,-3,7,england3
Bristol Rovers,8,2,1,5,7,13,-6,7,england3
Exeter City,8,2,0,6,4,20,-16,6,england3
Cheltenham,8,1,2,5,6,13,-7,5,england3
Carlisle Utd,8,1,2,5,7,16,-9,5,england3
Shrewsbury,8,1,2,5,2,14,-12,5,england3
Cambridge Utd,8,0,3,5,5,14,-9,3,england3
Reading,8,1,0,7,8,20,-12,3,england3
Stockport,8,6,1,1,18,9,9,19,england4
Mansfield,8,4,3,1,17,8,9,15,england4
Barrow,8,4,2,2,13,8,5,14,england4
Harrogate,8,4,1,3,9,8,1,13,england4
Crewe Alexandra,8,3,3,2,18,15,3,12,england4
AFC Wimbledon,8,3,3,2,10,8,2,12,england4
Wrexham,8,3,3,2,7,10,-3,12,england4
Notts County,8,3,2,3,15,14,1,11,england4
Bradford,8,3,1,4,13,13,0,10,england4
Accrington,8,3,1,4,11,13,-2,10,england4
Walsall,8,3,1,4,11,16,-5,10,england4
Milton Keynes,8,2,3,3,10,11,-1,9,england4
Morecambe,8,3,0,5,11,18,-7,9,england4
Salford City,8,2,2,4,10,10,0,8,england4
Crawley Town,8,2,2,4,11,15,-4,8,england4
Forest Green,8,2,2,4,7,12,-5,8,england4
Doncaster,8,2,1,5,9,13,-4,7,england4
Newport,8,2,0,6,7,16,-9,6,england4
Colchester Utd,8,2,0,6,7,17,-10,6,england4
Gillingham,8,2,0,6,5,15,-10,6,england4
Swindon Town,8,1,2,5,11,20,-9,5,england4
Grimsby,8,0,4,4,9,15,-6,4,england4
Tranmere,8,0,2,6,6,17,-11,2,england4
Sutton Utd,8,0,2,6,9,23,-14,2,england4
Chesterfield,8,6,1,1,16,8,8,19,england5
Gateshead FC,8,4,3,1,18,7,11,15,england5
Bromley,8,4,3,1,12,8,4,15,england5
Barnet,8,5,0,3,18,16,2,15,england5
Oldham,8,4,2,2,14,14,0,14,england5
Aldershot Town,8,4,0,4,12,11,1,12,england5
Dagenham & R.,8,3,3,2,9,8,1,12,england5
Solihull Moors,8,3,3,2,10,16,-6,12,england5
Halifax Town,8,3,2,3,8,7,1,11,england5
Rochdale,8,3,2,3,12,13,-1,11,england5
Altrincham,8,3,2,3,8,11,-3,11,england5
Dorking,8,3,2,3,8,13,-5,11,england5
Woking,8,3,1,4,10,10,0,10,england5
York City,8,3,1,4,9,16,-7,10,england5
Boreham Wood,8,2,3,3,12,13,-1,9,england5
Eastleigh,8,2,2,4,11,14,-3,8,england5
Hartlepool,8,2,2,4,11,14,-3,8,england5
Southend Utd,8,1,5,2,8,11,-3,8,england5
Maidenhead Utd,8,2,2,4,12,16,-4,8,england5
AFC Fylde,8,2,1,5,11,14,-3,7,england5
Ebbsfleet Utd,8,1,3,4,11,21,-10,6,england5
Kidderminster,8,1,2,5,7,13,-6,5,england5
Oxford City,8,1,2,5,11,19,-8,5,england5
Wealdstone,8,0,0,8,6,16,-10,0,england5
Flora,8,4,3,1,11,7,4,15,estonia
Tallinna Kalev,8,3,3,2,15,9,6,12,estonia
Levadia,8,3,3,2,14,11,3,12,estonia
Paide,8,3,2,3,11,10,1,11,estonia
Vaprus,8,1,4,3,6,7,-1,7,estonia
Nomme Kalju,8,1,4,3,8,10,-2,7,estonia
Harju Jalgpalli,8,1,3,4,7,13,-6,6,estonia
Narva Trans,8,2,0,6,8,20,-12,6,estonia
Kuressaare,8,1,0,7,3,21,-18,3,estonia
Tammeka,8,0,2,6,8,21,-13,2,estonia
Nomme Utd,8,7,1,0,34,5,29,22,estonia2
Viimsi,8,5,2,1,12,5,7,17,estonia2
Flora B,8,4,1,3,18,12,6,13,estonia2
FC Tallinn,8,4,1,3,17,16,1,13,estonia2
Paide B,8,4,1,3,17,19,-2,13,estonia2
Levadia B,8,3,1,4,8,12,-4,10,estonia2
Tabasalu,8,3,0,5,14,20,-6,9,estonia2
Elva,8,3,0,5,9,18,-9,9,estonia2
Legion,8,1,3,4,12,20,-8,6,estonia2
Alliance,8,1,2,5,11,23,-12,5,estonia2
Vikingur,8,6,0,2,21,8,13,18,faroeislands
Klaksvik,8,5,2,1,20,7,13,17,faroeislands
HB Torshavn,8,5,1,2,19,9,10,16,faroeislands
B36 Torshavn,8,3,1,4,14,14,0,10,faroeislands
07 Vestur,8,3,1,4,10,13,-3,10,faroeislands
Streymur,8,2,3,3,10,18,-8,9,faroeislands
B68 Toftir,8,1,3,4,7,13,-6,6,faroeislands
TB Tvoroyri,8,1,1,6,2,13,-11,4,faroeislands
IF Fuglafjordur,8,1,0,7,5,22,-17,3,faroeislands
AB Argir,8,0,1,7,8,26,-18,1,faroeislands
Skala,8,5,1,2,24,10,14,16,faroeislands2
NSI Runavik,8,5,1,2,22,10,12,16,faroeislands2
Klaksvik B,8,5,0,3,23,10,13,15,faroeislands2
Hoyvik,8,3,2,3,17,14,3,11,faroeislands2
Vikingur B,8,3,0,5,13,12,1,9,faroeislands2
B71 Sandur,8,1,4,3,6,13,-7,7,faroeislands2
HB B,8,2,1,5,9,20,-11,7,faroeislands2
B36 Torshavn B,8,1,1,6,14,22,-8,4,faroeislands2
B68 Toftir B,8,0,0,8,5,25,-20,0,faroeislands2
Streymur B,8,0,0,8,5,40,-35,0,faroeislands2
VPS,8,8,0,0,16,1,15,24,finland
KuPS,8,5,3,0,17,9,8,18,finland
HJK Helsinki,8,5,2,1,17,11,6,17,finland
Ilves,8,3,2,3,15,9,6,11,finland
Inter Turku,8,3,2,3,11,11,0,11,finland
Honka,8,3,1,4,7,11,-4,10,finland
SJK,8,2,3,3,9,12,-3,9,finland
Mariehamn,8,2,2,4,12,13,-1,8,finland
Lahti,8,1,4,3,6,10,-4,7,finland
Haka,8,2,1,5,7,16,-9,7,finland
Oulu,8,2,0,6,11,17,-6,6,finland
KTP,8,1,1,6,6,15,-9,4,finland
Ekenas IF,8,6,1,1,18,7,11,19,finland2
Gnistan,8,3,4,1,13,11,2,13,finland2
Mikkelin,8,3,2,3,12,11,1,11,finland2
JaPS,8,3,2,3,10,11,-1,11,finland2
TPS,8,3,1,4,9,12,-3,10,finland2
HIFK,8,3,0,5,13,15,-2,9,finland2
SJK Akatemia,8,2,3,3,14,17,-3,9,finland2
Jaro,8,2,3,3,10,15,-5,9,finland2
SalPa,8,1,4,3,7,10,-3,7,finland2
KPV Kokkola,8,1,2,5,10,19,-9,5,finland2
KaPa,8,1,1,6,10,15,-5,4,finland2
JJK,8,0,2,6,8,21,-13,2,finland2
Paris SG,7,5,2,0,16,5,11,17,france
Nice,7,4,2,1,7,4,3,14,france
Brest,8,4,1,3,8,8,0,13,france
Monaco,8,3,3,2,16,16,0,12,france
Lille,8,2,5,1,9,8,1,11,france
Reims,8,3,2,3,12,12,0,11,france
Metz,8,3,1,4,8,15,-7,10,france
Lens,8,2,3,3,7,9,-2,9,france
Le Havre,8,1,5,2,7,10,-3,8,france
Montpellier,7,2,1,4,9,11,-2,7,france
Marseille,8,1,3,4,10,15,-5,6,france
Clermont,7,1,3,3,6,11,-5,6,france
Nantes,7,2,0,5,6,15,-9,6,france
Strasbourg,7,1,2,4,4,12,-8,5,france
Lyon,7,1,1,5,4,11,-7,4,france
Rennes,6,0,3,3,2,7,-5,3,france
Lorient,7,0,3,4,7,14,-7,3,france
Toulouse,8,0,3,5,3,13,-10,3,france
Laval,8,5,2,1,10,3,7,17,france2
Auxerre,8,4,3,1,14,9,5,15,france2
Saint-Etienne,8,4,1,3,9,10,-1,13,france2
Guingamp,8,3,3,2,7,7,0,12,france2
Angers,8,3,2,3,12,13,-1,11,france2
Concarneau,8,3,2,3,8,10,-2,11,france2
Pau FC,8,3,2,3,12,15,-3,11,france2
USL Dunkerque,8,3,2,3,9,12,-3,11,france2
Grenoble,8,2,4,2,9,9,0,10,france2
Paris FC,8,3,1,4,8,11,-3,10,france2
Annecy,8,2,3,3,8,11,-3,9,france2
Caen,8,2,2,4,12,16,-4,8,france2
Bordeaux,8,2,2,4,7,12,-5,8,france2
AC Ajaccio,8,2,2,4,5,10,-5,8,france2
Troyes,8,1,4,3,7,9,-2,7,france2
Valenciennes,8,1,4,3,5,9,-4,7,france2
Amiens,7,2,1,4,3,9,-6,7,france2
Quevilly Rouen,8,1,3,4,12,15,-3,6,france2
SC Bastia,8,1,2,5,7,9,-2,5,france2
Rodez Aveyron,8,1,2,5,9,16,-7,5,france2
Red Star,8,4,2,2,11,11,0,14,france3
Martigues,8,3,4,1,5,3,2,13,france3
Le Mans,8,4,1,3,11,12,-1,13,france3
Rouen,8,3,3,2,10,7,3,12,france3
Villefranche,8,2,4,2,9,10,-1,10,france3
Sochaux,8,2,3,3,11,12,-1,9,france3
Orleans,7,2,2,3,8,12,-4,8,france3
Versailles,6,2,1,3,6,5,1,7,france3
Nancy,7,2,1,4,6,6,0,7,france3
Niort,7,2,1,4,9,13,-4,7,france3
G. O. A. L.,8,1,3,4,8,9,-1,6,france3
Chateauroux,8,0,6,2,9,14,-5,6,france3
Nimes,7,1,3,3,5,13,-8,6,france3
Dijon,6,1,2,3,3,10,-7,5,france3
Marignane G.,7,1,2,4,4,12,-8,5,france3
Avranches,8,1,2,5,8,19,-11,5,france3
Epinal,7,1,1,5,9,17,-8,4,france3
Cholet,7,1,0,6,5,16,-11,3,france3
Torpedo Kutaisi,8,4,4,0,11,7,4,16,georgia
Dinamo Tbilisi,8,4,3,1,19,11,8,15,georgia
Dinamo Batumi,8,4,1,3,20,13,7,13,georgia
Samtredia,8,3,3,2,20,9,11,12,georgia
Dila Gori,8,3,2,3,9,10,-1,11,georgia
Telavi,8,3,0,5,7,16,-9,9,georgia
Gagra,8,2,1,5,14,18,-4,7,georgia
Samgurali,8,1,3,4,9,17,-8,6,georgia
Saburtalo,8,1,1,6,3,16,-13,4,georgia
Shukura,8,1,0,7,7,33,-26,3,georgia
Gareji Sagarejo,8,5,1,2,17,8,9,16,georgia2
Bolnisi,8,5,1,2,14,6,8,16,georgia2
Kolkheti Poti,8,3,4,1,19,7,12,13,georgia2
WIT Georgia,8,3,3,2,15,13,2,12,georgia2
D. Tbilisi B,8,3,2,3,12,11,1,11,georgia2
Spaeri,8,3,1,4,13,11,2,10,georgia2
L. Tbilisi,8,3,1,4,8,10,-2,10,georgia2
Merani Martvili,8,1,1,6,10,30,-20,4,georgia2
Kolkheti Khobi,8,0,3,5,4,18,-14,3,georgia2
Merani Tbilisi,8,0,1,7,9,33,-24,1,georgia2
Leverkusen,7,5,2,0,17,6,11,17,germany
Bayern Munich,7,5,1,1,17,9,8,16,germany
Hoffenheim,7,5,1,1,16,10,6,16,germany
RB Leipzig,7,4,0,3,13,10,3,12,germany
Stuttgart,6,4,0,2,11,9,2,12,germany
Freiburg,8,3,1,4,6,14,-8,10,germany
Dortmund,6,2,3,1,13,10,3,9,germany
E. Frankfurt,7,2,3,2,11,9,2,9,germany
Monchengladbach,7,1,3,3,17,21,-4,6,germany
Bochum,8,1,3,4,6,20,-14,6,germany
FC Augsburg,7,1,2,4,8,14,-6,5,germany
FSV Mainz,8,0,5,3,7,15,-8,5,germany
FC Koln,7,1,2,4,4,14,-10,5,germany
Darmstadt,7,1,1,5,7,22,-15,4,germany
Union Berlin,6,1,0,5,7,14,-7,3,germany
Wolfsburg,7,1,0,6,7,18,-11,3,germany
Werder Bremen,6,0,1,5,6,14,-8,1,germany
Heidenheim,7,0,1,6,7,18,-11,1,germany
Holstein Kiel,8,6,1,1,14,7,7,19,germany2
Sankt Pauli,8,4,4,0,13,8,5,16,germany2
Elversberg,8,4,2,2,13,13,0,14,germany2
Dusseldorf,7,4,1,2,17,4,13,13,germany2
Paderborn,8,4,1,3,14,13,1,13,germany2
FC Nurnberg,8,4,1,3,14,17,-3,13,germany2
Hertha Berlin,8,3,2,3,14,18,-4,11,germany2
Hannover 96,8,2,3,3,11,12,-1,9,germany2
Wehen Wiesbaden,8,3,0,5,10,12,-2,9,germany2
Magdeburg,8,2,2,4,11,12,-1,8,germany2
Greuther Furth,7,2,2,3,6,11,-5,8,germany2
Hamburger SV,8,1,4,3,13,16,-3,7,germany2
Hansa Rostock,7,2,1,4,7,11,-4,7,germany2
Schalke 04,8,2,1,5,10,17,-7,7,germany2
Karlsruher SC,8,1,3,4,13,17,-4,6,germany2
Kaiserslautern,7,1,2,4,10,17,-7,5,germany2
Braunschweig,8,1,0,7,5,16,-11,3,germany2
Osnabruck,7,0,2,5,5,22,-17,2,germany2
Regensburg,8,6,2,0,12,5,7,20,germany3
Sandhausen,8,4,2,2,11,10,1,14,germany3
Verl,8,4,1,3,18,14,4,13,germany3
Dynamo Dresden,8,4,1,3,12,8,4,13,germany3
Ulm,8,4,1,3,12,13,-1,13,germany3
Saarbrucken,8,3,3,2,17,10,7,12,germany3
FC Ingolstadt,8,3,2,3,13,12,1,11,germany3
Dortmund B,8,2,4,2,10,11,-1,10,germany3
Erzgebirge Aue,8,2,4,2,9,12,-3,10,germany3
RW Essen,8,3,1,4,9,12,-3,10,germany3
Preuss. Munster,8,2,3,3,9,7,2,9,germany3
Bielefeld,8,2,3,3,10,12,-2,9,germany3
Unterhaching,8,2,3,3,7,10,-3,9,germany3
1860 Munchen,8,2,1,5,8,14,-6,7,germany3
Hallescher,8,2,1,5,13,20,-7,7,germany3
Freiburg B,8,2,0,6,9,15,-6,6,germany3
VfB Lubeck,8,1,3,4,6,14,-8,6,germany3
Viktoria Koln,8,0,4,4,13,17,-4,4,germany3
MSV Duisburg,8,0,4,4,3,9,-6,4,germany3
Mannheim,8,1,1,6,6,17,-11,4,germany3
Panathinaikos,7,6,0,1,16,4,12,18,greece
AEK Athens,6,4,1,1,10,6,4,13,greece
Olympiakos,5,3,2,0,10,3,7,11,greece
Asteras T.,6,3,1,2,8,8,0,10,greece
PAOK,5,2,1,2,9,8,1,7,greece
Atromitos,8,1,2,5,9,20,-11,5,greece
Lamia,7,1,2,4,4,15,-11,5,greece
PAS Giannina,7,0,4,3,7,11,-4,4,greece
Aris,6,1,1,4,5,9,-4,4,greece
OFI Crete,6,0,3,3,4,12,-8,3,greece
Volos,6,0,3,3,3,11,-8,3,greece
Panserraikos,8,0,3,5,6,19,-13,3,greece
Panaitolikos,7,0,1,6,5,16,-11,1,greece
Kifisia,6,0,1,5,3,15,-12,1,greece
Municipal,8,4,3,1,14,8,6,15,guatemala
Antigua GFC,8,3,2,3,9,10,-1,11,guatemala
Achuapa,8,3,2,3,12,15,-3,11,guatemala
Guastatoya,8,3,0,5,8,9,-1,9,guatemala
Comunicaciones,8,2,2,4,10,13,-3,8,guatemala
Zacapa Tellioz,8,2,1,5,7,12,-5,7,guatemala
Malacateco,8,2,1,5,9,17,-8,7,guatemala
Xinabajul,8,1,3,4,6,13,-7,6,guatemala
Mixco,8,1,2,5,5,13,-8,5,guatemala
Coban Imperial,8,0,3,5,6,15,-9,3,guatemala
Xelaju,8,0,2,6,1,9,-8,2,guatemala
Coatepecano IB,8,0,2,6,4,18,-14,2,guatemala
Olimpia,8,6,2,0,16,8,8,20,honduras
Marathon,8,4,1,3,9,13,-4,13,honduras
Motagua,8,3,2,3,18,15,3,11,honduras
Olancho,8,2,3,3,8,9,-1,9,honduras
Victoria,8,2,2,4,10,11,-1,8,honduras
Génesis,8,2,2,4,7,11,-4,8,honduras
Vida,8,2,1,5,9,18,-9,7,honduras
Real Sociedad,8,0,5,3,4,9,-5,5,honduras
Real Espana,8,1,1,6,10,17,-7,4,honduras
UPNFM,8,0,0,8,5,21,-16,0,honduras
HK Rangers,7,3,0,4,17,9,8,9,hongkong
North District,3,2,1,0,8,3,5,7,hongkong
LM Warriors,2,2,0,0,6,3,3,6,hongkong
Eastern,2,1,1,0,3,1,2,4,hongkong
Southern D.,4,1,1,2,6,5,1,4,hongkong
Hong Kong FC,3,1,1,1,2,9,-7,4,hongkong
Kitchee,2,1,0,1,4,6,-2,3,hongkong
Wofoo Tai Po,2,1,0,1,1,3,-2,3,hongkong
Resources C.,5,1,0,4,4,16,-12,3,hongkong
HK U23,4,0,1,3,0,12,-12,1,hongkong
Sham Shui Po,4,0,0,4,3,19,-16,0,hongkong
Ferencvaros,8,5,1,2,25,13,12,16,hungary
Puskas Akad.,8,5,1,2,16,11,5,16,hungary
Paks,8,3,3,2,13,13,0,12,hungary
Zalaegerszegi,8,3,1,4,11,12,-1,10,hungary
MTK,8,3,1,4,9,11,-2,10,hungary
Diosgyor VTK,8,3,1,4,11,16,-5,10,hungary
MOL Fehervar,7,2,1,4,7,10,-3,7,hungary
Debrecen,8,1,3,4,8,13,-5,6,hungary
Mezokovesd,8,1,2,5,6,12,-6,5,hungary
Ujpest,7,1,2,4,7,17,-10,5,hungary
Kecskemeti TE,8,1,1,6,9,19,-10,4,hungary
Kisvarda,8,0,1,7,5,17,-12,1,hungary
Nyiregyhaza,8,5,2,1,22,10,12,17,hungary2
Kozarmisleny,8,4,1,3,11,11,0,13,hungary2
Gyori ETO,8,4,1,3,14,16,-2,13,hungary2
Vasas,8,3,3,2,16,14,2,12,hungary2
Szeged,8,2,6,0,7,5,2,12,hungary2
Haladas,8,3,3,2,12,12,0,12,hungary2
Pecsi MFC,8,3,3,2,4,4,0,12,hungary2
Gyirmot,8,2,4,2,8,7,1,10,hungary2
Csakvari,8,2,4,2,9,9,0,10,hungary2
Soroksar,8,3,1,4,8,9,-1,10,hungary2
BVSC,8,2,3,3,8,14,-6,9,hungary2
Honved,8,1,4,3,5,9,-4,7,hungary2
Tiszakecske,8,1,3,4,7,10,-3,6,hungary2
Kazincbarcika,8,1,3,4,5,12,-7,6,hungary2
Budafoki,8,1,2,5,6,14,-8,5,hungary2
MTE,8,1,2,5,9,21,-12,5,hungary2
Siofok,8,1,1,6,3,18,-15,4,hungary2
Ajka,8,1,0,7,4,10,-6,3,hungary2
Vikingur R.,8,5,1,2,20,14,6,16,iceland
Stjarnan,8,4,2,2,14,7,7,14,iceland
Valur,8,3,2,3,18,13,5,11,iceland
Fylkir,8,3,2,3,13,15,-2,11,iceland
KA Akureyri,8,3,1,4,15,15,0,10,iceland
Hafnarfjordur,8,3,1,4,11,16,-5,10,iceland
KR Reykjavik,8,1,4,3,14,19,-5,7,iceland
Breidablik,8,1,3,4,14,21,-7,6,iceland
IBV,8,1,3,4,9,18,-9,6,iceland
Fram,8,0,3,5,6,17,-11,3,iceland
Keflavik,8,0,2,6,7,19,-12,2,iceland
HK Kopavogur,8,0,2,6,6,20,-14,2,iceland
IA Akranes,8,7,1,0,23,11,12,22,iceland2
Leiknir R.,8,5,0,3,21,11,10,15,iceland2
Vestri,8,4,3,1,14,8,6,15,iceland2
Afturelding,8,4,2,2,19,13,6,14,iceland2
Fjolnir,8,3,3,2,14,14,0,12,iceland2
Njardvík,8,3,0,5,14,22,-8,9,iceland2
Thor Akureyri,8,1,3,4,8,14,-6,6,iceland2
Grindavik,8,2,0,6,7,23,-16,6,iceland2
Throttur R.,8,1,2,5,13,19,-6,5,iceland2
Grotta,8,1,2,5,9,17,-8,5,iceland2
Selfoss,8,1,0,7,10,23,-13,3,iceland2
AEggir,8,1,0,7,9,30,-21,3,iceland2
Dalvik / Reynir,8,5,2,1,15,6,9,17,iceland3
IR Reykjavik,8,5,0,3,18,11,7,15,iceland3
Haukar,8,4,1,3,14,11,3,13,iceland3
Fjardabyggd,8,3,3,2,14,9,5,12,iceland3
Throttur Vogar,8,3,1,4,15,16,-1,10,iceland3
Volsungur,8,3,0,5,14,16,-2,9,iceland3
Hottur / Huginn,8,3,0,5,12,18,-6,9,iceland3
KFG,8,2,2,4,13,15,-2,8,iceland3
V. Olafsvik,8,2,2,4,9,15,-6,8,iceland3
Fjallabyggd,8,2,1,5,14,18,-4,7,iceland3
KV Reykjavik,8,0,1,7,6,24,-18,1,iceland3
Sindri,8,0,1,7,6,32,-26,1,iceland3
ATK Mohun Bagan,3,3,0,0,8,3,5,9,india
Mumbai City,3,2,1,0,8,3,5,7,india
Goa,3,2,1,0,5,1,4,7,india
Chennaiyin,5,1,2,2,6,10,-4,5,india
Odisha FC,4,1,1,2,6,7,-1,4,india
Kerala Blasters,3,1,0,2,3,4,-1,3,india
Hyderabad,6,0,3,3,4,7,-3,3,india
Punjab,7,0,3,4,6,14,-8,3,india
Bengaluru,5,0,2,3,5,8,-3,2,india
NorthEast Utd,4,0,2,2,2,8,-6,2,india
East Bengal,2,0,1,1,2,3,-1,1,india
Jamshedpur,4,0,1,3,1,4,-3,1,india
Aizawl,7,4,2,1,16,7,9,14,india2
Sreenidi Deccan,6,3,2,1,12,5,7,11,india2
Inter Kashi,8,3,2,3,14,19,-5,11,india2
Mohammedan,3,3,0,0,6,2,4,9,india2
Delhi FC,3,2,0,1,8,4,4,6,india2
Churchill B.,6,1,2,3,5,8,-3,5,india2
Gokulam,3,1,1,1,4,4,0,4,india2
Neroca,5,1,1,3,7,16,-9,4,india2
Real Kashmir,2,1,0,1,4,1,3,3,india2
Shillong Lajong,2,0,2,0,2,2,0,2,india2
Namdhari,3,0,1,2,3,7,-4,1,india2
TRAU,5,0,1,4,2,14,-12,1,india2
Rajasthan,3,0,0,3,3,11,-8,0,india2
Persib,8,5,2,1,16,9,7,17,indonesia
Borneo,8,4,3,1,9,5,4,15,indonesia
Madura Utd,8,4,2,2,13,11,2,14,indonesia
Bali Utd,8,3,3,2,9,9,0,12,indonesia
Persik Kediri,8,3,2,3,10,12,-2,11,indonesia
R. Nusantara,8,3,1,4,8,11,-3,10,indonesia
Persija,8,2,3,3,11,14,-3,9,indonesia
PSIS Semarang,8,2,2,4,10,12,-2,8,indonesia
PSS Sleman,8,2,1,5,10,16,-6,7,indonesia
Dewa Utd,8,1,3,4,8,10,-2,6,indonesia
Arema,8,1,3,4,10,16,-6,6,indonesia
Persebaya S.,8,1,3,4,4,14,-10,6,indonesia
Bhayangkara S.,8,0,5,3,8,13,-5,5,indonesia
PSM,8,0,4,4,6,10,-4,4,indonesia
Persis Solo,8,1,1,6,6,14,-8,4,indonesia
Barito Putera,8,0,3,5,7,15,-8,3,indonesia
Persita,8,0,3,5,4,18,-14,3,indonesia
TIRA Persikabo,8,0,1,7,5,18,-13,1,indonesia
Zob Ahan,7,4,3,0,10,6,4,15,iran
Shams A. Qazvin,7,4,2,1,11,6,5,14,iran
Tractor Sazi,7,4,0,3,8,6,2,12,iran
Sepahan,4,3,1,0,9,3,6,10,iran
Persepolis,5,3,1,1,6,2,4,10,iran
Esteghlal,6,2,3,1,7,4,3,9,iran
Aluminium Arak,7,3,0,4,5,7,-2,9,iran
Havadar,6,2,2,2,9,8,1,8,iran
Malavan,5,2,2,1,6,5,1,8,iran
Paykan,6,1,4,1,4,5,-1,7,iran
Sanat Naft,5,2,1,2,8,10,-2,7,iran
Mes Rafsanjan,6,2,1,3,4,8,-4,7,iran
Gol Gohar,5,1,3,1,3,3,0,6,iran
Foolad,5,1,0,4,1,12,-11,3,iran
E. Khuzestan,6,0,2,4,2,6,-4,2,iran
N. Mazandaran,3,0,1,2,1,5,-4,1,iran
Naft Maysan,4,3,1,0,9,0,9,10,iraq
Al Quwa Al J.,3,3,0,0,6,1,5,9,iraq
Al Naft,4,2,2,0,6,3,3,8,iraq
Al Zawraa,4,2,2,0,4,1,3,8,iraq
Al Shorta,4,2,1,1,7,5,2,7,iraq
Newroz SC,4,2,0,2,5,3,2,6,iraq
Naft Al-Janoob,5,1,3,1,5,4,1,6,iraq
Karbala,4,2,0,2,5,6,-1,6,iraq
Baghdad,4,2,0,2,3,5,-2,6,iraq
Al Hudod,3,1,2,0,4,2,2,5,iraq
Al Talaba,3,1,1,1,4,3,1,4,iraq
Al Kahrabaa,4,1,1,2,4,5,-1,4,iraq
Al-Qasim,4,1,1,2,4,5,-1,4,iraq
Zakho,4,1,1,2,3,4,-1,4,iraq
Duhok,4,1,1,2,1,4,-3,4,iraq
Al Minaa Basra,4,1,1,2,2,7,-5,4,iraq
Al Karkh,4,0,3,1,5,6,-1,3,iraq
Naft Al-Wasat,4,0,2,2,2,5,-3,2,iraq
Al Najaf,3,0,1,2,2,4,-2,1,iraq
Erbil,3,0,0,3,2,5,-3,0,iraq
Shelbourne,8,4,3,1,13,5,8,15,ireland
St. Patricks,8,4,1,3,9,8,1,13,ireland
Derry City,8,3,3,2,12,6,6,12,ireland
Dundalk,8,4,0,4,14,11,3,12,ireland
Shamrock Rovers,8,1,6,1,6,6,0,9,ireland
Drogheda Utd,8,2,2,4,9,18,-9,8,ireland
Bohemians,8,1,4,3,4,10,-6,7,ireland
Cork City,8,1,1,6,6,20,-14,4,ireland
Sligo Rovers,8,0,1,7,7,18,-11,1,ireland
UC Dublin,8,0,1,7,3,28,-25,1,ireland
Galway Utd,8,4,3,1,18,8,10,15,ireland2
Waterford,8,4,3,1,14,7,7,15,ireland2
Wexford,8,4,2,2,12,8,4,14,ireland2
Longford Town,8,3,3,2,10,10,0,12,ireland2
Cobh Ramblers,8,3,2,3,16,17,-1,11,ireland2
Bray Wanderers,8,2,4,2,11,12,-1,10,ireland2
Treaty Utd,8,3,1,4,9,13,-4,10,ireland2
Athlone Town,8,3,1,4,13,21,-8,10,ireland2
Finn Harps,8,1,2,5,7,21,-14,5,ireland2
Kerry,8,0,1,7,7,17,-10,1,ireland2
M. Tel Aviv,4,4,0,0,13,3,10,12,israel
Hapoel Haifa,4,4,0,0,6,2,4,12,israel
M. Bnei Raina,4,2,2,0,6,3,3,8,israel
Maccabi Haifa,3,2,0,1,7,6,1,6,israel
Hapoel Tel Aviv,4,1,2,1,5,3,2,5,israel
Bnei Sakhnin,4,1,2,1,5,8,-3,5,israel
B. Jerusalem,4,1,1,2,4,5,-1,4,israel
Hapoel Hadera,4,1,1,2,2,6,-4,4,israel
Maccabi Netanya,4,0,2,2,2,5,-3,2,israel
Ashdod,4,0,2,2,2,7,-5,2,israel
M. Petah Tikva,4,0,2,2,3,9,-6,2,israel
H. Beer Sheva,3,0,1,2,1,3,-2,1,israel
H. Jerusalem,4,0,1,3,2,7,-5,1,israel
H. Petah Tikva,4,0,1,3,3,9,-6,1,israel
Bnei Yehuda,6,4,1,1,12,7,5,13,israel2
Ramat Hasharon,6,3,2,1,13,8,5,11,israel2
Kiryat Shmona,5,3,0,2,7,4,3,9,israel2
Hapoel Afula,6,2,2,2,9,13,-4,8,israel2
Maccabi Jaffa,5,2,1,2,9,9,0,7,israel2
H. Nof Hagalil,6,2,1,3,7,8,-1,7,israel2
M. Herziliya,5,2,1,2,5,8,-3,7,israel2
Ironi Tiberias,5,1,3,1,8,7,1,6,israel2
H. Ramat Gan,6,1,3,2,5,7,-2,6,israel2
H. Ironi Rishon,6,1,3,2,6,9,-3,6,israel2
H. Kfar Saba,5,1,2,2,3,4,-1,5,israel2
H. Umm al-Fahm,5,1,2,2,7,9,-2,5,israel2
Hapoel Akko,6,1,2,3,4,6,-2,5,israel2
Kafr Qasim,5,1,2,2,3,7,-4,5,israel2
Nes Tziona,6,1,2,3,7,14,-7,5,israel2
Ihud B. Shfaram,5,1,0,4,6,13,-7,3,israel2
Inter Milan,7,6,1,0,16,2,14,19,italy
Napoli,8,5,2,1,16,6,10,17,italy
Juventus,7,5,1,1,11,5,6,16,italy
AC Milan,8,4,2,2,15,14,1,14,italy
Fiorentina,8,3,2,3,11,10,1,11,italy
Atalanta,8,3,1,4,12,12,0,10,italy
Bologna,8,1,6,1,8,8,0,9,italy
AS Roma,7,2,2,3,9,10,-1,8,italy
Monza,7,2,2,3,6,9,-3,8,italy
Torino,8,2,2,4,6,11,-5,8,italy
Sassuolo,6,2,1,3,10,13,-3,7,italy
Lazio,8,2,1,5,8,12,-4,7,italy
Udinese,8,1,4,3,5,13,-8,7,italy
Empoli,7,2,1,4,5,15,-10,7,italy
Hellas Verona,8,1,2,5,6,11,-5,5,italy
Lecce,6,0,4,2,7,9,-2,4,italy
Genoa,8,1,1,6,5,11,-6,4,italy
Frosinone,7,0,2,5,6,14,-8,2,italy
Cagliari,7,0,2,5,4,12,-8,2,italy
Salernitana,7,0,2,5,4,14,-10,2,italy
Cremonese,7,5,2,0,13,5,8,17,italy2
Parma,7,5,0,2,17,9,8,15,italy2
Palermo,8,4,3,1,13,7,6,15,italy2
Venezia,8,4,2,2,9,4,5,14,italy2
Catanzaro,8,4,2,2,12,10,2,14,italy2
Como,8,4,2,2,9,7,2,14,italy2
Modena,8,3,4,1,9,7,2,13,italy2
Cittadella,7,3,2,2,7,7,0,11,italy2
Pisa,8,3,2,3,6,7,-1,11,italy2
Brescia,8,2,4,2,8,7,1,10,italy2
Bari,8,2,4,2,9,9,0,10,italy2
Sampdoria,8,2,3,3,9,11,-2,9,italy2
Sudtirol,8,2,2,4,9,11,-2,8,italy2
Reggiana,8,2,2,4,8,11,-3,8,italy2
Lecco,8,2,2,4,6,11,-5,8,italy2
Cosenza,8,2,2,4,4,9,-5,8,italy2
Spezia,8,2,2,4,7,13,-6,8,italy2
Ascoli,8,1,3,4,8,12,-4,6,italy2
Ternana,7,1,2,4,10,13,-3,5,italy2
FeralpiSalo,8,1,2,5,6,16,-10,5,italy2
Mount Pleasant,3,3,0,0,6,2,4,9,jamaica
Arnett Gardens,4,2,2,0,10,4,6,8,jamaica
Cavalier,4,2,1,1,7,4,3,7,jamaica
Vere Utd,5,2,1,2,7,8,-1,7,jamaica
Tivoli Gardens,3,1,2,0,5,3,2,5,jamaica
Portmore Utd,5,1,2,2,6,6,0,5,jamaica
Waterhouse,5,1,2,2,4,6,-2,5,jamaica
Humble Lions,4,1,1,2,5,8,-3,4,jamaica
Treasure Beach,4,1,0,3,5,8,-3,3,jamaica
Dunbeholden,3,0,2,1,0,3,-3,2,jamaica
Montego Bay,4,0,2,2,3,7,-4,2,jamaica
Lime Hall Acade,3,0,1,2,1,3,-2,1,jamaica
Molynes Utd,3,0,1,2,2,5,-3,1,jamaica
Harbour View,1,0,0,1,0,2,-2,0,jamaica
Avispa Fukuoka,8,6,0,2,14,11,3,18,japan
Urawa RD,8,4,2,2,10,7,3,14,japan
Shonan Bellmare,8,4,2,2,10,9,1,14,japan
Vissel Kobe,8,4,2,2,9,8,1,14,japan
Albirex Niigata,8,4,2,2,7,6,1,14,japan
Kashiwa Reysol,8,3,3,2,9,10,-1,12,japan
S. Hiroshima,8,3,2,3,5,5,0,11,japan
Yokohama M.,8,3,2,3,11,12,-1,11,japan
K. Frontale,8,3,2,3,9,11,-2,11,japan
FC Tokyo,8,2,2,4,4,7,-3,8,japan
Yokohama FC,8,1,3,4,9,13,-4,6,japan
Kyoto Sanga,8,1,3,4,7,11,-4,6,japan
Kashima Antlers,8,1,3,4,8,13,-5,6,japan
C. Sapporo,8,1,3,4,9,17,-8,6,japan
Sagan Tosu,8,0,5,3,10,13,-3,5,japan
Cerezo Osaka,8,1,2,5,3,8,-5,5,japan
Gamba Osaka,8,1,2,5,6,17,-11,5,japan
Nagoya G.,8,1,0,7,6,14,-8,3,japan
Machida Zelvia,8,5,2,1,18,5,13,17,japan2
JEF Utd Chiba,8,5,1,2,19,11,8,16,japan2
Tokyo Verdy,8,4,4,0,12,5,7,16,japan2
Shimizu S-Pulse,8,4,3,1,16,7,9,15,japan2
Blaublitz Akita,8,4,1,3,11,8,3,13,japan2
Jubilo Iwata,8,4,1,3,10,7,3,13,japan2
Iwaki,8,4,1,3,13,11,2,13,japan2
Tokushima V.,8,3,4,1,11,9,2,13,japan2
Omiya Ardija,8,4,1,3,10,12,-2,13,japan2
M. Yamagata,8,4,1,3,9,14,-5,13,japan2
V-V. Nagasaki,8,2,4,2,14,13,1,10,japan2
R. Kumamoto,8,3,1,4,8,8,0,10,japan2
Fagiano Okayama,8,2,4,2,9,10,-1,10,japan2
Mito Hollyhock,8,2,3,3,7,12,-5,9,japan2
Tochigi SC,8,2,2,4,4,9,-5,8,japan2
Oita Trinita,8,1,4,3,10,12,-2,7,japan2
Ventforet Kofu,8,1,4,3,9,12,-3,7,japan2
Kusatsu,8,2,1,5,8,13,-5,7,japan2
Vegalta Sendai,8,2,1,5,10,16,-6,7,japan2
Fujieda MYFC,8,1,3,4,8,14,-6,6,japan2
Z. Kanazawa,8,1,2,5,6,11,-5,5,japan2
R. Yamaguchi,8,0,2,6,3,15,-12,2,japan2
Al Hussein,4,4,0,0,9,0,9,12,jordan
Al Ramtha,4,2,0,2,7,3,4,6,jordan
Al Wihdat,2,2,0,0,2,0,2,6,jordan
Al Faysali,3,2,0,1,4,3,1,6,jordan
Moghayer Al S.,4,1,2,1,6,6,0,5,jordan
Al Jalil,5,1,2,2,6,10,-4,5,jordan
Aqaba,3,1,1,1,1,2,-1,4,jordan
Sahab,5,0,4,1,8,10,-2,4,jordan
Al Salt,5,1,1,3,5,7,-2,4,jordan
Maan,5,1,1,3,3,9,-6,4,jordan
Al Ahli,5,1,0,4,2,6,-4,3,jordan
Shabab Al Ordon,5,1,0,4,1,11,-10,3,jordan
Ordabasy,8,4,2,2,12,7,5,14,kazakhstan
Aktobe,8,3,5,0,8,5,3,14,kazakhstan
Zhetysu,8,4,2,2,11,9,2,14,kazakhstan
Maqtaaral,8,3,3,2,9,7,2,12,kazakhstan
Kaisar K.,8,3,3,2,9,8,1,12,kazakhstan
FC Astana,8,3,2,3,6,7,-1,11,kazakhstan
Kairat Almaty,8,2,3,3,7,9,-2,9,kazakhstan
Okzhetpes,8,3,0,5,7,13,-6,9,kazakhstan
Tobol,8,1,3,4,9,12,-3,6,kazakhstan
Atyrau,8,1,3,4,7,10,-3,6,kazakhstan
S. Karagandy,8,1,3,4,8,13,-5,6,kazakhstan
Kyzylzhar,8,1,2,5,7,13,-6,5,kazakhstan
Kaspiy Aktau,8,0,3,5,8,15,-7,3,kazakhstan
Aksu,8,0,1,7,4,16,-12,1,kazakhstan
Ballkani,7,4,2,1,13,7,6,14,kosovo
Llapi,8,4,2,2,13,9,4,14,kosovo
Drita,8,4,1,3,8,5,3,13,kosovo
Malisheva,8,3,2,3,6,7,-1,11,kosovo
Dukagjini,8,2,4,2,15,14,1,10,kosovo
Prishtina,8,0,6,2,4,8,-4,6,kosovo
Feronikeli,8,1,1,6,10,19,-9,4,kosovo
Gjilani,8,1,0,7,7,12,-5,3,kosovo
Liria,8,0,2,6,4,14,-10,2,kosovo
Fushe Kosova,8,0,1,7,3,12,-9,1,kosovo
Al Qadsia,5,5,0,0,12,1,11,15,kuwait
Kazma,5,3,1,1,12,11,1,10,kuwait
Al Kuwait,4,2,1,1,10,7,3,7,kuwait
Al Shabab,4,2,1,1,7,7,0,7,kuwait
Al Nasar,5,2,0,3,10,9,1,6,kuwait
Al Arabi SC,4,1,2,1,6,7,-1,5,kuwait
Al Salmiyah,4,1,1,2,5,7,-2,4,kuwait
Khaitan,4,0,2,2,3,9,-6,2,kuwait
Al Fahaheel,5,0,2,3,2,9,-7,2,kuwait
Al Jahra,5,0,1,4,3,9,-6,1,kuwait
Riga FC,8,6,2,0,21,4,17,20,latvia
RFS,8,5,2,1,19,10,9,17,latvia
Auda,8,4,2,2,10,8,2,14,latvia
FS Jelgava,8,3,4,1,11,10,1,13,latvia
Valmiera,8,3,2,3,10,11,-1,11,latvia
Liepaja,8,2,3,3,10,12,-2,9,latvia
Daugavpils,8,2,1,5,4,12,-8,7,latvia
Super Nova,8,1,3,4,5,13,-8,6,latvia
Metta / LU,8,1,1,6,8,18,-10,4,latvia
Tukums,8,1,1,6,6,24,-18,4,latvia
Panevezys,8,5,3,0,12,4,8,18,lithuania
Zalgiris,8,5,1,2,19,9,10,16,lithuania
Kauno Zalgiris,8,4,4,0,17,7,10,16,lithuania
Hegelmann L.,8,4,1,3,14,18,-4,13,lithuania
Riteriai,8,3,1,4,10,11,-1,10,lithuania
FA Siauliai,8,2,3,3,10,14,-4,9,lithuania
Dziugas Telsiai,8,1,5,2,3,6,-3,8,lithuania
Suduva,8,2,1,5,8,15,-7,7,lithuania
Banga,8,2,0,6,3,11,-8,6,lithuania
Dainava,8,1,2,5,5,10,-5,5,lithuania
Be1 NFA,8,6,1,1,11,2,9,19,lithuania2
Neptuna K.,8,5,1,2,19,12,7,16,lithuania2
Riteriai B,8,4,3,1,16,11,5,15,lithuania2
TransINVEST,8,4,2,2,17,10,7,14,lithuania2
BFA Vilnius,8,3,2,3,16,11,5,11,lithuania2
Ekranas,8,3,1,4,11,16,-5,10,lithuania2
Babrungas,8,3,1,4,12,19,-7,10,lithuania2
Minija,8,3,0,5,10,14,-4,9,lithuania2
Zalgiris B,8,2,2,4,11,16,-5,8,lithuania2
Garliava,8,1,4,3,10,12,-2,7,lithuania2
Nevezis,8,1,3,4,8,14,-6,6,lithuania2
Marijampole C.,8,2,0,6,6,20,-14,6,lithuania2
FA Siauliai B,8,2,0,6,10,25,-15,6,lithuania2
Panevezys B,8,1,2,5,14,25,-11,5,lithuania2
Kauno Z. B,8,1,2,5,6,19,-13,5,lithuania2
Jonava,8,1,1,6,11,20,-9,4,lithuania2
Differdange,8,3,5,0,12,8,4,14,luxembourg
Hesperang,8,4,1,3,17,9,8,13,luxembourg
Racing,7,3,1,3,13,9,4,10,luxembourg
Dudelange,8,3,1,4,9,11,-2,10,luxembourg
Mondercange,7,2,3,2,8,12,-4,9,luxembourg
Jeunesse Esch,7,2,2,3,8,11,-3,8,luxembourg
Wiltz,7,2,2,3,8,11,-3,8,luxembourg
V. Rosport,7,2,2,3,9,13,-4,8,luxembourg
Marisca Mersch,8,2,1,5,12,17,-5,7,luxembourg
UNA Strassen,7,1,3,3,8,9,-1,6,luxembourg
Niedercorn,7,1,3,3,11,15,-4,6,luxembourg
UN Käerjéng,8,1,2,5,12,17,-5,5,luxembourg
Petange,7,1,2,4,5,12,-7,5,luxembourg
Schifflange,8,1,1,6,7,16,-9,4,luxembourg
Mondorf,8,0,3,5,10,20,-10,3,luxembourg
Fola Esch,7,1,0,6,8,19,-11,3,luxembourg
Johor Darul,8,7,1,0,26,5,21,22,malaysia
Kedah,8,6,0,2,16,7,9,18,malaysia
Terengganu,8,4,4,0,23,7,16,16,malaysia
Selangor,8,5,0,3,27,7,20,15,malaysia
Sabah,8,5,0,3,18,5,13,15,malaysia
Pahang,8,4,0,4,15,13,2,12,malaysia
Kuala Lumpur,8,3,1,4,13,17,-4,10,malaysia
PDRM,8,3,1,4,13,19,-6,10,malaysia
Perak,8,3,0,5,7,19,-12,9,malaysia
Negeri Sembilan,8,1,2,5,10,16,-6,5,malaysia
Kelantan United,8,0,3,5,6,20,-14,3,malaysia
Kuching,8,0,2,6,10,17,-7,2,malaysia
Pulau Pinang,8,0,2,6,2,13,-11,2,malaysia
Kelantan,8,0,1,7,10,41,-31,1,malaysia
Floriana,5,4,1,0,13,1,12,13,malta
Hamrun Spartans,5,4,0,1,11,4,7,12,malta
Hibernians,5,3,1,1,8,3,5,10,malta
Marsaxlokk,5,3,1,1,10,6,4,10,malta
Sliema W.,5,3,1,1,6,2,4,10,malta
Balzan,5,2,1,2,5,4,1,7,malta
Gzira Utd,4,2,0,2,9,3,6,6,malta
Mosta,5,1,3,1,5,4,1,6,malta
Birkirkara,4,2,0,2,4,4,0,6,malta
Naxxar Lions,5,1,3,1,6,9,-3,6,malta
Valletta,5,1,2,2,3,4,-1,5,malta
Gudja Utd,5,0,2,3,1,6,-5,2,malta
Santa Lucia,5,0,2,3,3,11,-8,2,malta
Sirens,5,0,0,5,1,12,-11,0,malta
CF America,7,5,2,0,12,5,7,17,mexico
Monterrey,8,4,2,2,9,6,3,14,mexico
Puebla,8,4,2,2,10,10,0,14,mexico
Tigres,8,3,2,3,13,10,3,11,mexico
Guadalajara,8,3,2,3,9,11,-2,11,mexico
Pachuca,8,3,2,3,7,16,-9,11,mexico
Cruz Azul,8,3,1,4,11,11,0,10,mexico
Queretaro,8,3,0,5,9,20,-11,9,mexico
Pumas UNAM,8,2,2,4,10,11,-1,8,mexico
Mazatlan,8,2,2,4,11,15,-4,8,mexico
Atlas,8,2,2,4,7,15,-8,8,mexico
A. San Luis,8,2,1,5,13,17,-4,7,mexico
Santos Laguna,8,2,1,5,15,20,-5,7,mexico
Toluca,8,1,3,4,7,10,-3,6,mexico
Necaxa,8,1,3,4,9,16,-7,6,mexico
Club Leon,8,1,2,5,9,15,-6,5,mexico
Juarez,8,1,1,6,9,21,-12,4,mexico
Tijuana,8,0,1,7,3,15,-12,1,mexico
Monterrey,8,6,1,1,14,7,7,19,mexico2
CF America,8,5,3,0,19,10,9,18,mexico2
Pachuca,8,6,0,2,15,9,6,18,mexico2
Guadalajara,8,4,3,1,12,8,4,15,mexico2
Tigres,8,4,2,2,9,7,2,14,mexico2
Club Leon,8,3,4,1,9,7,2,13,mexico2
Atlas,8,2,5,1,14,9,5,11,mexico2
Toluca,8,3,2,3,14,11,3,11,mexico2
Queretaro,8,2,3,3,6,9,-3,9,mexico2
Puebla,8,2,2,4,11,13,-2,8,mexico2
Cruz Azul,8,2,2,4,10,12,-2,8,mexico2
Santos Laguna,8,1,3,4,9,16,-7,6,mexico2
Juarez,8,1,3,4,7,15,-8,6,mexico2
Pumas UNAM,8,1,2,5,7,15,-8,5,mexico2
Necaxa,8,1,1,6,6,13,-7,4,mexico2
Tijuana,8,1,1,6,9,21,-12,4,mexico2
Mazatlan,8,1,1,6,8,23,-15,4,mexico2
A. San Luis,8,0,1,7,3,14,-11,1,mexico2
SP Falcons,5,5,0,0,12,0,12,15,mongolia
Khoromkhon,5,4,0,1,12,11,1,12,mongolia
Deren,5,3,2,0,13,3,10,11,mongolia
FC Ulaanbaatar,4,3,0,1,9,2,7,9,mongolia
Erchim,5,2,2,1,15,14,1,8,mongolia
Bavarians,4,2,0,2,7,11,-4,6,mongolia
Khangarid,5,1,2,2,12,8,4,5,mongolia
Tuv Buganuud,3,1,1,1,9,10,-1,4,mongolia
Khovd,4,0,1,3,3,11,-8,1,mongolia
Bayanzurkh S.,4,0,0,4,2,13,-11,0,mongolia
Decic,8,6,2,0,10,3,7,20,montenegro
Buducnost,8,4,3,1,15,9,6,15,montenegro
Jezero,8,3,4,1,9,7,2,13,montenegro
Sutjeska,8,2,5,1,9,5,4,11,montenegro
Mornar,8,2,4,2,9,10,-1,10,montenegro
Arsenal Tivat,8,2,2,4,7,11,-4,8,montenegro
Petrovac,8,1,3,4,8,11,-3,6,montenegro
Mladost DG,8,1,3,4,10,15,-5,6,montenegro
Rudar,8,2,0,6,4,13,-9,6,montenegro
Jedinstvo,8,0,3,5,11,19,-8,3,montenegro
FUS Rabat,6,2,2,2,6,5,1,8,morocco
Moghreb Tetouan,6,2,2,2,6,5,1,8,morocco
FAR Rabat,5,2,1,2,9,6,3,7,morocco
Raja Casablanca,5,1,4,0,7,5,2,7,morocco
Wydad,4,2,1,1,7,5,2,7,morocco
Berkane,4,1,3,0,4,2,2,6,morocco
Maghreb de Fes,5,1,3,1,6,5,1,6,morocco
Union Touarga,5,2,0,3,5,5,0,6,morocco
Olympic Safi,5,1,2,2,4,7,-3,5,morocco
C. Mohammedia,6,1,2,3,3,6,-3,5,morocco
R. Zemamra,6,1,1,4,8,12,-4,4,morocco
Ittihad Tanger,5,0,3,2,4,6,-2,3,morocco
Mouloudia Oujda,6,0,3,3,3,8,-5,3,morocco
Salmi,5,1,0,4,2,9,-7,3,morocco
Hassania Agadir,6,0,2,4,2,8,-6,2,morocco
Youssoufia B.,5,0,0,5,4,13,-9,0,morocco
Meknes,8,4,3,1,9,6,3,15,morocco2
Difaa El Jadida,8,3,3,2,6,5,1,12,morocco2
Chabab Atlas K.,8,2,5,1,5,4,1,11,morocco2
El Massira,7,2,3,2,8,6,2,9,morocco2
Kawkab M.,6,3,0,3,5,6,-1,9,morocco2
C. Benguerir,7,2,2,3,5,6,-1,8,morocco2
Ittifaq M.,8,2,2,4,4,10,-6,8,morocco2
Stade Marocain,7,1,4,2,8,10,-2,7,morocco2
R. Beni Mellal,6,1,3,2,7,6,1,6,morocco2
Khouribga,7,1,3,3,5,7,-2,6,morocco2
Dcheira,6,1,3,2,6,9,-3,6,morocco2
Rapide Oued Z.,7,1,3,3,3,6,-3,6,morocco2
RAC Casablanca,7,1,2,4,4,8,-4,5,morocco2
USM Oujda,7,0,4,3,4,9,-5,4,morocco2
Wydad Fès,6,0,3,3,2,6,-4,3,morocco2
AS Salé,7,0,1,6,4,16,-12,1,morocco2
Shan Utd,8,6,2,0,19,7,12,20,myanmar
Yangon Utd,8,6,0,2,18,7,11,18,myanmar
Rakhine Utd,8,4,2,2,15,13,2,14,myanmar
Hantharwady,8,4,0,4,13,9,4,12,myanmar
Dagon,8,3,3,2,10,8,2,12,myanmar
Ispe FC,8,3,3,2,13,13,0,12,myanmar
Myawady,8,3,2,3,8,11,-3,11,myanmar
Ayeyawady,8,3,1,4,9,17,-8,10,myanmar
Yadanarbon,8,2,3,3,10,13,-3,9,myanmar
Sagaing Utd,8,2,2,4,13,20,-7,8,myanmar
Kachin Utd,8,1,1,6,10,17,-7,4,myanmar
Chinland,8,0,1,7,6,29,-23,1,myanmar
PSV Eindhoven,7,7,0,0,26,2,24,21,netherlands
Feyenoord,7,5,1,1,20,8,12,16,netherlands
FC Twente,7,4,2,1,15,6,9,14,netherlands
AZ Alkmaar,7,4,2,1,12,5,7,14,netherlands
Sparta,8,4,1,3,12,9,3,13,netherlands
PEC Zwolle,7,3,1,3,14,13,1,10,netherlands
FC Utrecht,8,3,1,4,7,9,-2,10,netherlands
Excelsior,8,2,3,3,15,17,-2,9,netherlands
NEC Nijmegen,7,2,3,2,11,13,-2,9,netherlands
Ajax Amsterdam,8,2,3,3,15,19,-4,9,netherlands
Almere City,8,2,2,4,8,17,-9,8,netherlands
RKC Waalwijk,7,2,0,5,5,11,-6,6,netherlands
Go Ahead Eagles,7,1,3,3,5,13,-8,6,netherlands
Heerenveen,8,2,0,6,9,20,-11,6,netherlands
Vitesse Arnhem,8,2,0,6,7,21,-14,6,netherlands
Heracles Almelo,8,1,2,5,10,20,-10,5,netherlands
Fortuna Sittard,7,0,2,5,3,17,-14,2,netherlands
FC Volendam,8,0,1,7,8,23,-15,1,netherlands
ADO Den Haag,8,4,3,1,14,9,5,15,netherlands2
Willem II,8,4,2,2,12,5,7,14,netherlands2
NAC Breda,8,4,1,3,18,11,7,13,netherlands2
Cambuur,8,4,1,3,21,16,5,13,netherlands2
FC Eindhoven,8,3,3,2,11,10,1,12,netherlands2
FC Emmen,8,3,3,2,12,12,0,12,netherlands2
VVV,8,3,3,2,11,11,0,12,netherlands2
De Graafschap,8,4,0,4,10,14,-4,12,netherlands2
FC Groningen,8,3,1,4,13,9,4,10,netherlands2
Roda JC,8,2,4,2,9,7,2,10,netherlands2
FC Dordrecht,8,2,4,2,11,12,-1,10,netherlands2
MVV Maastricht,8,3,1,4,11,12,-1,10,netherlands2
Jong PSV,8,3,1,4,11,15,-4,10,netherlands2
Helmond Sport,8,2,1,5,12,16,-4,7,netherlands2
Telstar,8,1,2,5,6,13,-7,5,netherlands2
Jong AZ,8,1,2,5,8,18,-10,5,netherlands2
FC Den Bosch,8,1,0,7,7,18,-11,3,netherlands2
TOP Oss,8,0,2,6,3,12,-9,2,netherlands2
Jong Ajax,8,0,2,6,12,24,-12,2,netherlands2
Jong Utrecht,8,0,2,6,6,24,-18,2,netherlands2
Diriangen,8,5,1,2,13,7,6,16,nicaragua
Real Esteli,8,4,3,1,17,6,11,15,nicaragua
UNAN Managua,8,3,2,3,12,16,-4,11,nicaragua
Export Sebaco,8,3,1,4,8,17,-9,10,nicaragua
Jalapa,8,2,2,4,11,15,-4,8,nicaragua
Managua FC,8,1,4,3,7,9,-2,7,nicaragua
D. Ocotal,8,1,1,6,9,16,-7,4,nicaragua
Matagalpa,8,1,1,6,9,16,-7,4,nicaragua
Walter Ferreti,8,0,2,6,2,13,-11,2,nicaragua
O. Masachapa,8,0,2,6,2,17,-15,2,nicaragua
Bendel,8,2,6,0,8,6,2,12,nigeria
Enyimba,8,3,1,4,6,7,-1,10,nigeria
Akwa Utd,8,2,3,3,9,8,1,9,nigeria
Remo Stars,8,2,3,3,7,12,-5,9,nigeria
Rivers Utd,8,1,5,2,9,10,-1,8,nigeria
Plateau Utd,8,1,3,4,11,14,-3,6,nigeria
Lobi Stars,8,1,3,4,4,10,-6,6,nigeria
Sunshine Stars,8,1,2,5,7,10,-3,5,nigeria
Enugu Rangers,8,0,5,3,4,7,-3,5,nigeria
Bayelsa Utd,8,1,2,5,7,13,-6,5,nigeria
Shooting Stars,8,1,2,5,3,10,-7,5,nigeria
Niger Tornadoes,8,1,1,6,6,13,-7,4,nigeria
Wikki Tourist,8,1,1,6,4,13,-9,4,nigeria
Gombe Utd,8,0,4,4,1,12,-11,4,nigeria
Kwara Utd,8,1,1,6,4,16,-12,4,nigeria
Abia Warriors,8,1,1,6,6,19,-13,4,nigeria
Nasarawa Utd,8,0,3,5,4,10,-6,3,nigeria
Doma Utd,8,0,3,5,2,10,-8,3,nigeria
El Kanemi,8,1,0,7,3,16,-13,3,nigeria
Dakkada,8,0,0,8,2,15,-13,0,nigeria
Cliftonville,8,6,0,2,16,5,11,18,northernireland
Linfield,8,6,0,2,12,8,4,18,northernireland
Crusaders,8,4,2,2,14,10,4,14,northernireland
Larne,8,3,4,1,9,4,5,13,northernireland
Carrick Rangers,8,3,2,3,16,19,-3,11,northernireland
Coleraine,8,3,2,3,10,14,-4,11,northernireland
Glentoran,8,2,3,3,11,11,0,9,northernireland
Glenavon,8,3,0,5,11,17,-6,9,northernireland
Ballymena Utd,8,2,1,5,4,16,-12,7,northernireland
Dungannon,8,1,3,4,9,16,-7,6,northernireland
Loughgall,8,1,3,4,10,21,-11,6,northernireland
Newry City,8,1,1,6,7,22,-15,4,northernireland
Dundela,8,5,1,2,12,11,1,16,northernireland2
Bangor,8,4,1,3,17,11,6,13,northernireland2
Ards,8,4,1,3,15,16,-1,13,northernireland2
Institute,8,3,3,2,12,12,0,12,northernireland2
Ballinamallard,8,3,2,3,11,9,2,11,northernireland2
Portadown,8,3,1,4,9,9,0,10,northernireland2
Newington Youth,8,3,0,5,13,18,-5,9,northernireland2
Annagh Utd,8,2,2,4,9,15,-6,8,northernireland2
H&W Welders,8,1,2,5,10,16,-6,5,northernireland2
Ballyclare,6,1,1,4,8,14,-6,4,northernireland2
Dergview,8,1,1,6,12,22,-10,4,northernireland2
Knockbreda,8,0,1,7,5,22,-17,1,northernireland2
Shkupi,8,3,4,1,7,5,2,13,northmacedonia
Struga,8,4,0,4,12,10,2,12,northmacedonia
Skendija,8,3,2,3,12,11,1,11,northmacedonia
Gostivar,8,2,3,3,8,11,-3,9,northmacedonia
Voska Sport,8,1,4,3,9,13,-4,7,northmacedonia
Vardar,8,2,1,5,6,13,-7,7,northmacedonia
Sileks,8,1,3,4,7,12,-5,6,northmacedonia
Makedonija,8,1,1,6,7,12,-5,4,northmacedonia
Tikves,8,1,1,6,5,11,-6,4,northmacedonia
Rabotnicki,8,1,1,6,4,13,-9,4,northmacedonia
A. Pandev,8,0,2,6,2,8,-6,2,northmacedonia
Bregalnica Stip,8,0,2,6,3,11,-8,2,northmacedonia
Tromso,8,5,1,2,15,12,3,16,norway
Brann,8,5,1,2,11,8,3,16,norway
Bodo / Glimt,8,4,2,2,24,16,8,14,norway
Molde,8,4,2,2,16,11,5,14,norway
Viking,8,4,1,3,12,10,2,13,norway
Valerenga,8,3,2,3,12,12,0,11,norway
HamKam,8,3,1,4,9,13,-4,10,norway
Stromsgodset,8,3,0,5,6,9,-3,9,norway
Rosenborg,8,3,0,5,15,20,-5,9,norway
Haugesund,8,1,3,4,8,9,-1,6,norway
Sandefjord,8,2,0,6,17,20,-3,6,norway
Odd,8,1,2,5,15,20,-5,5,norway
Stabaek,8,0,4,4,5,14,-9,4,norway
Sarpsborg 08,8,1,1,6,9,19,-10,4,norway
Lillestrom,8,1,1,6,6,17,-11,4,norway
Aalesund,8,1,0,7,7,27,-20,3,norway
Kristiansund,8,5,2,1,18,8,10,17,norway2
Fredrikstad,8,5,2,1,18,11,7,17,norway2
KFUM Oslo,8,5,2,1,13,7,6,17,norway2
Kongsvinger,8,4,2,2,17,12,5,14,norway2
Raufoss,8,4,1,3,12,14,-2,13,norway2
Ranheim,8,4,0,4,8,13,-5,12,norway2
Sogndal,8,3,1,4,13,15,-2,10,norway2
Bryne,8,3,0,5,10,11,-1,9,norway2
Jerv,8,2,2,4,13,20,-7,8,norway2
Sandnes Ulf,8,2,2,4,5,14,-9,8,norway2
Hodd,8,2,1,5,3,10,-7,7,norway2
Asane,8,1,3,4,10,15,-5,6,norway2
Moss,8,1,3,4,7,12,-5,6,norway2
Mjondalen,8,1,3,4,6,11,-5,6,norway2
Start,8,1,2,5,5,10,-5,5,norway2
Skeid,8,0,1,7,0,14,-14,1,norway2
Al Seeb,5,4,1,0,11,0,11,13,oman
Sohar,5,3,1,1,9,4,5,10,oman
Al Nasr,6,3,1,2,7,4,3,10,oman
Ibri,5,3,0,2,8,4,4,9,oman
Al-Nahda,5,2,3,0,10,7,3,9,oman
Al-Shabab Club,6,2,3,1,7,6,1,9,oman
Al Wehda,5,2,1,2,5,8,-3,7,oman
Al-Rustaq,5,1,2,2,5,8,-3,5,oman
Sur,4,1,1,2,2,3,-1,4,oman
Dhofar,4,1,1,2,6,8,-2,4,oman
Oman Club,4,1,1,2,3,6,-3,4,oman
Bahla,5,1,0,4,1,7,-6,3,oman
Independiente,8,4,2,2,15,10,5,14,panama
Plaza Amador,8,4,2,2,13,9,4,14,panama
Arabe Unido,8,3,3,2,8,5,3,12,panama
San Miguelito,8,3,3,2,7,5,2,12,panama
Tauro,8,3,3,2,7,7,0,12,panama
Herrera,8,2,4,2,8,7,1,10,panama
Alianza,8,2,2,4,5,10,-5,8,panama
UMECIT,8,1,4,3,2,7,-5,7,panama
San Francisco,8,1,4,3,3,9,-6,7,panama
Costa del Este,8,2,1,5,9,17,-8,7,panama
Universitario,8,2,1,5,7,15,-8,7,panama
A. Chiriqui,8,0,0,8,5,22,-17,0,panama
Tauro,8,4,3,1,14,5,9,15,panama2
Independiente,8,4,3,1,18,11,7,15,panama2
San Francisco,8,4,1,3,10,5,5,13,panama2
Arabe Unido,8,3,3,2,9,6,3,12,panama2
Alianza,8,3,3,2,9,11,-2,12,panama2
Costa del Este,8,3,2,3,10,11,-1,11,panama2
San Miguelito,8,2,3,3,8,9,-1,9,panama2
Universitario,8,2,3,3,8,14,-6,9,panama2
UMECIT,8,2,1,5,10,13,-3,7,panama2
Herrera,8,2,1,5,10,16,-6,7,panama2
Plaza Amador,8,1,1,6,7,12,-5,4,panama2
A. Chiriqui,8,0,2,6,1,28,-27,2,panama2
S. Ameliano,8,4,2,2,10,7,3,14,paraguay
Cerro Porteno,8,4,2,2,14,14,0,14,paraguay
Libertad,8,4,1,3,12,9,3,13,paraguay
Guarani,8,3,4,1,10,8,2,13,paraguay
Olimpia,8,3,2,3,10,8,2,11,paraguay
S. Trinidense,8,3,2,3,10,9,1,11,paraguay
Nacional,8,3,2,3,8,10,-2,11,paraguay
S. Luqueno,8,2,3,3,12,14,-2,9,paraguay
G. Caballero,8,2,2,4,6,11,-5,8,paraguay
Guairena,8,1,4,3,6,10,-4,7,paraguay
Resistencia,8,1,1,6,4,15,-11,4,paraguay
Tacuary,8,1,0,7,2,10,-8,3,paraguay
Libertad,8,5,3,0,18,6,12,18,paraguay2
S. Trinidense,8,4,1,3,14,9,5,13,paraguay2
Olimpia,8,4,1,3,4,6,-2,13,paraguay2
Cerro Porteno,8,2,5,1,13,8,5,11,paraguay2
S. Ameliano,8,3,1,4,15,15,0,10,paraguay2
Tacuary,8,2,3,3,9,11,-2,9,paraguay2
G. Caballero,8,3,0,5,10,14,-4,9,paraguay2
Guarani,8,2,3,3,3,10,-7,9,paraguay2
Nacional,8,1,5,2,7,7,0,8,paraguay2
Guairena,8,1,3,4,6,15,-9,6,paraguay2
S. Luqueno,8,1,2,5,6,11,-5,5,paraguay2
Resistencia,8,1,1,6,7,23,-16,4,paraguay2
Alianza Lima,8,5,0,3,12,9,3,15,peru
S. Cristal,8,3,4,1,15,10,5,13,peru
Universitario,8,3,1,4,8,9,-1,10,peru
Carlos Manucci,8,3,0,5,5,13,-8,9,peru
D. Garcilaso,8,2,2,4,12,13,-1,8,peru
FBC Melgar,8,1,5,2,7,8,-1,8,peru
D. Municipal,8,2,2,4,6,9,-3,8,peru
Sport Huancayo,8,2,2,4,10,14,-4,8,peru
Cusco,8,2,2,4,8,12,-4,8,peru
ADT,8,1,3,4,9,12,-3,6,peru
Cienciano,8,2,0,6,9,19,-10,6,peru
Sport Boys,8,1,2,5,3,11,-8,5,peru
Cajamarca,8,1,2,5,8,17,-9,5,peru
Alianza A.,8,1,1,6,12,20,-8,4,peru
Cesar Vallejo,8,0,4,4,5,15,-10,4,peru
Union Comercio,8,1,1,6,7,20,-13,4,peru
Atletico Grau,8,0,2,6,7,14,-7,2,peru
Binacional,8,0,2,6,6,18,-12,2,peru
AD Cantolao,8,0,1,7,2,21,-19,1,peru
FBC Melgar,8,6,2,0,10,3,7,20,peru2
Alianza Lima,8,4,3,1,9,5,4,15,peru2
Cesar Vallejo,8,4,1,3,12,6,6,13,peru2
Universitario,8,3,4,1,9,6,3,13,peru2
ADT,8,3,4,1,9,7,2,13,peru2
D. Garcilaso,8,2,4,2,9,9,0,10,peru2
S. Cristal,8,2,4,2,8,10,-2,10,peru2
Sport Boys,8,2,2,4,5,12,-7,8,peru2
AD Cantolao,8,2,1,5,6,11,-5,7,peru2
Union Comercio,8,1,3,4,7,15,-8,6,peru2
Sport Huancayo,8,1,2,5,5,10,-5,5,peru2
Cienciano,8,1,2,5,8,14,-6,5,peru2
Atletico Grau,8,1,2,5,5,14,-9,5,peru2
Cajamarca,8,0,4,4,6,14,-8,4,peru2
Carlos Manucci,8,0,3,5,5,14,-9,3,peru2
D. Municipal,8,1,0,7,6,22,-16,3,peru2
Alianza A.,8,0,2,6,2,14,-12,2,peru2
Cusco,8,0,1,7,4,15,-11,1,peru2
Binacional,8,0,1,7,8,20,-12,1,peru2
Comerciantes U.,8,5,1,2,12,7,5,16,peru3
A. Huanuco,8,3,3,2,10,8,2,12,peru3
Santa Rosa,8,3,2,3,13,11,2,11,peru3
Llacuabamba,8,3,2,3,14,15,-1,11,peru3
D. Coopsol,8,2,3,3,8,9,-1,9,peru3
Juan Aurich,8,2,2,4,6,9,-3,8,peru3
U. San Martin,8,1,4,3,9,10,-1,7,peru3
Ayacucho,8,1,3,4,11,17,-6,6,peru3
Santos FC,8,1,3,4,7,13,-6,6,peru3
Comerciantes,8,1,2,5,3,11,-8,5,peru3
Alfonso Ugarte,8,0,3,5,4,18,-14,3,peru3
Huaral,8,0,2,6,3,12,-9,2,peru3
Carlos Stein,8,0,2,6,10,34,-24,2,peru3
M. El Pirata,8,0,1,7,3,30,-27,1,peru3
Kaya,8,7,1,0,29,5,24,22,philippines
Cebu FC,8,6,2,0,19,8,11,20,philippines
Stallion,8,4,1,3,12,5,7,13,philippines
United City,6,3,1,2,18,10,8,10,philippines
Mendiola,8,3,0,5,9,15,-6,9,philippines
Azkals,8,2,0,6,7,20,-13,6,philippines
Maharlika,8,1,0,7,4,24,-20,3,philippines
Slask Wroclaw,8,6,1,1,13,6,7,19,poland
Pogon Szczecin,8,4,1,3,11,4,7,13,poland
Jagiellonia,8,3,3,2,16,14,2,12,poland
Warta Poznan,8,3,3,2,12,10,2,12,poland
Legia Warsaw,8,3,3,2,11,12,-1,12,poland
Lech Poznan,8,3,3,2,8,11,-3,12,poland
Cracovia Krakow,8,2,4,2,7,7,0,10,poland
Radomiak Radom,8,3,1,4,10,12,-2,10,poland
Piast Gliwice,8,1,6,1,8,8,0,9,poland
Korona Kielce,8,1,5,2,6,8,-2,8,poland
Rakow C.,8,2,2,4,14,18,-4,8,poland
Stal Mielec,8,2,2,4,10,15,-5,8,poland
Widzew Lodz,8,1,4,3,11,13,-2,7,poland
Zaglebie Lubin,8,2,1,5,9,18,-9,7,poland
Gornik Zabrze,8,1,3,4,12,13,-1,6,poland
Ruch Chorzow,8,0,4,4,9,16,-7,4,poland
Puszcza Niepolo,8,1,1,6,10,20,-10,4,poland
LKS Lodz,8,0,0,8,3,17,-14,0,poland
Motor Lublin,8,5,0,3,9,5,4,15,poland2
Arka Gdynia,8,4,1,3,13,12,1,13,poland2
Miedz Legnica,8,3,3,2,13,10,3,12,poland2
T. Nieciecza,8,3,2,3,17,10,7,11,poland2
Stal Rzeszow,8,3,2,3,12,12,0,11,poland2
Polonia Warszaw,8,3,2,3,8,8,0,11,poland2
Gornik Leczna,8,3,2,3,7,12,-5,11,poland2
Odra Opole,7,3,1,3,10,9,1,10,poland2
Wisla Krakow,8,2,3,3,12,11,1,9,poland2
Lechia Gdansk,8,2,3,3,7,10,-3,9,poland2
Tychy,8,3,0,5,7,12,-5,9,poland2
Znicz Pruszkow,8,3,0,5,7,13,-6,9,poland2
Z. Sosnowiec,8,1,4,3,3,6,-3,7,poland2
Katowice,8,1,4,3,10,14,-4,7,poland2
Wisla Plock,8,1,4,3,6,13,-7,7,poland2
Resovia Rzeszow,8,2,0,6,8,19,-11,6,poland2
Chrobry Glogow,8,1,2,5,7,13,-6,5,poland2
Podbeskidzie,8,0,1,7,3,17,-14,1,poland2
Pogon Siedlce,8,5,0,3,15,10,5,15,poland3
K. Kolobrzeg,8,4,2,2,21,18,3,14,poland3
Kalisz,8,4,1,3,13,10,3,13,poland3
Hutnik Krakow,8,4,0,4,10,12,-2,12,poland3
Radunia Stezyca,8,3,3,2,9,12,-3,12,poland3
Lech Poznan B,8,3,2,3,10,10,0,11,poland3
Chojniczanka,8,3,2,3,11,12,-1,11,poland3
SKRA Czestochow,8,2,4,2,10,8,2,10,poland3
LKS Lodz B,8,2,2,4,11,13,-2,8,poland3
Olimpia Elblag,7,1,2,4,6,10,-4,5,poland3
Wisla Pulawy,8,1,2,5,11,17,-6,5,poland3
Stalowa Wola,8,1,2,5,3,13,-10,5,poland3
Zaglebie L. B,8,1,1,6,10,17,-7,4,poland3
Sandecja Nowy,8,1,1,6,5,14,-9,4,poland3
Stomil Olsztyn,8,1,0,7,7,15,-8,3,poland3
Jastrzebie,8,0,3,5,5,13,-8,3,poland3
Polonia Bytom,8,0,3,5,5,13,-8,3,poland3
O. Grudziadz,8,0,2,6,8,19,-11,2,poland3
FC Porto,7,6,0,1,12,4,8,18,portugal
Sporting Braga,7,5,1,1,19,13,6,16,portugal
Benfica,7,5,1,1,13,7,6,16,portugal
Moreirense,6,4,1,1,8,4,4,13,portugal
Sporting CP,6,3,1,2,11,9,2,10,portugal
Guimaraes,6,3,1,2,6,7,-1,10,portugal
Casa Pia,7,2,2,3,7,11,-4,8,portugal
Farense,6,2,1,3,9,9,0,7,portugal
Famalicao,7,1,4,2,6,7,-1,7,portugal
Boavista,6,2,1,3,9,12,-3,7,portugal
Portimonense,7,2,1,4,7,17,-10,7,portugal
Estrela Amadora,6,1,3,2,7,9,-2,6,portugal
Arouca,6,1,2,3,8,8,0,5,portugal
Vizela,6,1,2,3,6,9,-3,5,portugal
Rio Ave,6,0,3,3,5,10,-5,3,portugal
Estoril,7,1,0,6,11,18,-7,3,portugal
Chaves,7,1,0,6,4,22,-18,3,portugal
Gil Vicente,6,0,0,6,6,15,-9,0,portugal
Maritimo,7,5,0,2,12,8,4,15,portugal2
AVS,6,5,0,1,11,7,4,15,portugal2
Santa Clara,6,3,3,0,9,4,5,12,portugal2
Torreense,7,3,2,2,8,7,1,11,portugal2
FC Porto B,6,3,1,2,15,8,7,10,portugal2
Nacional,6,3,1,2,9,8,1,10,portugal2
Tondela,6,2,3,1,10,11,-1,9,portugal2
Leixoes,7,2,2,3,6,11,-5,8,portugal2
Uniao de Leiria,7,2,1,4,10,9,1,7,portugal2
Oliveirense,6,2,1,3,5,11,-6,7,portugal2
Benfica B,6,1,2,3,7,8,-1,5,portugal2
Mafra,7,1,2,4,8,11,-3,5,portugal2
Os Belenense,6,1,1,4,4,8,-4,4,portugal2
Pacos Ferreira,6,1,1,4,4,8,-4,4,portugal2
Academico Viseu,7,0,4,3,5,11,-6,4,portugal2
Feirense,7,1,1,5,4,12,-8,4,portugal2
Vilaverdense,7,1,1,5,3,12,-9,4,portugal2
Penafiel,7,0,1,6,2,11,-9,1,portugal2
Al Rayyan,8,4,1,3,15,13,2,13,qatar
Umm Salal,5,3,1,1,9,5,4,10,qatar
Al Duhail,5,3,1,1,11,9,2,10,qatar
Al Gharafa,5,3,1,1,14,13,1,10,qatar
Al Shamal,8,2,4,2,11,13,-2,10,qatar
Al Sadd,3,3,0,0,8,2,6,9,qatar
Al Ahli Doha,5,2,0,3,10,12,-2,6,qatar
Al Wakrah,4,1,2,1,5,3,2,5,qatar
Qatar SC,6,1,2,3,7,8,-1,5,qatar
Al Arabi,4,1,1,2,10,8,2,4,qatar
Al Markhiya,5,0,1,4,3,17,-14,1,qatar
Al Muaidar,5,0,0,5,7,19,-12,0,qatar
U. Cluj,8,4,4,0,17,11,6,16,romania
FCSB,8,4,3,1,14,9,5,15,romania
Otelul,8,3,5,0,12,6,6,14,romania
Rapid Bucharest,8,2,5,1,11,9,2,11,romania
P. Iasi,8,3,2,3,10,8,2,11,romania
Voluntari,8,2,4,2,11,13,-2,10,romania
Farul Constanta,8,3,0,5,12,19,-7,9,romania
CFR Cluj,8,2,2,4,13,14,-1,8,romania
Petrolul,8,1,5,2,5,6,-1,8,romania
U Craiova 1948,8,2,2,4,9,12,-3,8,romania
Univ. Craiova,8,2,2,4,9,12,-3,8,romania
UTA Arad,8,1,4,3,7,11,-4,7,romania
Sepsi OSK,8,2,0,6,8,11,-3,6,romania
Hermannstadt,8,0,6,2,6,9,-3,6,romania
Din. Bucharest,8,1,1,6,6,17,-11,4,romania
Botosani,8,0,3,5,9,20,-11,3,romania
Rubin Kazan,8,5,0,3,7,6,1,15,russia
Zenit,8,4,2,2,14,9,5,14,russia
Lokomotiv M.,8,3,3,2,14,13,1,12,russia
Dinamo Moscow,8,2,5,1,12,11,1,11,russia
FC Krasnodar,8,2,4,2,9,8,1,10,russia
CSKA Moscow,8,1,5,2,11,12,-1,8,russia
Fakel Voronezh,8,2,2,4,5,10,-5,8,russia
Spartak Moscow,8,2,1,5,10,15,-5,7,russia
Krylya Sovetov,8,1,2,5,8,15,-7,5,russia
Akhmat Grozny,8,1,2,5,4,11,-7,5,russia
Orenburg,8,1,2,5,6,14,-8,5,russia
Ural,8,1,1,6,5,16,-11,4,russia
Rostov,8,0,3,5,6,15,-9,3,russia
PFC Sochi,8,1,0,7,6,16,-10,3,russia
Baltika,8,0,2,6,4,11,-7,2,russia
Nizhny Novgorod,8,0,1,7,3,12,-9,1,russia
Khimki,8,5,1,2,16,9,7,16,russia2
Makhachkala,8,4,3,1,6,2,4,15,russia2
Akron,8,4,3,1,8,5,3,15,russia2
Arsenal Tula,8,3,5,0,10,4,6,14,russia2
Tyumen,8,4,2,2,10,8,2,14,russia2
Leningradets,8,4,1,3,10,9,1,13,russia2
Neftekhimik,8,3,2,3,7,7,0,11,russia2
V. Astrakhan,8,2,4,2,6,5,1,10,russia2
A. Vladikavkaz,8,2,4,2,9,11,-2,10,russia2
Rodina Moskva,8,2,3,3,13,10,3,9,russia2
Shinnik,8,2,2,4,8,15,-7,8,russia2
Torpedo Moscow,8,1,4,3,5,7,-2,7,russia2
Urozhay,8,2,1,5,7,13,-6,7,russia2
Kamaz,8,1,3,4,5,10,-5,6,russia2
Chernomorets,8,1,3,4,5,12,-7,6,russia2
Sokol Saratov,8,1,2,5,8,18,-10,5,russia2
Yenisey,8,0,2,6,6,14,-8,2,russia2
SKA Khabarovsk,8,0,2,6,4,14,-10,2,russia2
Al Hilal,8,7,1,0,28,6,22,22,saudiarabia
Al Nassr,8,6,0,2,22,10,12,18,saudiarabia
Al Fateh,8,4,2,2,14,11,3,14,saudiarabia
Al Taawon,8,4,2,2,12,9,3,14,saudiarabia
Al Ittihad,8,3,3,2,11,6,5,12,saudiarabia
Al Feiha,8,3,3,2,13,13,0,12,saudiarabia
Al Ahli Jeddah,7,3,1,3,17,15,2,10,saudiarabia
Al Ittifaq,8,2,3,3,6,7,-1,9,saudiarabia
Damak,8,2,2,4,11,13,-2,8,saudiarabia
Al Khaleej,8,2,1,5,9,15,-6,7,saudiarabia
Al Akhdoud,8,2,1,5,6,13,-7,7,saudiarabia
Al Riyadh,8,2,1,5,9,22,-13,7,saudiarabia
Al Wahda,7,2,0,5,8,16,-8,6,saudiarabia
Al Shabab,8,1,2,5,6,15,-9,5,saudiarabia
Al Raed,8,0,4,4,7,11,-4,4,saudiarabia
Al Hazm,8,0,4,4,7,16,-9,4,saudiarabia
Al Tai,8,1,1,6,6,17,-11,4,saudiarabia
Abha,8,0,1,7,8,23,-15,1,saudiarabia
Jeddah,8,4,2,2,15,12,3,14,saudiarabia2
Al Adalh,7,4,1,2,14,10,4,13,saudiarabia2
Ohod,6,4,0,2,9,6,3,12,saudiarabia2
Al Orubah,6,4,0,2,8,6,2,12,saudiarabia2
Al Quadisiya,5,3,1,1,4,1,3,10,saudiarabia2
Al Kholood,6,3,0,3,11,7,4,9,saudiarabia2
Al Najma,6,2,2,2,15,12,3,8,saudiarabia2
Al Batin,6,2,1,3,3,4,-1,7,saudiarabia2
Al Arabi,5,1,2,2,9,8,1,5,saudiarabia2
Al Faisaly,6,1,2,3,6,10,-4,5,saudiarabia2
Al Jabalain,6,1,2,3,4,9,-5,5,saudiarabia2
Al-Ain,7,1,2,4,4,11,-7,5,saudiarabia2
Al-Jndal,6,1,1,4,3,12,-9,4,saudiarabia2
Al Safa,6,1,0,5,3,12,-9,3,saudiarabia2
Al Taraji,6,1,0,5,2,11,-9,3,saudiarabia2
Al Bukayriyah,5,0,2,3,2,5,-3,2,saudiarabia2
Hajer,5,0,2,3,4,11,-7,2,saudiarabia2
Al Qaisoma,6,0,1,5,6,14,-8,1,saudiarabia2
Rangers,8,6,1,1,16,2,14,19,scotland
Celtic,8,6,1,1,17,5,12,19,scotland
Hearts,8,4,0,4,8,7,1,12,scotland
Hibernian,8,3,3,2,12,15,-3,12,scotland
Aberdeen,8,2,2,4,9,17,-8,8,scotland
Dundee FC,7,1,3,3,9,13,-4,6,scotland
Kilmarnock,8,1,3,4,6,10,-4,6,scotland
Motherwell,8,1,3,4,5,11,-6,6,scotland
Ross County,8,1,3,4,8,16,-8,6,scotland
Livingston,8,1,2,5,6,14,-8,5,scotland
St. Mirren,8,1,2,5,4,12,-8,5,scotland
St. Johnstone,7,0,3,4,1,10,-9,3,scotland
Dundee Utd,7,6,1,0,18,2,16,19,scotland2
Raith Rovers,7,5,1,1,12,8,4,16,scotland2
Partick Thistle,7,3,2,2,17,10,7,11,scotland2
Dunfermline,7,3,2,2,8,8,0,11,scotland2
Ayr Utd,8,3,1,4,13,14,-1,10,scotland2
Inverness,7,2,2,3,10,9,1,8,scotland2
Greenock Morton,7,2,2,3,8,10,-2,8,scotland2
Queen`s Park,7,2,2,3,10,14,-4,8,scotland2
Arbroath,6,2,0,4,7,13,-6,6,scotland2
Airdrieonians,7,1,1,5,4,12,-8,4,scotland2
Falkirk,7,4,3,0,16,6,10,15,scotland3
Hamilton,8,4,3,1,12,5,7,15,scotland3
Cove Rangers,8,4,2,2,12,7,5,14,scotland3
Queen of South,8,4,0,4,10,13,-3,12,scotland3
Kelty Hearts,8,3,2,3,15,12,3,11,scotland3
Montrose,6,3,0,3,13,9,4,9,scotland3
Alloa Athletic,8,2,1,5,10,16,-6,7,scotland3
Stirling Albion,8,2,0,6,5,17,-12,6,scotland3
Edinburgh City,6,0,2,4,7,13,-6,2,scotland3
Annan Athletic,7,0,2,5,7,19,-12,2,scotland3
Stenhousemuir,8,6,2,0,12,2,10,20,scotland4
Peterhead,8,5,1,2,13,8,5,16,scotland4
Spartans,6,3,2,1,12,10,2,11,scotland4
Dumbarton,6,3,1,2,10,7,3,10,scotland4
Forfar Athletic,8,2,3,3,6,6,0,9,scotland4
Bonnyrigg Rose,7,2,1,4,7,12,-5,7,scotland4
East Fife,7,1,3,3,10,11,-1,6,scotland4
Stranraer,8,1,3,4,8,19,-11,6,scotland4
Clyde,6,0,3,3,6,10,-4,3,scotland4
Elgin City,8,0,1,7,4,23,-19,1,scotland4
Partizan,8,7,1,0,20,6,14,22,serbia
Red Star,8,6,0,2,18,12,6,18,serbia
Backa Topola,8,4,4,0,13,3,10,16,serbia
Cukaricki,8,3,1,4,10,10,0,10,serbia
Napredak,7,3,1,3,10,11,-1,10,serbia
Mladost Lucani,8,3,1,4,8,13,-5,10,serbia
Radnicki 1923,8,3,0,5,11,14,-3,9,serbia
Novi Pazar,8,2,2,4,7,7,0,8,serbia
S. Subotica,8,2,1,5,6,12,-6,7,serbia
Z. Pancevo,8,2,1,5,8,15,-7,7,serbia
IMT N. Beograd,8,2,0,6,11,16,-5,6,serbia
Vojvodina,8,1,3,4,8,18,-10,6,serbia
Radnicki Nis,8,1,2,5,6,10,-4,5,serbia
Vozdovac,8,1,2,5,4,15,-11,5,serbia
R. Surdulica,8,0,4,4,5,12,-7,4,serbia
Javor Ivanjica,8,1,1,6,7,15,-8,4,serbia
OFK Beograd,8,5,2,1,18,9,9,17,serbia2
Indija,8,5,2,1,9,4,5,17,serbia2
Metalac GM,8,3,2,3,6,7,-1,11,serbia2
Dubocica,8,2,4,2,5,5,0,10,serbia2
S. Mitrovica,8,3,1,4,7,8,-1,10,serbia2
Jedinstvo Ub,8,3,1,4,10,13,-3,10,serbia2
Kolubara,8,2,3,3,8,8,0,9,serbia2
Smederevo,8,2,3,3,7,8,-1,9,serbia2
Tekstilac Odzac,8,2,2,4,6,7,-1,8,serbia2
Mladost Novi S.,8,1,3,4,5,11,-6,6,serbia2
Sloboda Uzice,8,1,3,4,2,8,-6,6,serbia2
Macva Sabac,8,1,2,5,4,8,-4,5,serbia2
Radnicki B.,8,1,2,5,9,16,-7,5,serbia2
OFK Vrac,8,1,2,5,5,12,-7,5,serbia2
Graficar,8,0,4,4,5,13,-8,4,serbia2
Novi Sad,8,0,0,8,6,19,-13,0,serbia2
Lion City,8,6,1,1,35,16,19,19,singapore
Khalsa,8,6,0,2,26,22,4,18,singapore
A. Niigata (S),8,5,2,1,24,11,13,17,singapore
Tampines Rovers,8,4,3,1,14,12,2,15,singapore
Hougang,8,5,0,3,17,16,1,15,singapore
Geylang,8,4,1,3,15,16,-1,13,singapore
DPMM FC,8,2,2,4,10,12,-2,8,singapore
Tanjong Pagar,8,2,1,5,16,24,-8,7,singapore
Young Lions,8,0,0,8,5,29,-24,0,singapore
S. Bratislava,8,7,0,1,22,7,15,21,slovakia
Spartak Trnava,8,6,1,1,14,8,6,19,slovakia
Banska Bystrica,8,5,1,2,19,9,10,16,slovakia
Zilina,8,4,2,2,10,6,4,14,slovakia
Podbrezova,8,4,0,4,18,13,5,12,slovakia
DAC Streda,8,3,3,2,8,7,1,12,slovakia
Trencin,8,2,3,3,9,11,-2,9,slovakia
Skalica,8,1,2,5,6,12,-6,5,slovakia
FC Kosice,8,1,1,6,6,16,-10,4,slovakia
Ruzomberok,8,0,4,4,8,19,-11,4,slovakia
Z. Michalovce,8,0,2,6,7,18,-11,2,slovakia
Zlate Moravce,8,0,1,7,3,14,-11,1,slovakia
Komarno,8,7,0,1,16,8,8,21,slovakia2
Tatran Presov,8,5,1,2,15,6,9,16,slovakia2
Petrzalka,8,4,3,1,16,9,7,15,slovakia2
Puchov,8,5,0,3,20,14,6,15,slovakia2
S. Bratislava B,8,4,2,2,12,10,2,14,slovakia2
P. Bystrica,8,3,4,1,10,6,4,13,slovakia2
Zilina B,8,4,1,3,12,11,1,13,slovakia2
Pohronie,8,3,1,4,15,14,1,10,slovakia2
Samorin,8,3,1,4,11,13,-2,10,slovakia2
Futura Humenne,8,2,3,3,13,17,-4,9,slovakia2
Spartak Myjava,7,2,2,3,8,10,-2,8,slovakia2
L. Mikulas,8,2,1,5,8,16,-8,7,slovakia2
OFK Malzenice,7,1,1,5,9,16,-7,4,slovakia2
Slavoj Trebisov,7,1,1,5,5,15,-10,4,slovakia2
Dolny Kubin,7,0,2,5,6,19,-13,2,slovakia2
Spisska Nova V.,8,0,1,7,7,17,-10,1,slovakia2
NK Celje,8,7,1,0,21,4,17,22,slovenia
NK Olimpija,8,6,0,2,17,10,7,18,slovenia
Koper,8,4,3,1,13,8,5,15,slovenia
Mura,8,4,1,3,10,8,2,13,slovenia
Radomlje,8,3,2,3,9,9,0,11,slovenia
Domzale,8,3,1,4,13,12,1,10,slovenia
Bravo,8,1,4,3,8,11,-3,7,slovenia
Aluminij,8,2,1,5,7,11,-4,7,slovenia
Maribor,8,1,3,4,9,13,-4,6,slovenia
Rogaska,8,2,0,6,9,18,-9,6,slovenia
Mamelodi S.,7,7,0,0,11,1,10,21,southafrica
Golden Arrows,7,4,0,3,8,9,-1,12,southafrica
Stellenbosch,7,3,2,2,8,5,3,11,southafrica
SuperSport Utd,7,3,2,2,9,8,1,11,southafrica
Sekhukhune,7,3,1,3,6,6,0,10,southafrica
Cape Town City,8,3,1,4,7,8,-1,10,southafrica
Kaizer Chiefs,7,3,0,4,6,6,0,9,southafrica
Moroka Swallows,5,2,2,1,5,4,1,8,southafrica
Chippa Utd,6,2,2,2,4,5,-1,8,southafrica
Royal AM,7,2,1,4,8,13,-5,7,southafrica
Orlando Pirates,6,1,3,2,3,4,-1,6,southafrica
AmaZulu,6,1,3,2,5,7,-2,6,southafrica
Richards Bay,6,1,2,3,5,8,-3,5,southafrica
Polokwane,6,1,2,3,4,8,-4,5,southafrica
TS Galaxy,6,0,1,5,0,7,-7,1,southafrica
Cape Town Spurs,6,0,0,6,5,14,-9,0,southafrica
Magesi,8,4,2,2,10,9,1,14,southafrica2
Orbit College,7,4,0,3,9,13,-4,12,southafrica2
Hungry Lions,7,3,1,3,9,7,2,10,southafrica2
Pretoria U.,8,2,4,2,5,5,0,10,southafrica2
Baroka,7,2,3,2,7,7,0,9,southafrica2
JDR Stars,8,2,3,3,9,12,-3,9,southafrica2
Maritzburg Utd,8,1,5,2,6,8,-2,8,southafrica2
Casric Stars,7,2,2,3,6,10,-4,8,southafrica2
Pretoria C.,8,1,4,3,8,11,-3,7,southafrica2
NB La Masia,7,1,4,2,3,6,-3,7,southafrica2
Upington City,7,0,5,2,5,7,-2,5,southafrica2
Milford,8,1,2,5,6,11,-5,5,southafrica2
Platinum City,8,1,1,6,4,10,-6,4,southafrica2
Venda FC,7,1,1,5,5,15,-10,4,southafrica2
Tshakhuma,7,0,2,5,7,14,-7,2,southafrica2
Black Leopards,7,0,1,6,0,12,-12,1,southafrica2
Gwangju,8,4,3,1,10,7,3,15,southkorea
Seoul,8,3,4,1,15,12,3,13,southkorea
Incheon Utd,8,3,3,2,8,7,1,12,southkorea
Jeonbuk Motors,8,3,2,3,7,6,1,11,southkorea
Suwon City,8,3,2,3,8,11,-3,11,southkorea
Suwon Bluewings,8,3,1,4,8,15,-7,10,southkorea
Gangwon,8,2,3,3,6,6,0,9,southkorea
Pohang Steelers,8,1,5,2,8,8,0,8,southkorea
Daegu,8,2,2,4,8,11,-3,8,southkorea
Daejeon Citizen,8,1,4,3,10,14,-4,7,southkorea
Ulsan,8,1,3,4,7,13,-6,6,southkorea
Jeju Utd,8,0,2,6,6,13,-7,2,southkorea
Gyeongnam,8,4,2,2,9,7,2,14,southkorea2
Busan IPark,8,4,1,3,9,10,-1,13,southkorea2
Cheongju,8,3,3,2,7,7,0,12,southkorea2
Ansan Greeners,8,3,2,3,13,14,-1,11,southkorea2
Gimcheon Sangmu,8,3,1,4,14,12,2,10,southkorea2
Gimpo,8,2,4,2,7,6,1,10,southkorea2
Cheonan City,8,2,2,4,9,9,0,8,southkorea2
Seongnam,8,2,2,4,8,14,-6,8,southkorea2
Jeonnam Dragons,8,2,0,6,8,15,-7,6,southkorea2
Bucheon FC,8,1,2,5,6,11,-5,5,southkorea2
Anyang,8,1,1,6,10,19,-9,4,southkorea2
Chungnam Asan,8,1,1,6,3,12,-9,4,southkorea2
Seoul E-Land,8,1,0,7,3,14,-11,3,southkorea2
Girona,8,7,1,0,20,10,10,22,spain
Real Madrid,8,5,2,1,15,7,8,17,spain
FC Barcelona,7,3,4,0,12,9,3,13,spain
Real Sociedad,8,3,3,2,12,8,4,12,spain
Rayo Vallecano,8,3,3,2,7,7,0,12,spain
Athletic Bilbao,7,3,2,2,8,7,1,11,spain
Atletico Madrid,7,3,1,3,13,6,7,10,spain
Las Palmas,8,3,1,4,6,8,-2,10,spain
Osasuna,8,3,1,4,11,14,-3,10,spain
Villarreal,7,2,3,2,8,10,-2,9,spain
Real Betis,8,1,5,2,8,14,-6,8,spain
Celta Vigo,7,1,2,4,10,13,-3,5,spain
Mallorca,8,1,2,5,9,15,-6,5,spain
Getafe,8,0,4,4,9,16,-7,4,spain
Sevilla FC,7,0,3,4,7,11,-4,3,spain
Alaves,8,0,3,5,4,10,-6,3,spain
Cadiz,8,0,3,5,5,14,-9,3,spain
Valencia,8,0,3,5,7,17,-10,3,spain
Granada,8,0,1,7,8,20,-12,1,spain
Almeria,8,0,1,7,7,21,-14,1,spain
Leganes,8,4,1,3,9,5,4,13,spain2
Eibar,8,4,1,3,13,11,2,13,spain2
Sporting Gijon,8,3,3,2,9,5,4,12,spain2
Valladolid,8,4,0,4,8,13,-5,12,spain2
Huesca,8,3,2,3,6,5,1,11,spain2
Mirandes,8,2,4,2,11,10,1,10,spain2
Espanyol,8,3,1,4,9,10,-1,10,spain2
Real Zaragoza,8,2,3,3,8,9,-1,9,spain2
Levante,8,2,3,3,6,7,-1,9,spain2
Racing,8,2,3,3,11,13,-2,9,spain2
Eldense,8,2,3,3,9,12,-3,9,spain2
Elche,8,2,3,3,6,11,-5,9,spain2
Real Oviedo,8,1,5,2,7,7,0,8,spain2
Cartagena,8,1,5,2,7,8,-1,8,spain2
Alcorcon,8,2,2,4,10,14,-4,8,spain2
Racing Ferrol,8,2,2,4,8,12,-4,8,spain2
Tenerife,8,2,1,5,7,12,-5,7,spain2
Villarreal B,8,1,3,4,8,13,-5,6,spain2
Albacete,8,1,3,4,9,15,-6,6,spain2
Burgos,8,1,1,6,5,15,-10,4,spain2
FC Andorra,8,0,3,5,7,14,-7,3,spain2
Amorebieta,8,0,1,7,3,18,-15,1,spain2
Mjallby,8,5,1,2,13,7,6,16,sweden
Varnamo,8,5,1,2,17,12,5,16,sweden
Sirius,8,4,1,3,14,10,4,13,sweden
Malmo FF,8,4,1,3,11,9,2,13,sweden
Djurgarden,8,4,1,3,8,7,1,13,sweden
Elfsborg,8,4,0,4,11,7,4,12,sweden
Hammarby,8,3,3,2,6,4,2,12,sweden
IFK Goteborg,8,3,3,2,10,12,-2,12,sweden
Kalmar,8,3,0,5,10,15,-5,9,sweden
AIK,8,2,2,4,8,15,-7,8,sweden
Norrkoping,8,2,1,5,12,17,-5,7,sweden
Degerfors,8,1,3,4,7,13,-6,6,sweden
Hacken,8,1,1,6,8,14,-6,4,sweden
Brommapojkarna,8,1,1,6,12,19,-7,4,sweden
Halmstad,8,0,4,4,6,13,-7,4,sweden
Varberg BoIS,8,1,0,7,9,24,-15,3,sweden
GAIS,8,5,1,2,24,5,19,16,sweden2
Oster,8,4,2,2,13,10,3,14,sweden2
Vasteras,8,4,2,2,10,9,1,14,sweden2
Trelleborg,8,3,4,1,13,11,2,13,sweden2
Landskrona,8,4,1,3,14,18,-4,13,sweden2
Orgryte,8,4,0,4,10,11,-1,12,sweden2
Ostersunds,8,2,4,2,10,12,-2,10,sweden2
Gefle,8,1,4,3,8,11,-3,7,sweden2
Utsikten,8,2,1,5,6,14,-8,7,sweden2
GIF Sundsvall,8,1,3,4,9,17,-8,6,sweden2
AFC Eskilstuna,8,1,3,4,5,14,-9,6,sweden2
Skovde AIK,8,1,2,5,13,21,-8,5,sweden2
Brage,8,1,2,5,3,12,-9,5,sweden2
Helsingborg,8,0,4,4,7,13,-6,4,sweden2
Orebro,8,1,1,6,11,20,-9,4,sweden2
Jonkopings,8,0,1,7,6,22,-16,1,sweden2
FC Zurich,7,3,4,0,14,5,9,13,switzerland
BSC Young Boys,8,3,3,2,12,10,2,12,switzerland
Servette,8,3,3,2,8,9,-1,12,switzerland
Lugano,8,3,0,5,16,17,-1,9,switzerland
St. Gallen,8,1,3,4,9,13,-4,6,switzerland
Grasshopper,8,2,0,6,8,14,-6,6,switzerland
Winterthur,8,1,2,5,16,22,-6,5,switzerland
Lausanne Sport,8,1,2,5,10,18,-8,5,switzerland
Luzern,8,1,2,5,8,18,-10,5,switzerland
Yverdon,8,1,2,5,7,19,-12,5,switzerland
Lausanne Ouchy,8,1,1,6,8,16,-8,4,switzerland
FC Basel,8,1,1,6,9,20,-11,4,switzerland
Foutoua,4,2,2,0,7,3,4,8,syria
Wathbah,4,2,1,1,7,3,4,7,syria
Hottin,4,2,0,2,4,4,0,6,syria
Taliya,5,2,0,3,3,6,-3,6,syria
Al Wahda,4,1,1,2,2,3,-1,4,syria
Al Sahel,4,1,1,2,3,5,-2,4,syria
Al Ittihad,4,1,1,2,3,6,-3,4,syria
Karama,4,0,3,1,4,5,-1,3,syria
Jabala,3,0,2,1,3,4,-1,2,syria
Al Jaish,4,0,2,2,3,5,-2,2,syria
Teshrin,4,0,2,2,1,4,-3,2,syria
Horriya,4,0,0,4,1,10,-9,0,syria
Singida,6,4,0,2,10,8,2,12,tanzania
Azam,5,3,1,1,9,4,5,10,tanzania
Young Africans,4,3,0,1,10,3,7,9,tanzania
Simba,3,3,0,0,9,4,5,9,tanzania
JKT Tanzania,7,2,2,3,7,12,-5,8,tanzania
Dodoma Jiji,7,2,1,4,6,9,-3,7,tanzania
Namungo,6,1,3,2,5,5,0,6,tanzania
T. Prisons,7,1,3,3,6,9,-3,6,tanzania
KMC,6,1,3,2,4,13,-9,6,tanzania
Coastal Union,6,1,2,3,4,8,-4,5,tanzania
Geita Gold,6,1,2,3,3,7,-4,5,tanzania
Tabora,8,0,5,3,2,8,-6,5,tanzania
Kagera Sugar,6,1,1,4,3,6,-3,4,tanzania
Ihefu,6,0,2,4,4,10,-6,2,tanzania
Mashujaa,4,0,1,3,2,6,-4,1,tanzania
Mtibwa Sugar,6,0,1,5,4,13,-9,1,tanzania
Pathum Utd,7,4,2,1,12,8,4,14,thailand
Bangkok Utd,4,4,0,0,9,1,8,12,thailand
Port FC,7,3,2,2,15,9,6,11,thailand
Uthai Thani,6,3,1,2,10,10,0,10,thailand
Muang Thong Utd,8,3,1,4,11,15,-4,10,thailand
Buriram Utd,5,2,3,0,5,3,2,9,thailand
Chonburi,7,1,3,3,11,13,-2,6,thailand
Police Tero,4,2,0,2,5,10,-5,6,thailand
Sukhothai,6,1,2,3,6,11,-5,5,thailand
Nakhon Pathom,7,1,2,4,9,16,-7,5,thailand
Khon Kaen Utd,7,1,2,4,8,19,-11,5,thailand
Chiangrai Utd,5,1,1,3,3,7,-4,4,thailand
Trat,5,1,1,3,4,11,-7,4,thailand
Ratchaburi,7,0,3,4,5,10,-5,3,thailand
Prachuap,7,0,2,5,6,13,-7,2,thailand
Lamphun Warrior,6,0,2,4,6,14,-8,2,thailand
Ayutthaya Utd,8,4,3,1,10,4,6,15,thailand2
N. Bua Pitchaya,8,4,2,2,14,12,2,14,thailand2
Pattaya United,7,4,1,2,14,10,4,13,thailand2
Nakhon Si Thamm,6,4,1,1,11,8,3,13,thailand2
Rayong,7,3,3,1,12,4,8,12,thailand2
Phrae Utd,7,3,1,3,7,12,-5,10,thailand2
Chiangmai FC,7,2,3,2,5,5,0,9,thailand2
N. Ratchasima,8,2,3,3,9,10,-1,9,thailand2
Lampang,8,2,2,4,8,12,-4,8,thailand2
Samut Prakan,7,2,2,3,8,13,-5,8,thailand2
Suphanburi,8,2,2,4,6,11,-5,8,thailand2
Kanchanaburi,8,1,4,3,8,10,-2,7,thailand2
Chiangmai Utd,7,1,3,3,9,13,-4,6,thailand2
Chainat,7,1,3,3,2,6,-4,6,thailand2
Chanthaburi,8,1,2,5,11,16,-5,5,thailand2
Customs Utd,8,1,2,5,5,17,-12,5,thailand2
Kasetsart,8,1,1,6,7,21,-14,4,thailand2
Krabi,6,1,0,5,4,18,-14,3,thailand2
Fenerbahce,7,6,1,0,14,1,13,19,turkey
Galatasaray,8,6,1,1,12,3,9,19,turkey
Trabzonspor,8,3,2,3,16,13,3,11,turkey
Kayserispor,7,3,2,2,10,11,-1,11,turkey
Besiktas,8,3,1,4,11,14,-3,10,turkey
Sivasspor,7,3,1,3,10,14,-4,10,turkey
Antalyaspor,7,2,2,3,12,10,2,8,turkey
Ankaragucu,7,2,2,3,12,12,0,8,turkey
Kasimpasa,7,2,2,3,10,13,-3,8,turkey
Pendikspor,8,2,2,4,10,16,-6,8,turkey
Rizespor,7,2,1,4,7,15,-8,7,turkey
Hatayspor,8,1,3,4,9,10,-1,6,turkey
Konyaspor,7,1,3,3,7,12,-5,6,turkey
Gaziantep,8,2,0,6,8,15,-7,6,turkey
F. Karagumruk,7,1,2,4,7,9,-2,5,turkey
Basaksehir,8,1,2,5,4,11,-7,5,turkey
Alanyaspor,7,1,2,4,2,11,-9,5,turkey
Adana Demirspor,7,0,4,3,8,13,-5,4,turkey
Samsunspor,8,1,1,6,7,15,-8,4,turkey
Istanbulspor,7,0,1,6,3,14,-11,1,turkey
Eyupspor,7,6,0,1,22,6,16,18,turkey2
Kocaelispor,7,6,0,1,14,4,10,18,turkey2
Goztepe,7,5,1,1,10,3,7,16,turkey2
Bandirmaspor,8,4,3,1,9,5,4,15,turkey2
Corum,8,4,2,2,15,7,8,14,turkey2
Sakaryaspor,7,4,1,2,11,9,2,13,turkey2
Genclerbirligi,7,3,3,1,9,8,1,12,turkey2
Bodrumspor,8,3,2,3,8,8,0,11,turkey2
Umraniyespor,8,3,1,4,9,10,-1,10,turkey2
Keciorengucu,7,2,3,2,5,8,-3,9,turkey2
Sanliurfaspor,8,2,3,3,6,13,-7,9,turkey2
Boluspor,6,2,2,2,4,4,0,8,turkey2
Manisa BB,7,2,2,3,8,9,-1,8,turkey2
Erzurum BB,8,1,4,3,5,9,-4,7,turkey2
Adanaspor,8,2,1,5,6,11,-5,7,turkey2
Tuzlaspor,7,1,2,4,5,11,-6,5,turkey2
Giresunspor,8,1,1,6,8,19,-11,4,turkey2
Altay,8,0,1,7,3,20,-17,1,turkey2
Al Sharjah,6,4,2,0,16,9,7,14,uae
Al Wasl,5,3,2,0,17,8,9,11,uae
Shabab Al Ahli,4,3,1,0,9,2,7,10,uae
Al Ain,6,3,1,2,11,8,3,10,uae
Al Jazira,4,3,0,1,13,6,7,9,uae
Ajman,6,2,3,1,13,14,-1,9,uae
Ittihad Kalba,4,2,1,1,10,7,3,7,uae
Al Wahda,5,2,1,2,6,7,-1,7,uae
Al Bataeh,4,2,0,2,6,8,-2,6,uae
Al Nasr,5,1,2,2,9,10,-1,5,uae
Hatta,5,1,1,3,7,8,-1,4,uae
Emirates,6,1,1,4,4,15,-11,4,uae
Bani Yas,5,1,0,4,6,13,-7,3,uae
Al Khaleej,3,0,0,3,2,6,-4,0,uae
Kryvbas KR,8,5,2,1,15,5,10,17,ukraine
Dnipro-1,8,5,2,1,12,8,4,17,ukraine
Shakhtar,7,4,3,0,14,7,7,15,ukraine
Polessya,8,4,2,2,10,4,6,14,ukraine
Rukh Lviv,8,4,2,2,14,10,4,14,ukraine
Vorskla Poltava,8,4,2,2,8,9,-1,14,ukraine
LNZ Cherkasy,8,3,3,2,8,7,1,12,ukraine
Dynamo Kyiv,6,3,1,2,15,11,4,10,ukraine
Zorya Luhansk,8,2,4,2,13,12,1,10,ukraine
Kolos Kovalivka,7,1,5,1,4,4,0,8,ukraine
Obolon,8,2,2,4,5,11,-6,8,ukraine
Chornomorets,8,2,0,6,12,16,-4,6,ukraine
Oleksandria,8,0,3,5,4,10,-6,3,ukraine
Veres,8,0,3,5,2,10,-8,3,ukraine
Metalist 1925,8,0,2,6,9,17,-8,2,ukraine
FC Minaj,7,0,2,5,3,13,-10,2,ukraine
Wanderers,8,5,3,0,11,4,7,18,uruguay
Defensor S.,7,4,2,1,13,3,10,14,uruguay
Montevideo City,7,4,1,2,13,8,5,13,uruguay
Penarol,6,3,2,1,10,7,3,11,uruguay
Nacional,8,2,4,2,10,8,2,10,uruguay
Cerro Largo,7,2,4,1,5,3,2,10,uruguay
Racing CM,7,3,1,3,9,8,1,10,uruguay
La Luz,6,2,2,2,6,7,-1,8,uruguay
Liverpool M.,8,1,4,3,9,11,-2,7,uruguay
Boston River,8,1,3,4,9,12,-3,6,uruguay
Cerro,8,1,3,4,8,12,-4,6,uruguay
Fenix,8,2,0,6,8,17,-9,6,uruguay
River Plate,8,0,5,3,4,9,-5,5,uruguay
D. Maldonado,8,1,2,5,8,18,-10,5,uruguay
Plaza Colonia,7,1,2,4,4,16,-12,5,uruguay
Danubio,8,0,3,5,8,15,-7,3,uruguay
Cerro,3,2,1,0,3,1,2,7,uruguay2
River Plate,4,2,1,1,4,5,-1,7,uruguay2
Liverpool M.,3,2,0,1,4,2,2,6,uruguay2
Wanderers,3,2,0,1,4,4,0,6,uruguay2
Defensor S.,4,1,2,1,4,4,0,5,uruguay2
Fenix,4,1,2,1,4,4,0,5,uruguay2
Danubio,4,1,1,2,4,4,0,4,uruguay2
Montevideo City,4,1,1,2,4,5,-1,4,uruguay2
Boston River,3,1,0,2,3,5,-2,3,uruguay2
D. Maldonado,4,1,0,3,5,10,-5,3,uruguay2
Racing CM,4,1,0,3,4,9,-5,3,uruguay2
Cerro Largo,3,0,2,1,3,4,-1,2,uruguay2
Nacional,3,0,2,1,3,6,-3,2,uruguay2
Plaza Colonia,4,0,2,2,4,10,-6,2,uruguay2
Penarol,3,0,1,2,2,4,-2,1,uruguay2
La Luz,3,0,1,2,0,7,-7,1,uruguay2
Orlando City,8,5,1,2,10,9,1,16,usa
Seattle,8,4,3,1,11,8,3,15,usa
Cincinnati,8,4,3,1,13,12,1,15,usa
Real Salt Lake,8,4,2,2,12,9,3,14,usa
Vancouver,8,3,3,2,11,12,-1,12,usa
New York RB,8,3,1,4,11,14,-3,10,usa
Dallas,8,2,3,3,11,11,0,9,usa
Houston Dynamo,8,2,3,3,8,8,0,9,usa
Columbus Crew,8,2,3,3,15,16,-1,9,usa
Sporting KC,8,2,3,3,13,16,-3,9,usa
Atlanta Utd,8,2,3,3,11,14,-3,9,usa
Philadelphia,8,2,2,4,11,14,-3,8,usa
Minnesota Utd,8,2,2,4,13,19,-6,8,usa
Inter Miami,8,2,2,4,11,17,-6,8,usa
St. Louis City,8,2,2,4,8,14,-6,8,usa
Los Angeles FC,8,1,4,3,8,10,-2,7,usa
Charlotte,8,1,4,3,9,13,-4,7,usa
New York City,8,1,4,3,7,12,-5,7,usa
SJ Earthquakes,8,1,4,3,6,12,-6,7,usa
Portland,8,1,4,3,9,19,-10,7,usa
Chicago Fire,8,2,1,5,3,14,-11,7,usa
Austin,8,1,3,4,12,15,-3,6,usa
Nashville SC,8,1,3,4,5,11,-6,6,usa
LA Galaxy,8,1,3,4,15,22,-7,6,usa
DC United,8,1,2,5,4,15,-11,5,usa
CF Montreal,8,1,1,6,5,19,-14,4,usa
New England,8,0,3,5,11,16,-5,3,usa
Colorado Rapids,8,0,1,7,4,22,-18,1,usa
Toronto,8,0,0,8,1,22,-21,0,usa
Orange County,8,6,1,1,19,11,8,19,usa2
San Diego Loyal,8,5,1,2,15,7,8,16,usa2
Sacramento R.,8,5,1,2,12,9,3,16,usa2
Miami FC,8,5,0,3,11,6,5,15,usa2
Tampa Bay,8,4,2,2,14,10,4,14,usa2
Pittsburgh,8,4,2,2,10,8,2,14,usa2
Colorado S.,8,4,1,3,13,11,2,13,usa2
San Antonio,8,3,3,2,11,8,3,12,usa2
Indy Eleven,8,3,3,2,12,12,0,12,usa2
Charleston,8,3,3,2,10,10,0,12,usa2
Memphis,8,3,3,2,10,10,0,12,usa2
Oakland Roots,8,4,0,4,14,15,-1,12,usa2
FC Tulsa,8,3,1,4,12,13,-1,10,usa2
El Paso,8,3,1,4,5,15,-10,10,usa2
Louisville City,8,3,0,5,12,15,-3,9,usa2
Birmingham L.,8,3,0,5,8,14,-6,9,usa2
Phoenix Rising,8,2,2,4,7,12,-5,8,usa2
Monterey Bay,8,2,2,4,7,14,-7,8,usa2
Detroit City,8,2,1,5,9,17,-8,7,usa2
New Mexico,8,1,3,4,8,11,-3,6,usa2
Rio Grande,8,1,3,4,9,13,-4,6,usa2
Loudoun Utd,8,1,1,6,8,12,-4,4,usa2
Hartford A.,8,1,1,6,8,19,-11,4,usa2
Las Vegas L.,8,0,2,6,6,14,-8,2,usa2
North Carolina,8,6,1,1,19,9,10,19,usa3
Union Omaha,8,6,1,1,16,10,6,19,usa3
N. Colorado,8,4,2,2,13,11,2,14,usa3
Greenville,8,3,4,1,10,8,2,13,usa3
Tormenta,8,3,2,3,18,16,2,11,usa3
One Knoxville,8,3,2,3,9,9,0,11,usa3
Central Valley,8,2,1,5,16,20,-4,7,usa3
Chattanooga RW,8,2,1,5,12,17,-5,7,usa3
Lexington,8,1,3,4,12,16,-4,6,usa3
Charlotte,8,1,3,4,14,20,-6,6,usa3
Forward Madison,8,1,2,5,11,19,-8,5,usa3
Richmond K.,8,0,2,6,9,19,-10,2,usa3
Pakhtakor,8,5,2,1,11,6,5,17,uzbekistan
Termez Surkhon,8,4,4,0,10,5,5,16,uzbekistan
AMGK,8,4,3,1,9,7,2,15,uzbekistan
Nasaf Qarshi,8,3,3,2,9,7,2,12,uzbekistan
Navbahor,8,3,2,3,11,9,2,11,uzbekistan
Andijan,8,3,2,3,8,10,-2,11,uzbekistan
Bunyodkor,8,3,2,3,8,11,-3,11,uzbekistan
Neftchi,8,2,4,2,8,7,1,10,uzbekistan
Metallurg,8,3,1,4,9,9,0,10,uzbekistan
FK Olympic,8,3,0,5,7,9,-2,9,uzbekistan
Qizilqum,8,1,4,3,4,7,-3,7,uzbekistan
Sogdiana,8,1,3,4,10,14,-4,6,uzbekistan
Buxoro,8,1,1,6,3,11,-8,4,uzbekistan
Turan,8,1,1,6,5,17,-12,4,uzbekistan
D. Tachira,8,6,2,0,13,6,7,20,venezuela
Portuguesa,8,4,2,2,10,10,0,14,venezuela
Caracas,8,2,5,1,9,7,2,11,venezuela
Rayo Zuliano,8,3,2,3,11,11,0,11,venezuela
Carabobo,8,1,6,1,6,5,1,9,venezuela
Puerto Cabello,8,3,0,5,10,11,-1,9,venezuela
D. La Guaira,8,2,3,3,10,12,-2,9,venezuela
Metropolitanos,8,2,3,3,9,13,-4,9,venezuela
E. Merida,8,2,1,5,6,11,-5,7,venezuela
Zamora,8,2,1,5,8,18,-10,7,venezuela
H. Colmenares,8,1,3,4,8,11,-3,6,venezuela
UCV,8,0,4,4,2,7,-5,4,venezuela
Monagas,8,1,1,6,7,15,-8,4,venezuela
Angostura,8,1,1,6,6,16,-10,4,venezuela
M. de Guayana,8,1,1,6,6,21,-15,4,venezuela
Binh Duong,3,2,1,0,5,1,4,7,vietnam
Thanh Hoa,3,2,1,0,6,3,3,7,vietnam
Nam Dinh,2,2,0,0,7,4,3,6,vietnam
Cong An Nhan,3,1,1,1,6,5,1,4,vietnam
Hai Phong,3,1,1,1,6,5,1,4,vietnam
Binh Dinh,2,1,1,0,2,1,1,4,vietnam
Viettel,3,1,1,1,3,4,-1,4,vietnam
Ha Noi,2,1,0,1,1,2,-1,3,vietnam
S. Khanh Hoa,2,1,0,1,1,2,-1,3,vietnam
Quang Nam,2,0,1,1,5,6,-1,1,vietnam
Ho Chi Minh,2,0,1,1,2,3,-1,1,vietnam
Gia Lai,2,0,1,1,2,4,-2,1,vietnam
Hong Linh Ha T.,3,0,1,2,2,4,-2,1,vietnam
Song Lam Nghe,3,0,1,2,2,6,-4,1,vietnam
Da Nang,3,2,1,0,6,0,6,7,vietnam2
PVF-CAND,3,1,2,0,3,2,1,5,vietnam2
Hoa Binh,3,1,1,1,2,3,-1,4,vietnam2
Long An,3,1,0,2,5,4,1,3,vietnam2
Ba Ria Vung Tau,3,1,0,2,4,4,0,3,vietnam2
Hue,2,1,0,1,2,2,0,3,vietnam2
Binh Phuoc,3,0,2,1,4,5,-1,2,vietnam2
Phu Dong,3,0,2,1,1,3,-2,2,vietnam2
Phu Tho,2,0,1,1,0,3,-3,1,vietnam2
Binh Thuan,0,0,0,0,0,0,0,0,vietnam2
Dong Thap,2,0,0,2,0,3,-3,0,vietnam2
Dong Nai,3,0,0,3,0,8,-8,0,vietnam2
The New Saints,8,7,1,0,24,6,18,22,wales
Connah`s Quay,8,5,1,2,19,9,10,16,wales
Newtown,8,4,1,3,14,10,4,13,wales
Caernarfon Town,8,3,2,3,14,18,-4,11,wales
Bala Town,8,2,3,3,8,10,-2,9,wales
Cardiff MU,8,2,3,3,9,15,-6,9,wales
Haverfordwest,8,2,3,3,9,15,-6,9,wales
Aberystwyth,8,3,0,5,7,19,-12,9,wales
Penybont,8,2,2,4,13,15,-2,8,wales
Barry Town,8,2,1,5,7,17,-10,7,wales
Colwyn Bay,8,2,0,6,9,20,-11,6,wales
Pontypridd Town,8,1,2,5,2,12,-10,5,wales
