Equipe,GP,W,D,L,GF,GA,GD,Pts,albania2
AF Elbasani,6,4,2,0,12,6,6,14,albania2
Bylis,6,4,1,1,12,6,6,13,albania2
Korabi Peshkopi,6,3,3,0,9,3,6,12,albania2
Flamurtari,6,4,0,2,8,6,2,12,albania2
Vora,6,3,2,1,7,4,3,11,albania2
Luzi 2008,6,3,1,2,12,7,5,10,albania2
Apolonia Fier,6,2,2,2,8,6,2,8,albania2
Lushnja,6,2,1,3,7,11,-4,7,albania2
Kastrioti Kruje,6,1,2,3,6,9,-3,5,albania2
Burreli,6,1,2,3,3,9,-6,5,albania2
Besa Kavaje,6,0,2,4,2,7,-5,2,albania2
Tomori Berat,6,0,0,6,1,13,-12,0,albania2
MC Alger,6,5,1,0,16,3,13,16,algeria
CR Belouizdad,6,4,1,1,9,4,5,13,algeria
ES Setif,6,3,2,1,8,5,3,11,algeria
JS Saoura,6,3,2,1,6,7,-1,11,algeria
US Biskra,6,2,4,0,7,5,2,10,algeria
El Bayadh,6,2,3,1,7,4,3,9,algeria
CS Constantine,6,2,2,2,6,4,2,8,algeria
USM Alger,6,2,2,2,5,5,0,8,algeria
JS Kabylie,6,2,1,3,5,6,-1,7,algeria
Khenchela,6,2,1,3,4,7,-3,7,algeria
Paradou AC,6,1,3,2,5,4,1,6,algeria
Ben Aknoun,6,1,3,2,4,5,-1,6,algeria
ASO Chlef,6,1,2,3,7,8,-1,5,algeria
NC Magra,6,1,2,3,4,9,-5,5,algeria
MC Oran,6,1,0,5,3,8,-5,3,algeria
US Souf,6,0,0,6,5,15,-10,0,algeria
Oued Akbou,6,6,0,0,13,4,9,18,algeria2
Bordj Mena√Øel,6,5,1,0,12,5,7,16,algeria2
RC Kouba,6,5,0,1,7,3,4,15,algeria2
Temouchent,6,4,1,1,11,6,5,13,algeria2
GC Mascara,6,4,1,1,9,6,3,13,algeria2
CA Batna,6,3,3,0,7,1,6,12,algeria2
WA Mostaganem,6,3,2,1,10,5,5,11,algeria2
MSP Batna,6,3,2,1,10,6,4,11,algeria2
Mostaganem,6,2,4,0,6,0,6,10,algeria2
Khemis Melina,6,3,1,2,7,6,1,10,algeria2
MO Constantine,6,3,1,2,6,6,0,10,algeria2
Oued Magrane,6,3,0,3,6,5,1,9,algeria2
El Ghozlane,6,3,0,3,8,11,-3,9,algeria2
Khemis El K.,6,2,2,2,9,6,3,8,algeria2
Kolea,6,2,2,2,5,4,1,8,algeria2
ASM Oran,6,2,2,2,7,7,0,8,algeria2
Chelghoum,6,2,2,2,6,6,0,8,algeria2
RB Ouargla,6,2,2,2,3,3,0,8,algeria2
Khroub,6,2,1,3,8,9,-1,7,algeria2
Oued Sly,6,2,1,3,5,7,-2,7,algeria2
Hussein Dey,6,2,1,3,5,9,-4,7,algeria2
Teleghma,6,2,0,4,10,12,-2,6,algeria2
Tiaret,6,1,3,2,1,3,-2,6,algeria2
RC Arbaa,6,2,0,4,4,9,-5,6,algeria2
Olympique Medea,6,1,2,3,3,5,-2,5,algeria2
Mechria,6,1,2,3,5,8,-3,5,algeria2
El Harrach,6,1,1,4,6,10,-4,4,algeria2
Mlila,6,1,1,4,5,11,-6,4,algeria2
El Eulma,6,1,1,4,2,8,-6,4,algeria2
Inter Escaldes,6,6,0,0,23,1,22,18,andorra
UE Santa Coloma,6,5,0,1,16,5,11,15,andorra
FC Santa Coloma,6,5,0,1,15,6,9,15,andorra
A. Escaldes,6,4,1,1,14,5,9,13,andorra
Ordino,6,4,1,1,8,4,4,13,andorra
Penya Encarnada,6,2,1,3,7,7,0,7,andorra
Carroi,6,2,0,4,7,11,-4,6,andorra
Pas de la Casa,6,0,1,5,3,15,-12,1,andorra
Esperanca,6,0,0,6,1,19,-18,0,andorra
A. America,6,0,0,6,3,24,-21,0,andorra
Boca Juniors,6,5,1,0,10,2,8,16,argentina
A. Tucuman,6,5,1,0,7,0,7,16,argentina
Banfield,6,3,3,0,7,3,4,12,argentina
River Plate,6,3,2,1,11,7,4,11,argentina
Defensa y J.,6,3,2,1,10,7,3,11,argentina
Barracas C.,6,3,2,1,5,3,2,11,argentina
T. de Cordoba,6,2,4,0,6,4,2,10,argentina
Instituto,6,3,1,2,7,6,1,10,argentina
Racing Club,6,2,3,1,10,5,5,9,argentina
Estudiantes,6,2,3,1,9,6,3,9,argentina
Tigre,6,3,0,3,7,5,2,9,argentina
Godoy Cruz,6,2,3,1,10,9,1,9,argentina
Velez Sarsfield,6,2,3,1,4,3,1,9,argentina
Lanus,6,2,2,2,8,7,1,8,argentina
Argentinos Jrs,6,2,2,2,5,4,1,8,argentina
San Lorenzo,6,2,2,2,3,5,-2,8,argentina
Rosario Central,6,1,4,1,6,5,1,7,argentina
Union Santa Fe,6,1,4,1,2,1,1,7,argentina
Independiente,6,2,1,3,3,6,-3,7,argentina
Newells,6,1,3,2,6,7,-1,6,argentina
Huracan,6,2,0,4,2,4,-2,6,argentina
Arsenal Sarandi,6,1,2,3,3,5,-2,5,argentina
Platense,6,1,2,3,3,5,-2,5,argentina
Gimnasia,6,0,4,2,7,11,-4,4,argentina
Central Cordoba,6,1,1,4,4,9,-5,4,argentina
Sarmiento,6,0,2,4,1,8,-7,2,argentina
Belgrano,6,0,2,4,0,8,-8,2,argentina
Colon Santa Fe,6,0,1,5,1,12,-11,1,argentina
Atletico Mitre,6,5,1,0,12,3,9,16,argentina3
CA Guemes,6,5,1,0,9,2,7,16,argentina3
Racing Cordoba,6,4,1,1,10,6,4,13,argentina3
Chaco For Ever,6,4,1,1,8,7,1,13,argentina3
Agropecuario,6,3,3,0,9,3,6,12,argentina3
E. Rio Cuarto,6,4,0,2,8,5,3,12,argentina3
I. Rivadavia,6,3,3,0,5,2,3,12,argentina3
D. Riestra,6,3,2,1,6,2,4,11,argentina3
Quilmes,6,3,1,2,14,8,6,10,argentina3
Gimnasia Jujuy,6,3,1,2,7,5,2,10,argentina3
SM Tucuman,6,2,3,1,9,4,5,9,argentina3
Chacarita J.,6,2,3,1,9,8,1,9,argentina3
Ferro Carril,6,2,3,1,8,7,1,9,argentina3
San Telmo,6,3,0,3,8,8,0,9,argentina3
Guillermo Brown,6,3,0,3,6,9,-3,9,argentina3
SM San Juan,6,2,2,2,9,7,2,8,argentina3
G. Mendoza,6,2,2,2,12,11,1,8,argentina3
Deportivo Maipu,6,2,2,2,6,6,0,8,argentina3
Nueva Chicago,6,2,2,2,5,5,0,8,argentina3
Almirante Brown,6,2,2,2,4,4,0,8,argentina3
Temperley,6,2,2,2,7,8,-1,8,argentina3
Flandria,6,2,2,2,5,7,-2,8,argentina3
D. Madryn,6,1,4,1,5,3,2,7,argentina3
A. Rafaela,6,2,1,3,10,9,1,7,argentina3
Alvarado,6,2,1,3,8,9,-1,7,argentina3
Tristan Suarez,6,2,1,3,7,9,-2,7,argentina3
Defensores U.,6,2,1,3,7,10,-3,7,argentina3
D. de Belgrano,6,2,0,4,6,8,-2,6,argentina3
Brown de A.,6,2,0,4,6,10,-4,6,argentina3
Noah,6,5,0,1,14,5,9,15,armenia
Ararat-Armenia,6,4,1,1,11,4,7,13,armenia
Pyunik,6,3,3,0,17,6,11,12,armenia
West Armenia,6,3,1,2,8,12,-4,10,armenia
Alashkert,6,1,4,1,4,4,0,7,armenia
Urartu,6,2,1,3,7,10,-3,7,armenia
Van,6,2,1,3,12,19,-7,7,armenia
BKMA,6,2,0,4,11,12,-1,6,armenia
Ararat Yerevan,6,1,1,4,5,9,-4,4,armenia
Shirak,6,0,2,4,3,11,-8,2,armenia
Central Coast,6,4,2,0,19,8,11,14,australia
Melbourne V.,6,3,3,0,12,6,6,12,australia
Melbourne City,6,3,2,1,15,6,9,11,australia
Western Sydney,6,3,1,2,10,9,1,10,australia
Wellington,6,3,1,2,9,8,1,10,australia
Sydney FC,6,3,0,3,10,11,-1,9,australia
Newcastle Jets,6,2,2,2,9,8,1,8,australia
Macarthur FC,6,2,1,3,10,13,-3,7,australia
Brisbane Roar,6,2,1,3,8,16,-8,7,australia
Perth Glory,6,1,1,4,11,15,-4,4,australia
Adelaide Utd,6,1,1,4,8,12,-4,4,australia
Western United,6,1,0,5,5,15,-10,3,australia
Salzburg,6,5,1,0,10,2,8,16,austria
Hartberg,6,4,1,1,13,6,7,13,austria
LASK Linz,6,3,2,1,10,7,3,11,austria
Sturm Graz,6,3,1,2,8,5,3,10,austria
Rapid Wien,6,3,1,2,8,6,2,10,austria
Wolfsberger AC,6,3,0,3,8,7,1,9,austria
Austria Wien,6,2,3,1,4,3,1,9,austria
A. Klagenfurt,6,2,2,2,5,10,-5,8,austria
BW Linz,6,2,1,3,8,7,1,7,austria
Tirol,6,2,0,4,8,8,0,6,austria
Altach,6,1,0,5,4,12,-8,3,austria
A. Lustenau,6,0,0,6,3,16,-13,0,austria
Ried,6,5,1,0,20,4,16,16,austria2
Leoben,6,4,2,0,14,4,10,14,austria2
Grazer AK,6,4,1,1,10,6,4,13,austria2
Floridsdorfer,6,3,2,1,9,5,4,11,austria2
First Vienna,6,3,2,1,10,8,2,11,austria2
St. Polten,6,3,1,2,10,8,2,10,austria2
SV Horn,6,3,0,3,8,8,0,9,austria2
Bregenz,6,2,2,2,9,7,2,8,austria2
Kapfenberger,6,2,2,2,9,10,-1,8,austria2
Admira Wacker,6,2,1,3,9,8,1,7,austria2
Stripfing,6,2,1,3,6,11,-5,7,austria2
Liefering,6,1,3,2,10,8,2,6,austria2
Lafnitz,6,2,0,4,10,19,-9,6,austria2
Amstetten,6,0,3,3,7,12,-5,3,austria2
Sturm Graz B,6,0,1,5,5,18,-13,1,austria2
Dornbirn,6,0,0,6,5,18,-13,0,austria2
Qarabag,6,6,0,0,17,3,14,18,azerbaijan
Neftci,6,3,1,2,8,7,1,10,azerbaijan
Sabah,6,3,0,3,10,7,3,9,azerbaijan
Sumqayit,6,2,3,1,7,10,-3,9,azerbaijan
Kapaz,6,2,2,2,5,5,0,8,azerbaijan
Turan,6,2,1,3,10,13,-3,7,azerbaijan
Araz,6,1,3,2,5,6,-1,6,azerbaijan
Qabala,6,2,0,4,5,10,-5,6,azerbaijan
Zira,6,1,2,3,1,3,-2,5,azerbaijan
Sebail,6,1,2,3,5,9,-4,5,azerbaijan
Bashundhara K.,2,2,0,0,9,3,6,6,bangladesh
Mohammedan,2,1,1,0,3,2,1,4,bangladesh
Sheikh Russel,2,1,1,0,3,2,1,4,bangladesh
B. Police,2,1,0,1,2,1,1,3,bangladesh
Fortis,2,1,0,1,2,2,0,3,bangladesh
Sheikh Jamal,2,1,0,1,2,2,0,3,bangladesh
Rahmatgonj,2,0,2,0,3,3,0,2,bangladesh
Abahani,2,0,1,1,1,2,-1,1,bangladesh
Brothers Union,2,0,1,1,4,7,-3,1,bangladesh
Chittagong,2,0,0,2,1,6,-5,0,bangladesh
Dinamo Minsk,6,5,0,1,16,2,14,15,belarus
Isloch,6,4,1,1,13,6,7,13,belarus
BATE Borisov,6,4,0,2,16,10,6,12,belarus
Neman Grodno,6,3,2,1,13,5,8,11,belarus
T. Zhodino,6,3,2,1,5,3,2,11,belarus
FC Minsk,6,3,1,2,6,5,1,10,belarus
Energetik-BGU,6,3,0,3,11,10,1,9,belarus
Slutsk,6,3,0,3,13,14,-1,9,belarus
Dinamo Brest,6,3,0,3,10,11,-1,9,belarus
Gomel,6,2,2,2,9,7,2,8,belarus
Smorgon,6,2,1,3,7,15,-8,7,belarus
S. Soligorsk,6,2,0,4,10,8,2,6,belarus
Slavia Mozyr,6,1,2,3,4,9,-5,5,belarus
Naftan,6,1,1,4,6,22,-16,4,belarus
Belshina,6,0,0,6,4,16,-12,0,belarus
Dnepr Mogilev,6,5,1,0,12,1,11,16,belarus2
Vitebsk,6,5,1,0,13,3,10,16,belarus2
Zhodino Yuzhnoe,6,5,0,1,22,7,15,15,belarus2
Arsenal D.,6,5,0,1,22,8,14,15,belarus2
Maxline,6,5,0,1,19,8,11,15,belarus2
Bumprom,6,4,1,1,12,7,5,13,belarus2
Lida,6,3,1,2,14,10,4,10,belarus2
Niva,6,3,1,2,14,13,1,10,belarus2
Lokomotiv Gomel,6,2,2,2,5,9,-4,8,belarus2
Baranovichi,6,2,1,3,10,10,0,7,belarus2
Volna Pinsk,6,2,1,3,7,12,-5,7,belarus2
S.Petrikov,6,2,0,4,8,13,-5,6,belarus2
Orsha,6,1,1,4,10,14,-4,4,belarus2
FC Ostrovets,6,0,2,4,4,14,-10,2,belarus2
Slonim,6,0,1,5,3,17,-14,1,belarus2
Molodechno-DYuS,6,0,1,5,4,19,-15,1,belarus2
Osipovichy,6,0,0,6,2,14,-12,0,belarus2
Club Brugge,6,4,2,0,12,2,10,14,belgium
Anderlecht,6,4,2,0,12,6,6,14,belgium
Royale Union SG,6,4,2,0,10,5,5,14,belgium
Gent,6,3,2,1,13,5,8,11,belgium
KRC Genk,6,3,1,2,13,6,7,10,belgium
Westerlo,6,3,1,2,12,9,3,10,belgium
Cercle Brugge,6,3,0,3,9,8,1,9,belgium
Antwerp,6,2,3,1,8,8,0,9,belgium
Sint-Truiden,6,2,3,1,6,6,0,9,belgium
Charleroi,6,2,2,2,7,7,0,8,belgium
KV Mechelen,6,2,1,3,7,6,1,7,belgium
Standard Liege,6,1,3,2,4,8,-4,6,belgium
OH Leuven,6,1,1,4,5,9,-4,4,belgium
RWDM,6,1,1,4,5,15,-10,4,belgium
Eupen,6,0,1,5,3,13,-10,1,belgium
Kortrijk,6,0,1,5,2,15,-13,1,belgium
Always Ready,6,3,2,1,12,6,6,11,bolivia
Bolivar,6,3,1,2,22,12,10,10,bolivia
Nacional Potosi,6,3,1,2,17,9,8,10,bolivia
Guabira,6,3,1,2,12,4,8,10,bolivia
Aurora,6,3,1,2,9,7,2,10,bolivia
Real Tomayapo,6,3,1,2,8,8,0,10,bolivia
The Strongest,6,2,3,1,14,8,6,9,bolivia
Blooming,6,3,0,3,8,7,1,9,bolivia
Wilstermann,6,2,3,1,6,5,1,9,bolivia
Oriente P.,6,3,0,3,8,9,-1,9,bolivia
Royal Pari,6,2,2,2,6,11,-5,8,bolivia
U. de Vinto,6,1,4,1,5,5,0,7,bolivia
Libertad,6,2,1,3,6,14,-8,7,bolivia
I. Petrolero,6,2,0,4,6,12,-6,6,bolivia
Santa Cruz,6,1,2,3,4,11,-7,5,bolivia
Vaca Diez,6,1,1,4,7,14,-7,4,bolivia
A. Palmaflor,6,1,1,4,5,17,-12,4,bolivia
Nacional Potosi,6,4,0,2,15,9,6,12,bolivia2
Always Ready,6,4,0,2,10,6,4,12,bolivia2
The Strongest,6,3,2,1,14,9,5,11,bolivia2
Oriente P.,6,3,2,1,12,9,3,11,bolivia2
Guabira,6,3,1,2,9,9,0,10,bolivia2
Santa Cruz,6,3,1,2,9,11,-2,10,bolivia2
I. Petrolero,6,2,3,1,9,7,2,9,bolivia2
Royal Pari,6,2,2,2,7,6,1,8,bolivia2
U. de Vinto,6,2,2,2,6,5,1,8,bolivia2
Bolivar,6,1,4,1,10,9,1,7,bolivia2
Blooming,6,1,3,2,2,3,-1,6,bolivia2
Real Tomayapo,6,1,3,2,4,7,-3,6,bolivia2
Wilstermann,6,1,2,3,5,8,-3,5,bolivia2
Aurora,6,0,4,2,3,6,-3,4,bolivia2
U. Sucre,6,1,1,4,7,12,-5,4,bolivia2
A. Palmaflor,6,0,4,2,5,11,-6,4,bolivia2
Atletico MG,6,4,1,1,12,7,5,13,brazil
Internacional,6,4,1,1,8,5,3,13,brazil
Gremio,6,4,0,2,10,10,0,12,brazil
Palmeiras,6,3,2,1,11,6,5,11,brazil
Fortaleza,6,3,2,1,9,7,2,11,brazil
Cuiaba,6,3,1,2,9,5,4,10,brazil
Fluminense,6,3,1,2,9,6,3,10,brazil
Cruzeiro,6,2,4,0,6,4,2,10,brazil
Flamengo,6,3,1,2,7,6,1,10,brazil
Corinthians,6,3,1,2,10,10,0,10,brazil
Sao Paulo,6,2,2,2,3,3,0,8,brazil
Vasco da Gama,6,2,2,2,8,9,-1,8,brazil
Bahia,6,2,1,3,12,10,2,7,brazil
Athletico PR,6,1,4,1,6,6,0,7,brazil
Coritiba,6,2,1,3,6,6,0,7,brazil
Botafogo,6,0,5,1,7,9,-2,5,brazil
Santos,6,1,2,3,3,9,-6,5,brazil
Bragantino,6,1,1,4,5,8,-3,4,brazil
Goias,6,1,0,5,3,7,-4,3,brazil
America MG,6,1,0,5,4,15,-11,3,brazil
Cherno More,6,5,1,0,12,5,7,16,bulgaria
Ludogorets,6,5,0,1,15,3,12,15,bulgaria
Botev Plovdiv,6,4,2,0,13,2,11,14,bulgaria
CSKA Sofia,6,4,1,1,11,3,8,13,bulgaria
CSKA 1948 Sofia,6,4,0,2,9,6,3,12,bulgaria
Slavia Sofia,6,3,1,2,6,8,-2,10,bulgaria
Levski Sofia,6,2,3,1,7,4,3,9,bulgaria
Beroe,6,2,2,2,4,4,0,8,bulgaria
Lok. Plovdiv,6,2,2,2,6,7,-1,8,bulgaria
L. Krumovgrad,6,2,0,4,7,10,-3,6,bulgaria
Arda,6,2,0,4,2,7,-5,6,bulgaria
Pirin Blag.,6,1,2,3,5,10,-5,5,bulgaria
Lokomotiv Sofia,6,1,2,3,6,12,-6,5,bulgaria
Botev Vratsa,6,1,0,5,3,11,-8,3,bulgaria
Hebar,6,0,1,5,4,13,-9,1,bulgaria
Etar,6,0,1,5,1,10,-9,1,bulgaria
Cavalry,6,4,0,2,10,6,4,12,canada
Forge,6,4,0,2,11,8,3,12,canada
Vancouver FC,6,4,0,2,9,7,2,12,canada
HFX Wanderers,6,3,0,3,8,8,0,9,canada
York Utd,6,3,0,3,7,10,-3,9,canada
Valour,6,2,0,4,7,8,-1,6,canada
Pacific,6,2,0,4,8,11,-3,6,canada
A. Ottawa,6,1,1,4,5,8,-3,4,canada
Huachipato,6,4,2,0,10,4,6,14,chile
Coquimbo Unido,6,4,0,2,11,9,2,12,chile
Colo-Colo,6,4,0,2,6,4,2,12,chile
Palestino,6,3,1,2,8,5,3,10,chile
Everton,6,3,1,2,9,7,2,10,chile
Cobresal,6,3,1,2,11,10,1,10,chile
U. de Chile,6,3,0,3,13,10,3,9,chile
Union La Calera,6,3,0,3,9,10,-1,9,chile
U. Catolica,6,2,2,2,11,8,3,8,chile
Copiapo,6,2,2,2,7,6,1,8,chile
Union Espanola,6,2,2,2,9,12,-3,8,chile
Magallanes,6,2,1,3,11,11,0,7,chile
Audax Italiano,6,2,0,4,5,10,-5,6,chile
Nublense,6,1,2,3,6,8,-2,5,chile
O`Higgins,6,1,2,3,5,8,-3,5,chile
Curico Unido,6,0,2,4,7,14,-7,2,chile
Cobreloa,6,5,0,1,9,4,5,15,chile2
S. Wanderers,6,4,1,1,9,4,5,13,chile2
Barnechea,6,3,2,1,14,10,4,11,chile2
Deportes Temuco,6,3,2,1,8,6,2,11,chile2
S. Morning,6,3,1,2,9,6,3,10,chile2
D. Iquique,6,2,3,1,9,8,1,9,chile2
San Marcos,6,2,2,2,13,13,0,8,chile2
Rangers,6,2,2,2,5,6,-1,8,chile2
U. Concepcion,6,2,2,2,8,10,-2,8,chile2
Recoleta,6,2,1,3,7,8,-1,7,chile2
La Serena,6,2,1,3,6,10,-4,7,chile2
San Luis,6,1,3,2,10,7,3,6,chile2
Puerto Montt,6,1,3,2,6,10,-4,6,chile2
Antofagasta,6,1,1,4,7,11,-4,4,chile2
CD Santa Cruz,6,1,1,4,6,10,-4,4,chile2
U. San Felipe,6,0,2,4,1,6,-5,2,chile2
Zhejiang,6,5,1,0,18,3,15,16,china
Chengdu,6,5,1,0,16,5,11,16,china
S. Taishan,6,4,2,0,15,5,10,14,china
Tianjin T.,6,4,2,0,11,5,6,14,china
Wuhan Three T.,6,4,0,2,11,7,4,12,china
Beijing Guoan,6,3,1,2,10,6,4,10,china
Shanghai Port,6,3,1,2,9,7,2,10,china
S. Shenhua,6,3,1,2,6,6,0,10,china
Henan SL,6,2,2,2,11,9,2,8,china
Meizhou Hakka,6,2,2,2,7,9,-2,8,china
Qingdao Jonoon,6,1,2,3,8,12,-4,5,china
Changchun Yatai,6,1,2,3,6,11,-5,5,china
Nantong Zhiyun,6,1,0,5,6,9,-3,3,china
Dalian P.,6,0,2,4,5,11,-6,2,china
Cangzhou,6,0,1,5,1,17,-16,1,china
Shenzhen,6,0,0,6,1,19,-18,0,china
Sichuan Jiuniu,6,6,0,0,14,0,14,18,china2
Wuxi Wugou,6,4,1,1,10,8,2,13,china2
Hebei Kungfu,6,3,3,0,9,4,5,12,china2
Qingdao Y. I.,6,3,2,1,7,3,4,11,china2
Guangxi Baoyun,6,3,2,1,9,7,2,11,china2
Dongguan United,6,3,0,3,5,7,-2,9,china2
Shenyang Urban,6,2,2,2,8,6,2,8,china2
Yanbian Longdin,6,2,2,2,7,6,1,8,china2
Dantong Hantong,6,2,2,2,5,7,-2,8,china2
Shanghai Jiadin,6,2,2,2,5,7,-2,8,china2
Jiangxi L.,6,2,1,3,9,9,0,7,china2
Jinan Xingzhou,6,1,3,2,4,6,-2,6,china2
Nanjing,6,1,2,3,1,5,-4,5,china2
Heilongjiang L.,6,1,1,4,4,8,-4,4,china2
Guangzhou FC,6,1,0,5,4,9,-5,3,china2
Suzhou Dongwu,6,0,1,5,2,11,-9,1,china2
Deportes Tolima,6,5,0,1,8,5,3,15,colombia2
R. Aguilas,6,4,2,0,13,2,11,14,colombia2
I. Medelin,6,4,2,0,11,3,8,14,colombia2
Junior,6,4,1,1,8,3,5,13,colombia2
America de Cali,6,3,2,1,8,5,3,11,colombia2
La Equidad,6,3,2,1,8,6,2,11,colombia2
A. Bucaramanga,6,3,1,2,8,7,1,10,colombia2
A. Nacional,6,3,0,3,12,8,4,9,colombia2
Deportivo Cali,6,2,2,2,7,7,0,8,colombia2
Millonarios,6,2,2,2,7,7,0,8,colombia2
D. Pereira,6,2,1,3,5,7,-2,7,colombia2
Once Caldas,6,1,3,2,5,6,-1,6,colombia2
A. Petrolera,6,2,0,4,3,8,-5,6,colombia2
Envigado,6,1,2,3,10,13,-3,5,colombia2
Deportivo Pasto,6,1,2,3,4,7,-3,5,colombia2
Jaguares de C.,6,1,2,3,1,4,-3,5,colombia2
Boyaca Chico,6,1,2,3,5,9,-4,5,colombia2
Union Magdalena,6,1,1,4,6,13,-7,4,colombia2
Atletico Huila,6,0,3,3,6,11,-5,3,colombia2
Santa Fe,6,0,2,4,5,13,-8,2,colombia2
Saprissa,6,6,0,0,13,4,9,18,costarica
San Carlos,6,5,0,1,9,4,5,15,costarica
Herediano,6,4,1,1,9,2,7,13,costarica
Guanacasteca,6,3,2,1,9,6,3,11,costarica
Alajuelense,6,3,1,2,9,7,2,10,costarica
AD Grecia,6,2,2,2,5,5,0,8,costarica
Sporting SJ,6,2,1,3,7,10,-3,7,costarica
Cartagines,6,1,2,3,5,7,-2,5,costarica
Puntarenas,6,1,1,4,8,8,0,4,costarica
M. Liberia,6,1,1,4,7,11,-4,4,costarica
Zeledon,6,1,1,4,1,11,-10,4,costarica
Santos DG,6,1,0,5,2,9,-7,3,costarica
Sparta Prague,6,6,0,0,12,2,10,18,czechrepublic
Slavia Prague,6,5,0,1,13,6,7,15,czechrepublic
Slovacko,6,4,2,0,13,4,9,14,czechrepublic
Viktoria Plzen,6,4,1,1,15,8,7,13,czechrepublic
Slovan Liberec,6,3,2,1,9,7,2,11,czechrepublic
Jablonec,6,2,3,1,7,8,-1,9,czechrepublic
Zlin,6,2,2,2,9,8,1,8,czechrepublic
Teplice,6,2,1,3,6,7,-1,7,czechrepublic
Pardubice,6,2,0,4,5,6,-1,6,czechrepublic
Banik Ostrava,6,2,0,4,8,10,-2,6,czechrepublic
Sigma Olomouc,6,1,3,2,6,8,-2,6,czechrepublic
Hradec Kralove,6,1,3,2,6,9,-3,6,czechrepublic
Bohemians,6,1,3,2,4,8,-4,6,czechrepublic
Karvina,6,1,2,3,4,8,-4,5,czechrepublic
Mlada Boleslav,6,1,1,4,5,10,-5,4,czechrepublic
C. Budejovice,6,0,1,5,1,11,-10,1,czechrepublic
FC Midtjylland,6,6,0,0,19,5,14,18,denmark
AGF Aarhus,6,4,2,0,9,3,6,14,denmark
Brondby IF,6,2,4,0,12,7,5,10,denmark
FC Kobenhavn,6,3,1,2,12,7,5,10,denmark
Nordsjaelland,6,2,2,2,5,5,0,8,denmark
Viborg,6,2,1,3,6,12,-6,7,denmark
Vejle BK,6,1,3,2,4,5,-1,6,denmark
Odense BK,6,1,3,2,5,7,-2,6,denmark
Lyngby,6,1,2,3,8,10,-2,5,denmark
Silkeborg,6,1,2,3,5,10,-5,5,denmark
Hvidovre,6,1,1,4,5,15,-10,4,denmark
Randers FC,6,0,3,3,6,10,-4,3,denmark
SonderjyskE,6,5,0,1,17,4,13,15,denmark2
Vendsyssel,6,4,2,0,7,2,5,14,denmark2
Hobro,6,4,1,1,6,3,3,13,denmark2
Hillerod,6,3,2,1,8,5,3,11,denmark2
Aalborg BK,6,3,2,1,9,7,2,11,denmark2
B 93,6,3,0,3,8,7,1,9,denmark2
AC Horsens,6,2,1,3,9,9,0,7,denmark2
Fredericia,6,1,4,1,6,9,-3,7,denmark2
Helsingor,6,0,3,3,8,12,-4,3,denmark2
Naestved,6,0,3,3,7,12,-5,3,denmark2
Kolding IF,6,1,0,5,3,9,-6,3,denmark2
HB Koge,6,1,0,5,7,16,-9,3,denmark2
Cuniburo,6,5,1,0,17,8,9,16,ecuador3
America de Q.,6,4,2,0,13,5,8,14,ecuador3
I. Juniors,6,3,1,2,11,8,3,10,ecuador3
Chacaritas,6,3,0,3,9,7,2,9,ecuador3
Imbabura,6,2,3,1,9,7,2,9,ecuador3
Nueve Octubre,6,2,1,3,7,7,0,7,ecuador3
Manta,6,2,1,3,7,10,-3,7,ecuador3
Macara,6,2,0,4,7,12,-5,6,ecuador3
Vargas Torres,6,1,2,3,5,10,-5,5,ecuador3
Guayaquil,6,0,1,5,3,14,-11,1,ecuador3
Al Ahly,6,4,2,0,12,4,8,14,egypt
Al Ittihad,6,4,2,0,10,5,5,14,egypt
Pyramids FC,6,4,1,1,9,7,2,13,egypt
ENPPI,6,4,0,2,10,7,3,12,egypt
El Gouna,6,3,2,1,9,6,3,11,egypt
ZED FC,6,3,2,1,8,5,3,11,egypt
Ceramica C.,6,3,1,2,9,6,3,10,egypt
El Geish,6,3,1,2,8,6,2,10,egypt
Al Masry,6,3,1,2,7,9,-2,10,egypt
National Bank,6,3,0,3,12,7,5,9,egypt
Zamalek,6,3,0,3,11,7,4,9,egypt
Smouha,6,2,3,1,4,3,1,9,egypt
Future FC,6,2,1,3,5,6,-1,7,egypt
Ismaily,6,1,2,3,6,8,-2,5,egypt
Al Mokawloon,6,1,2,3,7,10,-3,5,egypt
Baladiyyat,6,1,2,3,5,11,-6,5,egypt
El Daklyeh,6,0,3,3,1,6,-5,3,egypt
Pharco,6,0,1,5,6,12,-6,1,egypt
Liverpool,6,4,2,0,11,4,7,14,england
Bournemouth,6,4,1,1,14,7,7,13,england
Wolverhampton,6,4,1,1,11,6,5,13,england
Aston Villa,6,4,1,1,10,7,3,13,england
West Ham Utd,6,4,1,1,9,6,3,13,england
Tottenham,6,4,0,2,14,9,5,12,england
Manchester City,6,3,2,1,12,8,4,11,england
Fulham,6,3,0,3,12,9,3,9,england
Everton,6,3,0,3,9,8,1,9,england
Brighton,6,2,3,1,8,7,1,9,england
Chelsea,6,3,0,3,9,9,0,9,england
Arsenal,6,2,1,3,8,9,-1,7,england
Manchester Utd,6,2,1,3,6,10,-4,7,england
Nottm Forest,6,2,1,3,8,13,-5,7,england
Luton Town,6,2,0,4,11,14,-3,6,england
Crystal Palace,6,1,2,3,8,10,-2,5,england
Burnley,6,1,1,4,5,9,-4,4,england
Sheffield Utd,6,1,1,4,4,10,-6,4,england
Brentford,6,1,0,5,7,13,-6,3,england
Newcastle Utd,6,1,0,5,7,15,-8,3,england
Leicester City,6,5,1,0,16,6,10,16,england2
Southampton,6,4,2,0,14,3,11,14,england2
Coventry City,6,3,3,0,12,5,7,12,england2
Millwall,6,3,2,1,7,4,3,11,england2
Bristol City,6,3,1,2,9,6,3,10,england2
West Brom,6,3,1,2,5,3,2,10,england2
Sunderland,6,3,1,2,5,5,0,10,england2
Hull City,6,3,0,3,11,10,1,9,england2
Sheffield Wed,6,3,0,3,8,9,-1,9,england2
Middlesbrough,6,3,0,3,7,8,-1,9,england2
Norwich City,6,2,2,2,8,6,2,8,england2
Stoke City,6,1,5,0,6,4,2,8,england2
Watford,6,2,2,2,13,12,1,8,england2
Swansea City,6,2,2,2,7,11,-4,8,england2
Leeds Utd,6,2,1,3,9,5,4,7,england2
Plymouth,6,1,4,1,12,12,0,7,england2
Ipswich Town,6,1,4,1,5,8,-3,7,england2
Cardiff City,6,2,1,3,6,10,-4,7,england2
Preston,6,2,0,4,7,12,-5,6,england2
Birmingham City,6,1,2,3,7,12,-5,5,england2
Rotherham,6,1,2,3,6,11,-5,5,england2
Huddersfield,6,1,1,4,7,12,-5,4,england2
Blackburn,6,1,1,4,7,15,-8,4,england2
QP Rangers,6,0,2,4,2,7,-5,2,england2
Peterborough,6,4,2,0,13,7,6,14,england3
Derby County,6,4,1,1,13,7,6,13,england3
Northampton,6,4,1,1,10,7,3,13,england3
Barnsley,6,3,3,0,12,8,4,12,england3
Bolton,6,4,0,2,8,6,2,12,england3
Portsmouth,6,3,2,1,9,4,5,11,england3
Oxford Utd,6,3,1,2,11,8,3,10,england3
Port Vale,6,3,1,2,11,8,3,10,england3
Reading,6,2,4,0,11,8,3,10,england3
Bristol Rovers,6,3,1,2,10,10,0,10,england3
Leyton Orient,6,3,1,2,7,7,0,10,england3
Blackpool,6,3,0,3,9,7,2,9,england3
Stevenage,6,2,2,2,10,8,2,8,england3
Cheltenham,6,2,2,2,7,6,1,8,england3
Cambridge Utd,6,2,1,3,7,10,-3,7,england3
Burton Albion,6,2,1,3,4,7,-3,7,england3
Wycombe,6,1,3,2,5,6,-1,6,england3
Shrewsbury,6,2,0,4,5,9,-4,6,england3
Wigan Athletic,6,1,2,3,5,7,-2,5,england3
Exeter City,6,1,2,3,4,7,-3,5,england3
Carlisle Utd,6,1,2,3,5,10,-5,5,england3
Charlton,6,0,3,3,6,9,-3,3,england3
Lincoln City,6,0,2,4,3,9,-6,2,england3
Fleetwood,6,0,2,4,3,11,-8,2,england3
Walsall,6,5,0,1,15,5,10,15,england4
Tranmere,6,5,0,1,15,6,9,15,england4
Mansfield,6,4,2,0,12,4,8,14,england4
Wrexham,6,4,1,1,12,7,5,13,england4
Milton Keynes,6,4,1,1,9,5,4,13,england4
AFC Wimbledon,6,3,2,1,12,6,6,11,england4
Bradford,6,3,2,1,10,4,6,11,england4
Barrow,6,3,2,1,12,8,4,11,england4
Harrogate,6,3,2,1,11,9,2,11,england4
Gillingham,6,3,1,2,3,4,-1,10,england4
Stockport,6,2,3,1,13,6,7,9,england4
Accrington,6,2,3,1,10,7,3,9,england4
Crawley Town,6,3,0,3,9,9,0,9,england4
Grimsby,6,2,1,3,8,12,-4,7,england4
Notts County,6,2,0,4,13,11,2,6,england4
Newport,6,1,3,2,8,9,-1,6,england4
Morecambe,6,1,3,2,11,13,-2,6,england4
Crewe Alexandra,6,1,2,3,7,11,-4,5,england4
Doncaster,6,1,2,3,5,12,-7,5,england4
Sutton Utd,6,1,2,3,3,13,-10,5,england4
Colchester Utd,6,1,0,5,7,12,-5,3,england4
Swindon Town,6,1,0,5,4,14,-10,3,england4
Forest Green,6,0,2,4,4,12,-8,2,england4
Salford City,6,0,2,4,2,13,-11,2,england4
Bromley,6,5,1,0,17,7,10,16,england5
Chesterfield,6,5,0,1,13,7,6,15,england5
Wealdstone,6,4,1,1,14,9,5,13,england5
Oldham,6,4,0,2,14,10,4,12,england5
Barnet,6,3,1,2,13,8,5,10,england5
York City,6,2,4,0,7,3,4,10,england5
Eastleigh,6,3,1,2,16,16,0,10,england5
Aldershot Town,6,3,1,2,11,13,-2,10,england5
Boreham Wood,6,3,1,2,10,13,-3,10,england5
Halifax Town,6,2,3,1,8,6,2,9,england5
Maidenhead Utd,6,2,3,1,7,5,2,9,england5
Altrincham,6,2,2,2,11,9,2,8,england5
Dagenham & R.,6,2,2,2,11,10,1,8,england5
Rochdale,6,2,2,2,6,6,0,8,england5
Gateshead FC,6,2,2,2,6,8,-2,8,england5
Dorking,6,2,1,3,9,11,-2,7,england5
Southend Utd,6,2,1,3,6,8,-2,7,england5
AFC Fylde,6,1,3,2,9,10,-1,6,england5
Solihull Moors,6,2,0,4,10,15,-5,6,england5
Kidderminster,6,1,2,3,7,8,-1,5,england5
Ebbsfleet Utd,6,1,2,3,9,13,-4,5,england5
Woking,6,1,2,3,6,10,-4,5,england5
Oxford City,6,1,1,4,8,12,-4,4,england5
Hartlepool,6,0,2,4,7,15,-8,2,england5
Tallinna Kalev,6,4,1,1,17,5,12,13,estonia
Flora,6,4,1,1,12,6,6,13,estonia
Paide,6,3,2,1,14,8,6,11,estonia
Levadia,6,3,2,1,11,9,2,11,estonia
Kuressaare,6,3,1,2,4,5,-1,10,estonia
Nomme Kalju,6,1,4,1,10,10,0,7,estonia
Vaprus,6,1,3,2,3,3,0,6,estonia
Narva Trans,6,2,0,4,6,13,-7,6,estonia
Tammeka,6,1,0,5,5,15,-10,3,estonia
Harju Jalgpalli,6,0,2,4,4,12,-8,2,estonia
Nomme Utd,6,5,1,0,20,5,15,16,estonia2
Viimsi,6,4,0,2,14,9,5,12,estonia2
Paide B,6,4,0,2,11,11,0,12,estonia2
Flora B,6,3,0,3,19,10,9,9,estonia2
Tabasalu,6,3,0,3,10,12,-2,9,estonia2
Elva,6,3,0,3,10,15,-5,9,estonia2
FC Tallinn,6,2,1,3,10,10,0,7,estonia2
Levadia B,6,1,1,4,8,12,-4,4,estonia2
Alliance,6,1,1,4,8,18,-10,4,estonia2
Legion,6,1,0,5,9,21,-12,3,estonia2
Vikingur,6,6,0,0,24,3,21,18,faroeislands
Klaksvik,6,3,2,1,14,4,10,11,faroeislands
HB Torshavn,6,3,2,1,11,6,5,11,faroeislands
07 Vestur,6,3,0,3,8,9,-1,9,faroeislands
AB Argir,6,2,2,2,11,10,1,8,faroeislands
B36 Torshavn,6,2,2,2,8,10,-2,8,faroeislands
IF Fuglafjordur,6,2,2,2,4,9,-5,8,faroeislands
B68 Toftir,6,0,5,1,8,11,-3,5,faroeislands
Streymur,6,1,2,3,3,13,-10,5,faroeislands
TB Tvoroyri,6,0,0,6,2,15,-13,0,faroeislands
Skala,6,6,0,0,24,2,22,18,faroeislands2
Klaksvik B,6,5,0,1,26,5,21,15,faroeislands2
B71 Sandur,6,4,2,0,15,4,11,14,faroeislands2
Hoyvik,6,4,0,2,11,6,5,12,faroeislands2
Vikingur B,6,3,1,2,13,8,5,10,faroeislands2
NSI Runavik,6,3,0,3,15,11,4,9,faroeislands2
B36 Torshavn B,6,2,0,4,12,14,-2,6,faroeislands2
Streymur B,6,1,0,5,3,30,-27,3,faroeislands2
HB B,6,0,1,5,3,23,-20,1,faroeislands2
B68 Toftir B,6,0,0,6,4,25,-21,0,faroeislands2
VPS,6,5,1,0,13,4,9,16,finland
Ilves,6,4,1,1,17,9,8,13,finland
Haka,6,3,2,1,9,5,4,11,finland
KuPS,6,3,2,1,9,7,2,11,finland
HJK Helsinki,6,3,1,2,13,9,4,10,finland
Lahti,6,3,1,2,8,11,-3,10,finland
Honka,6,3,0,3,8,11,-3,9,finland
Oulu,6,2,1,3,10,10,0,7,finland
Mariehamn,6,2,1,3,8,8,0,7,finland
SJK,6,1,1,4,6,10,-4,4,finland
Inter Turku,6,1,1,4,4,10,-6,4,finland
KTP,6,0,0,6,2,13,-11,0,finland
Ekenas IF,6,5,1,0,14,6,8,16,finland2
Gnistan,6,3,3,0,14,10,4,12,finland2
JaPS,6,3,2,1,13,8,5,11,finland2
Jaro,6,3,2,1,13,9,4,11,finland2
KaPa,6,2,2,2,11,10,1,8,finland2
SJK Akatemia,6,2,2,2,11,11,0,8,finland2
HIFK,6,2,1,3,11,12,-1,7,finland2
KPV Kokkola,6,2,0,4,9,14,-5,6,finland2
SalPa,6,1,2,3,9,11,-2,5,finland2
Mikkelin,6,1,2,3,7,10,-3,5,finland2
JJK,6,1,2,3,7,12,-5,5,finland2
TPS,6,1,1,4,6,12,-6,4,finland2
Brest,6,5,1,0,14,2,12,16,france
Paris SG,6,5,1,0,16,5,11,16,france
Marseille,6,4,2,0,13,5,8,14,france
Lens,6,4,1,1,9,4,5,13,france
Strasbourg,6,3,2,1,9,7,2,11,france
Nice,6,3,1,2,6,5,1,10,france
Monaco,6,3,1,2,8,8,0,10,france
Lille,6,2,3,1,7,4,3,9,france
Lyon,6,3,0,3,7,8,-1,9,france
Rennes,6,2,1,3,7,7,0,7,france
Metz,6,2,0,4,7,10,-3,6,france
Montpellier,6,1,3,2,4,7,-3,6,france
Reims,6,2,0,4,5,11,-6,6,france
Le Havre,6,1,2,3,4,6,-2,5,france
Nantes,6,1,1,4,3,8,-5,4,france
Toulouse,6,0,3,3,3,8,-5,3,france
Clermont,6,0,2,4,3,12,-9,2,france
Lorient,6,0,1,5,6,15,-9,1,france
Auxerre,6,5,1,0,15,6,9,16,france2
Angers,6,4,2,0,14,6,8,14,france2
Grenoble,6,4,1,1,9,4,5,13,france2
Paris FC,6,4,1,1,8,4,4,13,france2
Pau FC,6,3,3,0,10,6,4,12,france2
Caen,6,3,2,1,7,7,0,11,france2
Bordeaux,6,3,1,2,9,6,3,10,france2
AC Ajaccio,6,3,1,2,6,6,0,10,france2
Rodez Aveyron,6,2,2,2,7,7,0,8,france2
Quevilly Rouen,6,1,4,1,10,10,0,7,france2
Guingamp,6,2,1,3,4,4,0,7,france2
Troyes,6,2,1,3,5,7,-2,7,france2
Amiens,6,1,3,2,5,7,-2,6,france2
SC Bastia,6,1,2,3,7,5,2,5,france2
Laval,6,1,2,3,5,10,-5,5,france2
Annecy,6,1,1,4,5,8,-3,4,france2
Saint-Etienne,6,1,1,4,7,13,-6,4,france2
Concarneau,6,1,1,4,4,10,-6,4,france2
USL Dunkerque,6,1,1,4,2,11,-9,4,france2
Valenciennes,6,0,2,4,2,7,-5,2,france2
Sochaux,6,4,1,1,16,7,9,13,france3
Dijon,6,4,1,1,11,7,4,13,france3
Martigues,6,4,1,1,6,2,4,13,france3
Rouen,6,3,2,1,11,4,7,11,france3
Red Star,6,3,2,1,10,7,3,11,france3
Orleans,6,3,1,2,12,10,2,10,france3
Nancy,6,3,1,2,6,4,2,10,france3
Epinal,6,3,0,3,13,10,3,9,france3
Villefranche,6,2,3,1,10,7,3,9,france3
Versailles,6,2,2,2,14,7,7,8,france3
Niort,6,2,1,3,11,12,-1,7,france3
G. O. A. L.,6,2,1,3,8,9,-1,7,france3
Le Mans,6,2,1,3,6,9,-3,7,france3
Avranches,6,2,1,3,4,9,-5,7,france3
Marignane G.,6,1,3,2,5,9,-4,6,france3
Chateauroux,6,0,3,3,6,13,-7,3,france3
Cholet,6,1,0,5,2,12,-10,3,france3
Nimes,6,0,1,5,4,16,-12,1,france3
Dinamo Tbilisi,6,5,1,0,21,6,15,16,georgia
Dila Gori,6,5,0,1,11,4,7,15,georgia
Torpedo Kutaisi,6,3,3,0,17,6,11,12,georgia
Samgurali,6,3,2,1,9,8,1,11,georgia
Dinamo Batumi,6,3,1,2,15,12,3,10,georgia
Gagra,6,3,0,3,16,10,6,9,georgia
Samtredia,6,1,1,4,16,12,4,4,georgia
Telavi,6,1,0,5,5,13,-8,3,georgia
Shukura,6,1,0,5,4,33,-29,3,georgia
Saburtalo,6,0,2,4,3,13,-10,2,georgia
Kolkheti Poti,6,4,1,1,8,2,6,13,georgia2
Bolnisi,6,4,0,2,22,10,12,12,georgia2
Gareji Sagarejo,6,3,2,1,15,6,9,11,georgia2
WIT Georgia,6,3,2,1,9,5,4,11,georgia2
L. Tbilisi,6,3,1,2,12,7,5,10,georgia2
Spaeri,6,3,1,2,9,9,0,10,georgia2
D. Tbilisi B,6,2,2,2,12,6,6,8,georgia2
Merani Martvili,6,1,1,4,9,25,-16,4,georgia2
Kolkheti Khobi,6,0,3,3,5,13,-8,3,georgia2
Merani Tbilisi,6,0,1,5,8,26,-18,1,georgia2
Bayern Munich,6,5,0,1,15,8,7,15,germany
Leverkusen,6,4,2,0,16,2,14,14,germany
RB Leipzig,6,4,1,1,13,8,5,13,germany
Stuttgart,6,4,1,1,10,6,4,13,germany
Freiburg,6,3,1,2,8,7,1,10,germany
Heidenheim,6,3,1,2,10,10,0,10,germany
Bochum,6,2,2,2,8,9,-1,8,germany
Monchengladbach,6,2,1,3,12,12,0,7,germany
E. Frankfurt,6,2,1,3,11,11,0,7,germany
Union Berlin,6,2,1,3,6,12,-6,7,germany
Dortmund,6,1,3,2,10,10,0,6,germany
Hoffenheim,6,1,3,2,10,11,-1,6,germany
Werder Bremen,6,1,3,2,7,10,-3,6,germany
FC Augsburg,6,1,3,2,5,9,-4,6,germany
Wolfsburg,6,2,0,4,5,11,-6,6,germany
FC Koln,6,1,2,3,2,6,-4,5,germany
FSV Mainz,6,0,4,2,2,4,-2,4,germany
Darmstadt,6,0,3,3,6,9,-3,3,germany
Holstein Kiel,6,5,1,0,15,5,10,16,germany2
Greuther Furth,6,4,2,0,9,3,6,14,germany2
Paderborn,6,4,0,2,11,8,3,12,germany2
Hertha Berlin,6,2,4,0,11,6,5,10,germany2
Schalke 04,6,3,1,2,14,10,4,10,germany2
Sankt Pauli,6,2,4,0,9,6,3,10,germany2
Hamburger SV,6,3,1,2,11,9,2,10,germany2
Dusseldorf,6,3,0,3,14,10,4,9,germany2
Karlsruher SC,6,2,3,1,13,12,1,9,germany2
Braunschweig,6,3,0,3,9,9,0,9,germany2
Magdeburg,6,2,1,3,10,9,1,7,germany2
Wehen Wiesbaden,6,2,1,3,9,11,-2,7,germany2
Hannover 96,6,1,3,2,6,8,-2,6,germany2
Elversberg,6,2,0,4,9,13,-4,6,germany2
FC Nurnberg,6,2,0,4,6,14,-8,6,germany2
Hansa Rostock,6,1,2,3,6,11,-5,5,germany2
Osnabruck,6,0,3,3,4,11,-7,3,germany2
Kaiserslautern,6,0,0,6,4,15,-11,0,germany2
FC Ingolstadt,6,4,2,0,14,4,10,14,germany3
Regensburg,6,4,2,0,11,6,5,14,germany3
Saarbrucken,6,3,3,0,10,3,7,12,germany3
RW Essen,6,4,0,2,10,7,3,12,germany3
Ulm,6,3,1,2,10,7,3,10,germany3
Sandhausen,6,3,1,2,9,8,1,10,germany3
Unterhaching,6,3,1,2,9,8,1,10,germany3
Verl,6,3,1,2,8,10,-2,10,germany3
Preuss. Munster,6,2,3,1,13,11,2,9,germany3
Dortmund B,6,2,3,1,8,6,2,9,germany3
Dynamo Dresden,6,3,0,3,7,6,1,9,germany3
MSV Duisburg,6,2,2,2,8,9,-1,8,germany3
Bielefeld,6,1,4,1,9,8,1,7,germany3
Erzgebirge Aue,6,1,4,1,6,7,-1,7,germany3
Mannheim,6,2,1,3,6,8,-2,7,germany3
Viktoria Koln,6,1,3,2,9,13,-4,6,germany3
VfB Lubeck,6,1,2,3,5,10,-5,5,germany3
Hallescher,6,1,1,4,9,13,-4,4,germany3
1860 Munchen,6,1,0,5,3,10,-7,3,germany3
Freiburg B,6,0,0,6,6,17,-11,0,germany3
PAOK,6,6,0,0,24,2,22,18,greece
AEK Athens,6,4,2,0,12,4,8,14,greece
Panathinaikos,6,4,0,2,12,5,7,12,greece
Asteras T.,6,4,0,2,10,9,1,12,greece
Olympiakos,6,3,2,1,8,4,4,11,greece
Atromitos,6,2,4,0,11,7,4,10,greece
Aris,6,3,1,2,9,6,3,10,greece
Panaitolikos,6,2,2,2,10,9,1,8,greece
Volos,6,2,2,2,6,10,-4,8,greece
Lamia,6,1,2,3,7,13,-6,5,greece
PAS Giannina,6,0,3,3,4,9,-5,3,greece
Kifisia,6,1,0,5,5,18,-13,3,greece
OFI Crete,6,0,2,4,2,13,-11,2,greece
Panserraikos,6,0,1,5,4,13,-9,1,greece
Achuapa,6,4,1,1,9,5,4,13,guatemala
Municipal,6,3,2,1,9,5,4,11,guatemala
Antigua GFC,6,3,2,1,10,7,3,11,guatemala
Mixco,6,3,2,1,6,4,2,11,guatemala
Zacapa Tellioz,6,3,1,2,10,5,5,10,guatemala
Guastatoya,6,3,1,2,8,4,4,10,guatemala
Comunicaciones,6,3,1,2,9,8,1,10,guatemala
Xelaju,6,2,1,3,3,4,-1,7,guatemala
Malacateco,6,2,1,3,9,15,-6,7,guatemala
Xinabajul,6,1,2,3,3,6,-3,5,guatemala
Coban Imperial,6,0,3,3,6,10,-4,3,guatemala
Coatepecano IB,6,0,1,5,0,9,-9,1,guatemala
Olimpia,6,6,0,0,17,4,13,18,honduras
Marathon,6,5,0,1,10,7,3,15,honduras
Motagua,6,3,0,3,12,11,1,9,honduras
Real Espana,6,2,2,2,7,8,-1,8,honduras
UPNFM,6,2,1,3,7,13,-6,7,honduras
G√©nesis,6,1,3,2,6,7,-1,6,honduras
Olancho,6,1,3,2,6,7,-1,6,honduras
Victoria,6,1,2,3,7,8,-1,5,honduras
Real Sociedad,6,1,2,3,5,7,-2,5,honduras
Vida,6,1,1,4,7,14,-7,4,honduras
LM Warriors,6,5,1,0,19,8,11,16,hongkong
Kitchee,6,4,1,1,16,8,8,13,hongkong
Eastern,6,4,1,1,10,4,6,13,hongkong
Wofoo Tai Po,6,4,0,2,8,6,2,12,hongkong
Southern D.,6,3,1,2,12,6,6,10,hongkong
HK Rangers,6,3,0,3,17,8,9,9,hongkong
North District,6,2,2,2,13,10,3,8,hongkong
Hong Kong FC,6,2,2,2,8,9,-1,8,hongkong
HK U23,6,0,3,3,4,16,-12,3,hongkong
Resources C.,6,1,0,5,4,22,-18,3,hongkong
Sham Shui Po,6,0,1,5,5,14,-9,1,hongkong
MOL Fehervar,6,5,1,0,14,5,9,16,hungary
MTK,6,3,2,1,10,8,2,11,hungary
Paks,6,3,1,2,9,8,1,10,hungary
Puskas Akad.,6,2,3,1,7,5,2,9,hungary
Ferencvaros,6,2,2,2,8,5,3,8,hungary
Debrecen,6,2,2,2,6,6,0,8,hungary
Kecskemeti TE,6,2,2,2,9,11,-2,8,hungary
Diosgyor VTK,6,2,2,2,8,11,-3,8,hungary
Kisvarda,6,2,1,3,9,6,3,7,hungary
Zalaegerszegi,6,2,1,3,6,8,-2,7,hungary
Mezokovesd,6,1,2,3,4,6,-2,5,hungary
Ujpest,6,0,1,5,4,15,-11,1,hungary
Nyiregyhaza,6,6,0,0,23,6,17,18,hungary2
Vasas,6,4,2,0,18,5,13,14,hungary2
Szeged,6,4,2,0,7,1,6,14,hungary2
Gyori ETO,6,4,1,1,9,7,2,13,hungary2
Kozarmisleny,6,3,2,1,15,8,7,11,hungary2
Pecsi MFC,6,3,1,2,3,2,1,10,hungary2
Gyirmot,6,2,3,1,9,9,0,9,hungary2
BVSC,6,2,2,2,4,4,0,8,hungary2
Soroksar,6,1,4,1,5,5,0,7,hungary2
Kazincbarcika,6,2,1,3,6,10,-4,7,hungary2
Ajka,6,2,0,4,5,8,-3,6,hungary2
Honved,6,1,3,2,5,8,-3,6,hungary2
Csakvari,6,1,3,2,6,12,-6,6,hungary2
Budafoki,6,1,2,3,5,7,-2,5,hungary2
MTE,6,1,1,4,5,11,-6,4,hungary2
Siofok,6,1,1,4,5,15,-10,4,hungary2
Tiszakecske,6,0,3,3,4,7,-3,3,hungary2
Haladas,6,0,3,3,8,12,-4,3,hungary2
Stjarnan,6,5,0,1,13,4,9,15,iceland
Valur,6,4,1,1,17,11,6,13,iceland
KA Akureyri,6,4,1,1,12,7,5,13,iceland
Vikingur R.,6,3,1,2,14,12,2,10,iceland
Fylkir,6,2,3,1,15,11,4,9,iceland
Hafnarfjordur,6,3,0,3,10,10,0,9,iceland
Fram,6,2,2,2,10,12,-2,8,iceland
IBV,6,1,4,1,9,9,0,7,iceland
KR Reykjavik,6,1,3,2,11,14,-3,6,iceland
Keflavik,6,1,1,4,7,15,-8,4,iceland
Breidablik,6,1,0,5,8,15,-7,3,iceland
HK Kopavogur,6,0,2,4,5,11,-6,2,iceland
IA Akranes,6,5,1,0,17,6,11,16,iceland2
Vestri,6,5,1,0,16,6,10,16,iceland2
Fjolnir,6,4,1,1,19,10,9,13,iceland2
Leiknir R.,6,3,0,3,13,7,6,9,iceland2
Grindavik,6,3,0,3,11,16,-5,9,iceland2
Throttur R.,6,2,2,2,12,8,4,8,iceland2
Afturelding,6,2,1,3,12,11,1,7,iceland2
Thor Akureyri,6,2,1,3,9,10,-1,7,iceland2
Grotta,6,1,3,2,9,12,-3,6,iceland2
Njardv√≠k,6,2,0,4,11,16,-5,6,iceland2
Selfoss,6,1,1,4,7,10,-3,4,iceland2
AEggir,6,0,1,5,4,28,-24,1,iceland2
IR Reykjavik,6,5,1,0,22,7,15,16,iceland3
Dalvik / Reynir,6,5,1,0,15,4,11,16,iceland3
V. Olafsvik,6,3,2,1,13,10,3,11,iceland3
Fjardabyggd,6,3,1,2,12,8,4,10,iceland3
Throttur Vogar,6,3,1,2,11,8,3,10,iceland3
Hottur / Huginn,6,3,1,2,9,11,-2,10,iceland3
Volsungur,6,3,0,3,13,10,3,9,iceland3
Haukar,6,3,0,3,9,11,-2,9,iceland3
Fjallabyggd,6,2,1,3,11,14,-3,7,iceland3
KFG,6,1,0,5,12,17,-5,3,iceland3
KV Reykjavik,6,0,1,5,4,17,-13,1,iceland3
Sindri,6,0,1,5,6,20,-14,1,iceland3
Odisha FC,6,4,2,0,11,3,8,14,india
Goa,6,4,2,0,10,2,8,14,india
Kerala Blasters,6,4,1,1,8,4,4,13,india
Mumbai City,6,3,2,1,9,3,6,11,india
East Bengal,6,1,4,1,7,3,4,7,india
ATK Mohun Bagan,6,2,1,3,9,10,-1,7,india
Punjab,6,1,3,2,5,6,-1,6,india
Chennaiyin,6,1,3,2,8,10,-2,6,india
Bengaluru,6,1,3,2,6,11,-5,6,india
Jamshedpur,6,1,1,4,8,9,-1,4,india
NorthEast Utd,6,0,4,2,5,12,-7,4,india
Hyderabad,6,0,2,4,2,13,-11,2,india
Mohammedan,6,4,2,0,8,3,5,14,india2
Real Kashmir,6,3,2,1,10,2,8,11,india2
Aizawl,6,2,4,0,12,5,7,10,india2
Shillong Lajong,6,3,1,2,9,8,1,10,india2
Sreenidi Deccan,6,3,1,2,7,7,0,10,india2
Rajasthan,6,2,3,1,15,14,1,9,india2
Delhi FC,6,3,0,3,8,9,-1,9,india2
Churchill B.,6,2,2,2,10,6,4,8,india2
Inter Kashi,6,2,2,2,8,11,-3,8,india2
Gokulam,6,1,4,1,9,9,0,7,india2
Namdhari,6,1,1,4,5,11,-6,4,india2
TRAU,6,1,0,5,10,18,-8,3,india2
Neroca,6,1,0,5,10,20,-10,3,india2
Borneo,6,5,1,0,9,1,8,16,indonesia
Persija,6,3,3,0,12,6,6,12,indonesia
PSIS Semarang,6,3,2,1,10,6,4,11,indonesia
Persik Kediri,6,3,2,1,8,4,4,11,indonesia
Bali Utd,6,3,2,1,8,6,2,11,indonesia
Persib,6,2,3,1,8,5,3,9,indonesia
Bhayangkara S.,6,1,5,0,10,7,3,8,indonesia
Barito Putera,6,2,2,2,7,8,-1,8,indonesia
Persita,6,2,2,2,8,11,-3,8,indonesia
PSM,6,1,4,1,8,7,1,7,indonesia
Arema,6,2,1,3,9,9,0,7,indonesia
PSS Sleman,6,2,1,3,4,5,-1,7,indonesia
Dewa Utd,6,1,3,2,6,10,-4,6,indonesia
Madura Utd,6,1,2,3,8,11,-3,5,indonesia
Persis Solo,6,1,2,3,6,9,-3,5,indonesia
TIRA Persikabo,6,1,2,3,7,13,-6,5,indonesia
Persebaya S.,6,0,4,2,3,9,-6,4,indonesia
R. Nusantara,6,0,2,4,2,8,-6,2,indonesia
Tractor Sazi,6,4,1,1,8,2,6,13,iran
Persepolis,6,3,3,0,8,5,3,12,iran
Shams A. Qazvin,6,3,2,1,7,4,3,11,iran
Esteghlal,6,2,4,0,9,4,5,10,iran
Zob Ahan,6,2,4,0,4,2,2,10,iran
Sepahan,6,3,0,3,13,7,6,9,iran
Malavan,6,2,3,1,7,5,2,9,iran
Gol Gohar,6,2,3,1,5,3,2,9,iran
Aluminium Arak,6,2,3,1,5,4,1,9,iran
Havadar,6,2,1,3,6,9,-3,7,iran
Foolad,6,1,3,2,2,5,-3,6,iran
E. Khuzestan,6,1,2,3,6,10,-4,5,iran
Paykan,6,0,4,2,3,6,-3,4,iran
Sanat Naft,6,1,1,4,3,7,-4,4,iran
N. Mazandaran,6,1,1,4,4,10,-6,4,iran
Mes Rafsanjan,6,0,1,5,4,15,-11,1,iran
Al Shorta,6,6,0,0,15,2,13,18,iraq
Al Quwa Al J.,6,4,2,0,11,5,6,14,iraq
Al Zawraa,6,3,3,0,8,2,6,12,iraq
Al Minaa Basra,6,3,2,1,6,6,0,11,iraq
Al Kahrabaa,6,2,4,0,10,7,3,10,iraq
Newroz SC,6,2,3,1,8,6,2,9,iraq
Erbil,6,2,2,2,7,7,0,8,iraq
Naft Maysan,6,1,4,1,6,4,2,7,iraq
Al Talaba,6,1,4,1,6,5,1,7,iraq
Baghdad,6,2,1,3,6,7,-1,7,iraq
Al Najaf,6,2,1,3,4,6,-2,7,iraq
Duhok,6,2,1,3,4,7,-3,7,iraq
Al Hudod,6,2,1,3,8,12,-4,7,iraq
Al Naft,6,1,3,2,4,5,-1,6,iraq
Zakho,6,1,3,2,2,5,-3,6,iraq
Al-Qasim,6,0,5,1,9,10,-1,5,iraq
Karbala,6,1,1,4,4,11,-7,4,iraq
Al Karkh,6,0,3,3,4,7,-3,3,iraq
Naft Al-Janoob,6,0,3,3,3,7,-4,3,iraq
Naft Al-Wasat,6,0,3,3,1,7,-6,3,iraq
Dundalk,6,5,0,1,17,3,14,15,ireland
Shamrock Rovers,6,4,2,0,12,2,10,14,ireland
Derry City,6,3,2,1,10,1,9,11,ireland
Shelbourne,6,3,2,1,9,6,3,11,ireland
Bohemians,6,3,1,2,10,7,3,10,ireland
St. Patricks,6,3,0,3,5,7,-2,9,ireland
Drogheda Utd,6,1,2,3,5,13,-8,5,ireland
Sligo Rovers,6,1,1,4,4,10,-6,4,ireland
Cork City,6,1,1,4,2,11,-9,4,ireland
UC Dublin,6,0,1,5,4,18,-14,1,ireland
Galway Utd,6,6,0,0,20,2,18,18,ireland2
Cobh Ramblers,6,3,2,1,14,7,7,11,ireland2
Wexford,6,3,2,1,9,7,2,11,ireland2
Treaty Utd,6,3,1,2,12,11,1,10,ireland2
Bray Wanderers,6,2,3,1,9,8,1,9,ireland2
Waterford,6,2,2,2,7,6,1,8,ireland2
Finn Harps,6,2,1,3,8,11,-3,7,ireland2
Athlone Town,6,1,1,4,4,16,-12,4,ireland2
Kerry,6,0,2,4,5,12,-7,2,ireland2
Longford Town,6,0,2,4,4,12,-8,2,ireland2
M. Tel Aviv,6,6,0,0,11,3,8,18,israel
Maccabi Haifa,6,4,2,0,15,3,12,14,israel
H. Beer Sheva,6,4,1,1,17,7,10,13,israel
H. Jerusalem,6,4,1,1,9,6,3,13,israel
Hapoel Tel Aviv,6,3,2,1,12,7,5,11,israel
Maccabi Netanya,6,3,0,3,10,9,1,9,israel
Bnei Sakhnin,6,2,3,1,7,6,1,9,israel
B. Jerusalem,6,2,2,2,13,11,2,8,israel
Hapoel Haifa,6,2,1,3,6,12,-6,7,israel
Hapoel Hadera,6,2,0,4,4,12,-8,6,israel
M. Bnei Raina,6,1,1,4,4,8,-4,4,israel
M. Petah Tikva,6,1,0,5,7,14,-7,3,israel
Ashdod,6,1,0,5,4,13,-9,3,israel
H. Petah Tikva,6,0,1,5,4,12,-8,1,israel
Maccabi Jaffa,6,4,2,0,12,2,10,14,israel2
Ironi Tiberias,6,4,2,0,12,5,7,14,israel2
H. Umm al-Fahm,6,3,2,1,10,4,6,11,israel2
Bnei Yehuda,6,3,2,1,9,3,6,11,israel2
Hapoel Akko,6,3,2,1,11,9,2,11,israel2
Kiryat Shmona,6,3,0,3,11,8,3,9,israel2
H. Nof Hagalil,6,2,2,2,6,6,0,8,israel2
Kafr Qasim,6,2,2,2,8,11,-3,8,israel2
M. Herziliya,6,2,2,2,7,10,-3,8,israel2
Ramat Hasharon,6,2,1,3,10,11,-1,7,israel2
H. Ramat Gan,6,2,1,3,6,9,-3,7,israel2
H. Ironi Rishon,6,2,1,3,4,7,-3,7,israel2
Ihud B. Shfaram,6,1,3,2,7,12,-5,6,israel2
Hapoel Afula,6,1,2,3,8,12,-4,5,israel2
Nes Tziona,6,1,1,4,6,11,-5,4,israel2
H. Kfar Saba,6,0,1,5,4,11,-7,1,israel2
Inter Milan,6,4,2,0,13,2,11,14,italy
Juventus,6,4,2,0,8,4,4,14,italy
AC Milan,6,4,1,1,12,6,6,13,italy
Fiorentina,6,4,1,1,7,2,5,13,italy
Bologna,6,3,2,1,7,6,1,11,italy
AS Roma,6,3,1,2,8,6,2,10,italy
Lazio,6,3,1,2,8,6,2,10,italy
Atalanta,6,3,0,3,9,9,0,9,italy
Torino,6,2,2,2,5,4,1,8,italy
Genoa,6,1,4,1,6,6,0,7,italy
Napoli,6,2,1,3,4,8,-4,7,italy
Salernitana,6,2,1,3,7,12,-5,7,italy
Hellas Verona,6,1,3,2,8,8,0,6,italy
Lecce,6,1,3,2,6,8,-2,6,italy
Udinese,6,1,3,2,10,13,-3,6,italy
Cagliari,6,1,2,3,4,7,-3,5,italy
Monza,6,1,2,3,3,7,-4,5,italy
Sassuolo,6,1,1,4,9,12,-3,4,italy
Frosinone,6,1,1,4,6,11,-5,4,italy
Empoli,6,0,3,3,5,9,-4,3,italy
Cittadella,6,4,2,0,10,3,7,14,italy2
Parma,6,3,3,0,10,5,5,12,italy2
Brescia,6,3,2,1,10,7,3,11,italy2
Ternana,6,3,2,1,11,9,2,11,italy2
Como,6,3,2,1,8,7,1,11,italy2
Cremonese,6,3,1,2,8,4,4,10,italy2
Sampdoria,6,3,1,2,10,9,1,10,italy2
Catanzaro,6,3,0,3,8,6,2,9,italy2
Palermo,6,2,3,1,14,13,1,9,italy2
Venezia,6,2,2,2,12,9,3,8,italy2
Reggiana,6,2,2,2,8,8,0,8,italy2
Lecco,6,2,2,2,7,8,-1,8,italy2
FeralpiSalo,6,2,1,3,8,9,-1,7,italy2
Spezia,6,2,1,3,6,9,-3,7,italy2
Pisa,6,1,3,2,5,7,-2,6,italy2
Modena,6,1,3,2,6,10,-4,6,italy2
Ascoli,6,1,2,3,4,7,-3,5,italy2
Bari,6,1,2,3,3,7,-4,5,italy2
Sudtirol,6,1,1,4,8,11,-3,4,italy2
Cosenza,6,0,2,4,2,9,-7,2,italy2
Portmore Utd,6,5,1,0,12,2,10,16,jamaica
Arnett Gardens,6,4,1,1,9,3,6,13,jamaica
Cavalier,6,4,1,1,8,3,5,13,jamaica
Dunbeholden,6,4,1,1,9,6,3,13,jamaica
Tivoli Gardens,6,3,2,1,11,6,5,11,jamaica
Vere Utd,6,3,1,2,8,5,3,10,jamaica
Montego Bay,6,3,1,2,11,10,1,10,jamaica
Waterhouse,6,2,3,1,9,6,3,9,jamaica
Mount Pleasant,6,3,0,3,8,7,1,9,jamaica
Harbour View,6,1,3,2,9,10,-1,6,jamaica
Molynes Utd,6,1,3,2,5,8,-3,6,jamaica
Humble Lions,6,1,0,5,3,10,-7,3,jamaica
Lime Hall Acade,6,0,1,5,3,15,-12,1,jamaica
Treasure Beach,6,0,0,6,2,13,-11,0,jamaica
Vissel Kobe,6,5,1,0,11,4,7,16,japan
S. Hiroshima,6,4,2,0,9,2,7,14,japan
Shonan Bellmare,6,4,1,1,7,3,4,13,japan
Albirex Niigata,6,3,3,0,6,3,3,12,japan
K. Frontale,6,3,2,1,14,9,5,11,japan
Yokohama M.,6,3,1,2,11,6,5,10,japan
Urawa RD,6,2,2,2,8,6,2,8,japan
Kyoto Sanga,6,2,1,3,9,9,0,7,japan
Yokohama FC,6,2,1,3,7,7,0,7,japan
FC Tokyo,6,2,1,3,6,6,0,7,japan
Kashiwa Reysol,6,1,4,1,7,8,-1,7,japan
C. Sapporo,6,2,1,3,7,10,-3,7,japan
Avispa Fukuoka,6,2,1,3,7,12,-5,7,japan
Sagan Tosu,6,1,3,2,8,10,-2,6,japan
Kashima Antlers,6,1,3,2,4,8,-4,6,japan
Nagoya G.,6,1,2,3,6,9,-3,5,japan
Cerezo Osaka,6,1,1,4,1,6,-5,4,japan
Gamba Osaka,6,0,0,6,1,11,-10,0,japan
Machida Zelvia,6,5,1,0,14,5,9,16,japan2
M. Yamagata,6,5,0,1,10,4,6,15,japan2
Tokyo Verdy,6,4,2,0,8,3,5,14,japan2
Jubilo Iwata,6,4,1,1,12,3,9,13,japan2
Ventforet Kofu,6,3,2,1,11,7,4,11,japan2
Shimizu S-Pulse,6,3,1,2,14,7,7,10,japan2
V-V. Nagasaki,6,3,1,2,12,7,5,10,japan2
JEF Utd Chiba,6,3,1,2,12,8,4,10,japan2
R. Kumamoto,6,3,0,3,7,8,-1,9,japan2
Omiya Ardija,6,3,0,3,6,11,-5,9,japan2
Oita Trinita,6,2,2,2,7,7,0,8,japan2
Vegalta Sendai,6,2,2,2,7,8,-1,8,japan2
Tokushima V.,6,2,2,2,4,6,-2,8,japan2
Blaublitz Akita,6,2,1,3,7,6,1,7,japan2
Fujieda MYFC,6,2,1,3,11,13,-2,7,japan2
Iwaki,6,2,1,3,11,17,-6,7,japan2
R. Yamaguchi,6,1,2,3,8,12,-4,5,japan2
Kusatsu,6,1,1,4,6,12,-6,4,japan2
Fagiano Okayama,6,0,4,2,4,11,-7,4,japan2
Z. Kanazawa,6,0,2,4,5,10,-5,2,japan2
Tochigi SC,6,0,2,4,4,9,-5,2,japan2
Mito Hollyhock,6,0,2,4,4,12,-8,2,japan2
Al Hussein,6,5,1,0,12,1,11,16,jordan
Al Wihdat,6,5,1,0,13,4,9,16,jordan
Al Faysali,6,3,2,1,10,5,5,11,jordan
Maan,6,3,2,1,9,5,4,11,jordan
Al Ramtha,6,3,1,2,9,4,5,10,jordan
Aqaba,6,2,2,2,6,9,-3,8,jordan
Moghayer Al S.,6,2,1,3,6,8,-2,7,jordan
Shabab Al Ordon,6,2,1,3,5,7,-2,7,jordan
Al Salt,6,1,1,4,4,8,-4,4,jordan
Al Ahli,6,1,1,4,2,7,-5,4,jordan
Al Jalil,6,1,1,4,4,10,-6,4,jordan
Sahab,6,0,2,4,4,16,-12,2,jordan
FC Astana,6,4,1,1,12,8,4,13,kazakhstan
Kairat Almaty,6,3,3,0,8,3,5,12,kazakhstan
Kaisar K.,6,3,2,1,8,6,2,11,kazakhstan
Aktobe,6,2,4,0,7,4,3,10,kazakhstan
Ordabasy,6,3,0,3,8,7,1,9,kazakhstan
Okzhetpes,6,2,3,1,7,8,-1,9,kazakhstan
Maqtaaral,6,2,2,2,6,6,0,8,kazakhstan
Atyrau,6,1,4,1,2,1,1,7,kazakhstan
Tobol,6,1,3,2,8,7,1,6,kazakhstan
Kaspiy Aktau,6,1,3,2,7,10,-3,6,kazakhstan
S. Karagandy,6,1,3,2,7,10,-3,6,kazakhstan
Zhetysu,6,1,2,3,8,10,-2,5,kazakhstan
Kyzylzhar,6,0,3,3,3,6,-3,3,kazakhstan
Aksu,6,1,0,5,3,11,-8,3,kazakhstan
Llapi,6,4,1,1,12,6,6,13,kosovo
Malisheva,6,4,1,1,5,3,2,13,kosovo
Drita,6,4,0,2,8,5,3,12,kosovo
Dukagjini,6,3,1,2,6,4,2,10,kosovo
Prishtina,6,2,4,0,6,4,2,10,kosovo
Feronikeli,6,3,1,2,5,5,0,10,kosovo
Ballkani,6,2,2,2,8,8,0,8,kosovo
Gjilani,6,1,1,4,4,5,-1,4,kosovo
Fushe Kosova,6,1,0,5,3,8,-5,3,kosovo
Liria,6,0,1,5,3,13,-10,1,kosovo
Al Arabi SC,6,5,1,0,16,2,14,16,kuwait
Al Qadsia,6,4,2,0,14,5,9,14,kuwait
Al Kuwait,6,4,1,1,19,8,11,13,kuwait
Al Nasar,6,3,2,1,9,4,5,11,kuwait
Al Fahaheel,6,3,1,2,9,6,3,10,kuwait
Kazma,6,2,1,3,6,15,-9,7,kuwait
Al Salmiyah,6,0,5,1,4,6,-2,5,kuwait
Al Shabab,6,1,0,5,4,15,-11,3,kuwait
Khaitan,6,0,2,4,2,13,-11,2,kuwait
Al Jahra,6,0,1,5,3,12,-9,1,kuwait
RFS,6,6,0,0,19,6,13,18,latvia
Riga FC,6,4,2,0,12,3,9,14,latvia
Auda,6,3,1,2,5,5,0,10,latvia
Liepaja,6,2,2,2,7,7,0,8,latvia
Valmiera,6,2,2,2,7,8,-1,8,latvia
Daugavpils,6,2,1,3,7,9,-2,7,latvia
FS Jelgava,6,1,3,2,3,5,-2,6,latvia
Super Nova,6,1,2,3,3,10,-7,5,latvia
Tukums,6,1,1,4,7,13,-6,4,latvia
Metta / LU,6,1,0,5,7,11,-4,3,latvia
Kauno Zalgiris,6,5,1,0,17,5,12,16,lithuania
Panevezys,6,2,4,0,6,3,3,10,lithuania
Riteriai,6,3,1,2,9,7,2,10,lithuania
Hegelmann L.,6,3,1,2,8,10,-2,10,lithuania
FA Siauliai,6,1,4,1,9,8,1,7,lithuania
Zalgiris,6,2,1,3,5,8,-3,7,lithuania
Suduva,6,2,1,3,4,7,-3,7,lithuania
Banga,6,2,0,4,4,9,-5,6,lithuania
Dziugas Telsiai,6,0,4,2,3,6,-3,4,lithuania
Dainava,6,0,2,4,3,7,-4,2,lithuania
Neptuna K.,6,4,1,1,18,8,10,13,lithuania2
TransINVEST,6,4,1,1,15,8,7,13,lithuania2
Be1 NFA,6,4,1,1,10,4,6,13,lithuania2
BFA Vilnius,6,4,0,2,13,9,4,12,lithuania2
Kauno Z. B,6,3,1,2,12,8,4,10,lithuania2
FA Siauliai B,6,3,1,2,13,13,0,10,lithuania2
Zalgiris B,6,2,3,1,16,13,3,9,lithuania2
Garliava,6,2,3,1,9,6,3,9,lithuania2
Minija,6,3,0,3,12,10,2,9,lithuania2
Riteriai B,6,3,0,3,10,10,0,9,lithuania2
Babrungas,6,3,0,3,11,14,-3,9,lithuania2
Nevezis,6,2,2,2,9,8,1,8,lithuania2
Panevezys B,6,2,1,3,11,10,1,7,lithuania2
Ekranas,6,2,0,4,7,13,-6,6,lithuania2
Jonava,6,1,1,4,7,15,-8,4,lithuania2
Marijampole C.,6,0,0,6,0,18,-18,0,lithuania2
Dudelange,6,5,0,1,9,1,8,15,luxembourg
Differdange,6,4,2,0,13,3,10,14,luxembourg
Racing,6,4,1,1,14,7,7,13,luxembourg
Hesperang,6,3,2,1,9,5,4,11,luxembourg
UN K√§erj√©ng,6,3,1,2,10,6,4,10,luxembourg
Petange,6,3,1,2,9,5,4,10,luxembourg
Niedercorn,6,2,2,2,9,9,0,8,luxembourg
Fola Esch,6,2,2,2,8,8,0,8,luxembourg
Wiltz,6,2,2,2,7,8,-1,8,luxembourg
UNA Strassen,6,1,4,1,5,5,0,7,luxembourg
Mondorf,6,2,0,4,7,12,-5,6,luxembourg
Marisca Mersch,6,1,2,3,9,11,-2,5,luxembourg
Mondercange,6,0,4,2,7,13,-6,4,luxembourg
V. Rosport,6,1,1,4,5,13,-8,4,luxembourg
Schifflange,6,1,1,4,6,15,-9,4,luxembourg
Jeunesse Esch,6,0,3,3,6,12,-6,3,luxembourg
Selangor,6,6,0,0,27,3,24,18,malaysia
Sabah,6,6,0,0,20,3,17,18,malaysia
Johor Darul,6,5,1,0,21,3,18,16,malaysia
Kedah,6,3,1,2,13,7,6,10,malaysia
Kuala Lumpur,6,3,1,2,10,5,5,10,malaysia
PDRM,6,3,1,2,14,10,4,10,malaysia
Kelantan United,6,3,0,3,9,12,-3,9,malaysia
Terengganu,6,2,2,2,8,11,-3,8,malaysia
Perak,6,2,0,4,9,12,-3,6,malaysia
Negeri Sembilan,6,2,0,4,8,11,-3,6,malaysia
Kuching,6,1,2,3,9,10,-1,5,malaysia
Pahang,6,1,2,3,9,12,-3,5,malaysia
Pulau Pinang,6,1,2,3,4,15,-11,5,malaysia
Kelantan,6,0,0,6,7,45,-38,0,malaysia
Floriana,6,5,1,0,13,3,10,16,malta
Sliema W.,6,5,0,1,8,3,5,15,malta
Hamrun Spartans,6,4,1,1,9,7,2,13,malta
Hibernians,6,3,2,1,5,2,3,11,malta
Naxxar Lions,6,3,2,1,8,7,1,11,malta
Birkirkara,6,3,1,2,10,7,3,10,malta
Marsaxlokk,6,3,0,3,13,9,4,9,malta
Balzan,6,1,2,3,6,8,-2,5,malta
Santa Lucia,6,1,2,3,3,8,-5,5,malta
Mosta,6,1,2,3,4,10,-6,5,malta
Sirens,6,1,2,3,4,10,-6,5,malta
Gzira Utd,6,1,1,4,9,11,-2,4,malta
Gudja Utd,6,0,3,3,6,9,-3,3,malta
Valletta,6,0,3,3,3,7,-4,3,malta
CF America,6,5,1,0,13,4,9,16,mexico
Monterrey,6,4,1,1,11,4,7,13,mexico
Puebla,6,4,1,1,11,9,2,13,mexico
Mazatlan,6,4,0,2,11,8,3,12,mexico
Guadalajara,6,4,0,2,9,7,2,12,mexico
Pachuca,6,3,2,1,8,6,2,11,mexico
Pumas UNAM,6,3,1,2,9,4,5,10,mexico
Tigres,6,2,3,1,9,6,3,9,mexico
Santos Laguna,6,3,0,3,14,12,2,9,mexico
Club Leon,6,2,2,2,9,9,0,8,mexico
Queretaro,6,2,1,3,6,8,-2,7,mexico
Necaxa,6,2,1,3,6,9,-3,7,mexico
Toluca,6,2,0,4,7,8,-1,6,mexico
Tijuana,6,2,0,4,7,10,-3,6,mexico
Cruz Azul,6,2,0,4,6,9,-3,6,mexico
A. San Luis,6,1,1,4,9,11,-2,4,mexico
Juarez,6,1,0,5,5,15,-10,3,mexico
Atlas,6,0,2,4,2,11,-9,2,mexico
CF America,6,4,2,0,13,7,6,14,mexico2
Guadalajara,6,4,1,1,14,9,5,13,mexico2
Atlas,6,3,3,0,15,6,9,12,mexico2
Monterrey,6,4,0,2,13,5,8,12,mexico2
Pachuca,6,4,0,2,10,8,2,12,mexico2
Toluca,6,3,2,1,13,10,3,11,mexico2
Queretaro,6,3,2,1,7,4,3,11,mexico2
Club Leon,6,2,3,1,7,5,2,9,mexico2
Cruz Azul,6,2,2,2,9,9,0,8,mexico2
Puebla,6,2,1,3,9,10,-1,7,mexico2
A. San Luis,6,2,1,3,6,7,-1,7,mexico2
Pumas UNAM,6,2,1,3,8,10,-2,7,mexico2
Necaxa,6,1,2,3,3,8,-5,5,mexico2
Tijuana,6,1,2,3,8,15,-7,5,mexico2
Tigres,6,1,1,4,4,9,-5,4,mexico2
Santos Laguna,6,1,1,4,6,14,-8,4,mexico2
Juarez,6,0,3,3,4,9,-5,3,mexico2
Mazatlan,6,1,0,5,6,13,-7,3,mexico2
SP Falcons,6,5,1,0,11,0,11,16,mongolia
Deren,6,4,2,0,19,6,13,14,mongolia
Tuv Buganuud,6,4,1,1,22,13,9,13,mongolia
FC Ulaanbaatar,6,4,0,2,14,4,10,12,mongolia
Khoromkhon,6,3,0,3,12,15,-3,9,mongolia
Khangarid,6,2,2,2,20,12,8,8,mongolia
Erchim,6,2,2,2,13,17,-4,8,mongolia
Bavarians,6,1,1,4,10,21,-11,4,mongolia
Bayanzurkh S.,6,1,0,5,5,20,-15,3,mongolia
Khovd,6,0,0,6,4,18,-14,0,mongolia
Buducnost,6,4,2,0,14,9,5,14,montenegro
Decic,6,3,2,1,6,3,3,11,montenegro
Jezero,6,2,3,1,7,3,4,9,montenegro
Sutjeska,6,2,3,1,7,6,1,9,montenegro
Mornar,6,2,2,2,8,8,0,8,montenegro
Mladost DG,6,2,1,3,6,7,-1,7,montenegro
Rudar,6,2,0,4,6,9,-3,6,montenegro
Petrovac,6,0,5,1,6,7,-1,5,montenegro
Jedinstvo,6,1,2,3,8,12,-4,5,montenegro
Arsenal Tivat,6,1,2,3,5,9,-4,5,montenegro
Raja Casablanca,6,4,2,0,12,3,9,14,morocco
FAR Rabat,6,4,1,1,13,6,7,13,morocco
Mouloudia Oujda,6,4,0,2,8,7,1,12,morocco
Berkane,6,2,4,0,9,4,5,10,morocco
Wydad,6,3,1,2,6,5,1,10,morocco
Olympic Safi,6,3,1,2,6,6,0,10,morocco
Hassania Agadir,6,2,2,2,6,6,0,8,morocco
R. Zemamra,6,2,1,3,6,6,0,7,morocco
FUS Rabat,6,1,4,1,5,5,0,7,morocco
C. Mohammedia,6,2,1,3,5,7,-2,7,morocco
Union Touarga,6,1,2,3,3,5,-2,5,morocco
Salmi,6,1,2,3,6,9,-3,5,morocco
Youssoufia B.,6,1,2,3,4,7,-3,5,morocco
Moghreb Tetouan,6,0,5,1,3,6,-3,5,morocco
Ittihad Tanger,6,0,5,1,4,9,-5,5,morocco
Maghreb de Fes,6,1,1,4,6,10,-4,4,morocco
Meknes,6,5,1,0,8,2,6,16,morocco2
R. Beni Mellal,6,3,3,0,9,2,7,12,morocco2
Stade Marocain,6,3,2,1,7,4,3,11,morocco2
Khouribga,6,3,2,1,5,3,2,11,morocco2
USM Oujda,6,2,3,1,7,3,4,9,morocco2
Kawkab M.,6,2,3,1,4,3,1,9,morocco2
Difaa El Jadida,6,3,0,3,6,8,-2,9,morocco2
Wydad F√®s,6,2,2,2,5,4,1,8,morocco2
Chabab Atlas K.,6,1,5,0,2,1,1,8,morocco2
C. Benguerir,6,1,4,1,4,4,0,7,morocco2
El Massira,6,2,0,4,7,9,-2,6,morocco2
RAC Casablanca,6,1,2,3,6,7,-1,5,morocco2
Rapide Oued Z.,6,0,4,2,4,7,-3,4,morocco2
Dcheira,6,0,4,2,2,6,-4,4,morocco2
AS Sal√©,6,1,1,4,7,14,-7,4,morocco2
Ittifaq M.,6,0,2,4,3,9,-6,2,morocco2
Shan Utd,6,5,1,0,16,7,9,16,myanmar
Yangon Utd,6,4,1,1,12,4,8,13,myanmar
Myawady,6,4,0,2,14,8,6,12,myanmar
Dagon,6,4,0,2,8,7,1,12,myanmar
Rakhine Utd,6,3,1,2,11,11,0,10,myanmar
Hantharwady,6,3,0,3,8,6,2,9,myanmar
Ispe FC,6,2,2,2,9,6,3,8,myanmar
Ayeyawady,6,2,2,2,7,7,0,8,myanmar
Sagaing Utd,6,2,1,3,7,12,-5,7,myanmar
Yadanarbon,6,1,1,4,5,13,-8,4,myanmar
Chinland,6,1,1,4,6,15,-9,4,myanmar
Kachin Utd,6,0,0,6,3,10,-7,0,myanmar
PSV Eindhoven,6,6,0,0,21,1,20,18,netherlands
Feyenoord,6,5,0,1,15,6,9,15,netherlands
Ajax Amsterdam,6,4,2,0,16,8,8,14,netherlands
NEC Nijmegen,6,3,2,1,14,9,5,11,netherlands
FC Utrecht,6,2,4,0,9,6,3,10,netherlands
Heerenveen,6,3,0,3,11,9,2,9,netherlands
FC Twente,6,2,3,1,13,12,1,9,netherlands
Fortuna Sittard,6,3,0,3,9,11,-2,9,netherlands
Go Ahead Eagles,6,2,2,2,9,8,1,8,netherlands
Sparta,6,2,1,3,10,9,1,7,netherlands
PEC Zwolle,6,2,1,3,11,11,0,7,netherlands
AZ Alkmaar,6,2,1,3,9,9,0,7,netherlands
Almere City,6,2,1,3,10,15,-5,7,netherlands
RKC Waalwijk,6,1,2,3,7,9,-2,5,netherlands
Excelsior,6,0,4,2,10,14,-4,4,netherlands
FC Volendam,6,1,1,4,7,19,-12,4,netherlands
Heracles Almelo,6,1,0,5,6,17,-11,3,netherlands
Vitesse Arnhem,6,1,0,5,5,21,-16,3,netherlands
Willem II,6,5,1,0,18,5,13,16,netherlands2
FC Groningen,6,5,1,0,14,4,10,16,netherlands2
NAC Breda,6,4,0,2,14,6,8,12,netherlands2
Jong Ajax,6,3,3,0,14,9,5,12,netherlands2
ADO Den Haag,6,3,2,1,16,8,8,11,netherlands2
FC Dordrecht,6,3,2,1,10,7,3,11,netherlands2
Roda JC,6,3,2,1,8,7,1,11,netherlands2
De Graafschap,6,3,1,2,10,7,3,10,netherlands2
MVV Maastricht,6,3,1,2,10,7,3,10,netherlands2
FC Eindhoven,6,2,3,1,13,10,3,9,netherlands2
Cambuur,6,2,2,2,10,11,-1,8,netherlands2
Jong AZ,6,2,1,3,5,13,-8,7,netherlands2
VVV,6,2,0,4,9,11,-2,6,netherlands2
FC Emmen,6,2,0,4,6,10,-4,6,netherlands2
FC Den Bosch,6,1,2,3,7,13,-6,5,netherlands2
TOP Oss,6,1,1,4,2,7,-5,4,netherlands2
Telstar,6,1,1,4,6,12,-6,4,netherlands2
Helmond Sport,6,1,1,4,10,17,-7,4,netherlands2
Jong PSV,6,0,2,4,4,12,-8,2,netherlands2
Jong Utrecht,6,0,2,4,4,15,-11,2,netherlands2
Real Esteli,6,4,2,0,13,2,11,14,nicaragua
Diriangen,6,4,1,1,7,4,3,13,nicaragua
O. Masachapa,6,3,1,2,9,11,-2,10,nicaragua
Export Sebaco,6,3,0,3,10,11,-1,9,nicaragua
D. Ocotal,6,2,2,2,7,6,1,8,nicaragua
UNAN Managua,6,2,2,2,5,10,-5,8,nicaragua
Matagalpa,6,2,1,3,11,9,2,7,nicaragua
Jalapa,6,1,3,2,8,8,0,6,nicaragua
Managua FC,6,1,2,3,5,10,-5,5,nicaragua
Walter Ferreti,6,0,2,4,1,5,-4,2,nicaragua
Cliftonville,6,5,1,0,17,5,12,16,northernireland
Linfield,6,5,1,0,12,5,7,16,northernireland
Larne,6,4,2,0,11,3,8,14,northernireland
Glentoran,6,3,1,2,10,7,3,10,northernireland
Crusaders,6,3,0,3,7,7,0,9,northernireland
Ballymena Utd,6,2,2,2,4,5,-1,8,northernireland
Carrick Rangers,6,2,1,3,6,7,-1,7,northernireland
Loughgall,6,2,1,3,10,12,-2,7,northernireland
Dungannon,6,2,0,4,14,14,0,6,northernireland
Glenavon,6,1,1,4,7,11,-4,4,northernireland
Coleraine,6,1,1,4,9,14,-5,4,northernireland
Newry City,6,0,2,4,1,12,-11,2,northernireland
Bangor,6,5,1,0,18,6,12,16,northernireland2
H&W Welders,6,4,1,1,15,9,6,13,northernireland2
Dundela,6,4,0,2,13,10,3,12,northernireland2
Annagh Utd,6,3,1,2,13,11,2,10,northernireland2
Ballyclare,6,3,0,3,10,9,1,9,northernireland2
Institute,6,2,2,2,10,9,1,8,northernireland2
Ballinamallard,6,2,1,3,8,6,2,7,northernireland2
Portadown,6,2,1,3,12,13,-1,7,northernireland2
Newington Youth,6,2,1,3,10,13,-3,7,northernireland2
Dergview,6,1,2,3,5,11,-6,5,northernireland2
Knockbreda,6,1,0,5,5,17,-12,3,northernireland2
Ards,6,0,2,4,9,18,-9,2,northernireland2
Struga,6,5,0,1,12,7,5,15,northmacedonia
Shkupi,6,4,1,1,6,2,4,13,northmacedonia
Skendija,6,3,1,2,9,6,3,10,northmacedonia
Gostivar,6,2,4,0,5,3,2,10,northmacedonia
Rabotnicki,6,3,1,2,5,5,0,10,northmacedonia
Voska Sport,6,2,2,2,8,10,-2,8,northmacedonia
Tikves,6,2,1,3,8,8,0,7,northmacedonia
Sileks,6,2,1,3,7,9,-2,7,northmacedonia
Makedonija,6,2,0,4,4,6,-2,6,northmacedonia
Vardar,6,2,0,4,7,10,-3,6,northmacedonia
A. Pandev,6,1,2,3,4,6,-2,5,northmacedonia
Bregalnica Stip,6,0,3,3,8,11,-3,3,northmacedonia
Bodo / Glimt,6,5,0,1,16,8,8,15,norway
Stromsgodset,6,5,0,1,11,3,8,15,norway
Tromso,6,4,1,1,13,8,5,13,norway
Brann,6,4,1,1,12,9,3,13,norway
Rosenborg,6,3,1,2,15,10,5,10,norway
Sandefjord,6,3,1,2,12,9,3,10,norway
Haugesund,6,3,0,3,13,6,7,9,norway
Odd,6,2,1,3,13,12,1,7,norway
Molde,6,2,1,3,12,12,0,7,norway
HamKam,6,2,1,3,5,8,-3,7,norway
Lillestrom,6,2,1,3,8,12,-4,7,norway
Viking,6,2,0,4,10,14,-4,6,norway
Stabaek,6,1,3,2,5,11,-6,6,norway
Valerenga,6,1,2,3,6,9,-3,5,norway
Sarpsborg 08,6,1,1,4,9,14,-5,4,norway
Aalesund,6,1,0,5,5,20,-15,3,norway
Kristiansund,6,5,0,1,17,5,12,15,norway2
KFUM Oslo,6,4,2,0,8,1,7,14,norway2
Fredrikstad,6,4,1,1,14,6,8,13,norway2
Bryne,6,4,0,2,7,5,2,12,norway2
Mjondalen,6,3,2,1,9,5,4,11,norway2
Asane,6,3,1,2,8,9,-1,10,norway2
Kongsvinger,6,3,0,3,12,9,3,9,norway2
Hodd,6,2,2,2,5,7,-2,8,norway2
Moss,6,2,1,3,9,8,1,7,norway2
Start,6,2,1,3,6,7,-1,7,norway2
Ranheim,6,2,1,3,7,10,-3,7,norway2
Sandnes Ulf,6,2,0,4,6,14,-8,6,norway2
Raufoss,6,1,2,3,2,6,-4,5,norway2
Sogndal,6,1,2,3,8,13,-5,5,norway2
Jerv,6,1,1,4,4,10,-6,4,norway2
Skeid,6,1,0,5,3,10,-7,3,norway2
Al Seeb,6,4,2,0,13,2,11,14,oman
Oman Club,6,4,1,1,7,2,5,13,oman
Al-Nahda,6,3,3,0,12,8,4,12,oman
Ibri,6,4,0,2,9,5,4,12,oman
Al Nasr,6,3,2,1,11,6,5,11,oman
Al-Shabab Club,6,2,2,2,8,8,0,8,oman
Sohar,6,2,2,2,7,7,0,8,oman
Dhofar,6,2,1,3,9,10,-1,7,oman
Al Wehda,6,2,0,4,4,12,-8,6,oman
Al-Rustaq,6,1,2,3,6,10,-4,5,oman
Sur,6,1,1,4,6,10,-4,4,oman
Bahla,6,0,1,5,1,12,-11,1,oman
San Miguelito,6,4,1,1,7,3,4,13,panama
UMECIT,6,4,1,1,7,4,3,13,panama
Plaza Amador,6,3,1,2,7,5,2,10,panama
Costa del Este,6,3,1,2,9,8,1,10,panama
Independiente,6,3,0,3,13,8,5,9,panama
San Francisco,6,2,3,1,3,4,-1,9,panama
Arabe Unido,6,2,2,2,5,3,2,8,panama
Alianza,6,2,2,2,5,7,-2,8,panama
Herrera,6,1,3,2,5,5,0,6,panama
Universitario,6,1,3,2,4,5,-1,6,panama
A. Chiriqui,6,1,1,4,5,12,-7,4,panama
Tauro,6,1,0,5,2,8,-6,3,panama
Independiente,6,6,0,0,21,7,14,18,panama2
San Francisco,6,5,0,1,15,5,10,15,panama2
San Miguelito,6,3,2,1,9,3,6,11,panama2
Arabe Unido,6,3,2,1,9,5,4,11,panama2
Tauro,6,3,2,1,7,6,1,11,panama2
Universitario,6,3,1,2,9,10,-1,10,panama2
Alianza,6,2,2,2,5,5,0,8,panama2
Herrera,6,2,1,3,16,10,6,7,panama2
UMECIT,6,2,0,4,11,12,-1,6,panama2
Plaza Amador,6,0,2,4,4,9,-5,2,panama2
Costa del Este,6,0,2,4,7,13,-6,2,panama2
A. Chiriqui,6,0,0,6,3,31,-28,0,panama2
2 de Mayo,0,0,0,0,0,0,0,0,paraguay
Cerro Porteno,0,0,0,0,0,0,0,0,paraguay
G. Caballero,0,0,0,0,0,0,0,0,paraguay
Guarani,0,0,0,0,0,0,0,0,paraguay
Libertad,0,0,0,0,0,0,0,0,paraguay
Nacional,0,0,0,0,0,0,0,0,paraguay
Olimpia,0,0,0,0,0,0,0,0,paraguay
S. Ameliano,0,0,0,0,0,0,0,0,paraguay
S. Luqueno,0,0,0,0,0,0,0,0,paraguay
S. Trinidense,0,0,0,0,0,0,0,0,paraguay
Sol de America,0,0,0,0,0,0,0,0,paraguay
Tacuary,0,0,0,0,0,0,0,0,paraguay
Tacuary,6,4,2,0,11,4,7,14,paraguay2
Libertad,6,3,2,1,11,6,5,11,paraguay2
Nacional,6,2,4,0,10,4,6,10,paraguay2
Cerro Porteno,6,2,4,0,9,3,6,10,paraguay2
Olimpia,6,3,1,2,5,5,0,10,paraguay2
S. Trinidense,6,2,2,2,12,7,5,8,paraguay2
S. Ameliano,6,2,2,2,8,6,2,8,paraguay2
Guarani,6,2,2,2,3,6,-3,8,paraguay2
Guairena,6,1,3,2,8,11,-3,6,paraguay2
S. Luqueno,6,1,2,3,5,8,-3,5,paraguay2
G. Caballero,6,1,2,3,2,7,-5,5,paraguay2
Resistencia,6,0,0,6,3,20,-17,0,paraguay2
S. Cristal,6,5,1,0,16,6,10,16,peru
FBC Melgar,6,4,1,1,12,9,3,13,peru
Alianza Lima,6,4,0,2,15,8,7,12,peru
Sport Huancayo,6,4,0,2,10,5,5,12,peru
Sport Boys,6,3,1,2,6,6,0,10,peru
Universitario,6,3,0,3,9,5,4,9,peru
D. Garcilaso,6,2,3,1,12,10,2,9,peru
Binacional,6,3,0,3,11,9,2,9,peru
Cusco,6,3,0,3,7,8,-1,9,peru
Atletico Grau,6,2,1,3,11,7,4,7,peru
Alianza A.,6,2,1,3,11,13,-2,7,peru
Cienciano,6,2,1,3,9,12,-3,7,peru
Cajamarca,6,2,1,3,7,12,-5,7,peru
ADT,6,1,3,2,8,9,-1,6,peru
D. Municipal,6,2,0,4,5,7,-2,6,peru
AD Cantolao,6,1,3,2,3,6,-3,6,peru
Union Comercio,6,1,3,2,10,19,-9,6,peru
Cesar Vallejo,6,1,2,3,6,12,-6,5,peru
Carlos Manucci,6,1,1,4,3,10,-7,4,peru
FBC Melgar,6,5,1,0,12,3,9,16,peru2
Universitario,6,4,2,0,10,1,9,14,peru2
Alianza Lima,6,4,2,0,8,3,5,14,peru2
ADT,6,3,3,0,7,2,5,12,peru2
Cesar Vallejo,6,3,1,2,9,4,5,10,peru2
Cienciano,6,3,1,2,10,8,2,10,peru2
S. Cristal,6,3,1,2,8,6,2,10,peru2
D. Municipal,6,3,0,3,10,11,-1,9,peru2
Sport Huancayo,6,2,2,2,3,4,-1,8,peru2
Alianza A.,6,2,1,3,5,7,-2,7,peru2
Sport Boys,6,2,1,3,5,9,-4,7,peru2
Atletico Grau,6,1,3,2,5,4,1,6,peru2
Cajamarca,6,1,3,2,10,11,-1,6,peru2
Cusco,6,1,2,3,7,9,-2,5,peru2
Carlos Manucci,6,1,2,3,6,8,-2,5,peru2
Union Comercio,6,1,2,3,5,10,-5,5,peru2
D. Garcilaso,6,1,2,3,2,7,-5,5,peru2
Binacional,6,1,1,4,7,10,-3,4,peru2
AD Cantolao,6,1,1,4,2,8,-6,4,peru2
Santa Rosa,6,4,1,1,23,6,17,13,peru3
D. Coopsol,6,4,1,1,10,5,5,13,peru3
Llacuabamba,6,3,2,1,11,4,7,11,peru3
Comerciantes U.,6,3,2,1,10,5,5,11,peru3
A. Huanuco,6,3,2,1,6,2,4,11,peru3
Santos FC,6,3,1,2,12,6,6,10,peru3
Comerciantes,6,3,1,2,7,8,-1,10,peru3
Ayacucho,6,2,3,1,14,7,7,9,peru3
U. San Martin,6,2,1,3,6,8,-2,7,peru3
Juan Aurich,6,1,3,2,6,6,0,6,peru3
Huaral,6,1,1,4,4,8,-4,4,peru3
Alfonso Ugarte,6,1,1,4,5,15,-10,4,peru3
Carlos Stein,6,1,1,4,6,21,-15,4,peru3
M. El Pirata,6,1,0,5,5,24,-19,3,peru3
Kaya,6,5,1,0,21,7,14,16,philippines
Cebu FC,6,4,2,0,10,2,8,14,philippines
United City,6,3,2,1,10,7,3,11,philippines
Stallion,6,3,1,2,8,4,4,10,philippines
Mendiola,6,3,0,3,9,12,-3,9,philippines
Maharlika,6,1,0,5,6,14,-8,3,philippines
Azkals,6,0,0,6,0,18,-18,0,philippines
Slask Wroclaw,6,4,2,0,7,3,4,14,poland
Jagiellonia,6,3,3,0,15,8,7,12,poland
Piast Gliwice,6,2,4,0,8,4,4,10,poland
Gornik Zabrze,6,3,1,2,8,5,3,10,poland
Puszcza Niepolo,6,3,1,2,11,11,0,10,poland
Stal Mielec,6,3,1,2,10,13,-3,10,poland
Rakow C.,6,2,3,1,11,7,4,9,poland
Legia Warsaw,6,2,3,1,8,5,3,9,poland
Pogon Szczecin,6,2,2,2,10,9,1,8,poland
Lech Poznan,6,2,2,2,6,6,0,8,poland
Widzew Lodz,6,2,1,3,7,9,-2,7,poland
Radomiak Radom,6,1,3,2,6,5,1,6,poland
Cracovia Krakow,6,1,3,2,9,10,-1,6,poland
Ruch Chorzow,6,0,5,1,9,10,-1,5,poland
Warta Poznan,6,1,2,3,7,12,-5,5,poland
Zaglebie Lubin,6,1,2,3,6,13,-7,5,poland
Korona Kielce,6,0,4,2,3,5,-2,4,poland
LKS Lodz,6,0,3,3,6,14,-8,3,poland
Motor Lublin,6,4,1,1,12,5,7,13,poland2
Wisla Plock,6,4,1,1,10,5,5,13,poland2
Chrobry Glogow,6,4,0,2,8,6,2,12,poland2
Tychy,6,4,0,2,8,6,2,12,poland2
Znicz Pruszkow,6,4,0,2,5,3,2,12,poland2
Wisla Krakow,6,3,2,1,10,5,5,11,poland2
Arka Gdynia,6,3,2,1,7,4,3,11,poland2
Lechia Gdansk,6,3,1,2,6,3,3,10,poland2
Stal Rzeszow,6,2,3,1,10,8,2,9,poland2
Katowice,6,2,2,2,10,9,1,8,poland2
T. Nieciecza,6,2,2,2,10,10,0,8,poland2
Podbeskidzie,6,2,1,3,4,7,-3,7,poland2
Miedz Legnica,6,1,3,2,6,7,-1,6,poland2
Resovia Rzeszow,6,2,0,4,7,9,-2,6,poland2
Gornik Leczna,6,1,2,3,3,10,-7,5,poland2
Odra Opole,6,1,1,4,4,8,-4,4,poland2
Polonia Warszaw,6,0,3,3,4,9,-5,3,poland2
Z. Sosnowiec,6,0,1,5,2,13,-11,1,poland2
K. Kolobrzeg,6,4,1,1,16,12,4,13,poland3
Lech Poznan B,6,4,1,1,9,6,3,13,poland3
Stalowa Wola,6,4,0,2,10,9,1,12,poland3
Zaglebie L. B,6,3,1,2,13,9,4,10,poland3
Kalisz,6,3,1,2,13,11,2,10,poland3
Pogon Siedlce,6,3,1,2,10,9,1,10,poland3
Radunia Stezyca,6,3,1,2,6,8,-2,10,poland3
Hutnik Krakow,6,3,0,3,13,13,0,9,poland3
Polonia Bytom,6,2,2,2,10,10,0,8,poland3
Chojniczanka,6,2,2,2,9,9,0,8,poland3
Jastrzebie,6,2,2,2,9,11,-2,8,poland3
Sandecja Nowy,6,2,2,2,8,10,-2,8,poland3
SKRA Czestochow,6,2,1,3,12,10,2,7,poland3
Olimpia Elblag,6,2,1,3,9,8,1,7,poland3
LKS Lodz B,6,2,1,3,9,10,-1,7,poland3
Stomil Olsztyn,6,2,0,4,5,8,-3,6,poland3
Wisla Pulawy,6,0,4,2,9,11,-2,4,poland3
O. Grudziadz,6,1,1,4,6,9,-3,4,poland3
Sporting Braga,6,5,0,1,16,5,11,15,portugal
Benfica,6,4,2,0,9,2,7,14,portugal
FC Porto,6,4,1,1,10,5,5,13,portugal
Sporting CP,6,4,0,2,15,8,7,12,portugal
Moreirense,6,3,3,0,8,3,5,12,portugal
Arouca,6,3,1,2,13,6,7,10,portugal
Estoril,6,3,1,2,15,9,6,10,portugal
Guimaraes,6,3,1,2,8,7,1,10,portugal
Farense,6,2,2,2,7,8,-1,8,portugal
Rio Ave,6,1,4,1,7,6,1,7,portugal
Vizela,6,1,3,2,4,6,-2,6,portugal
Famalicao,6,1,3,2,5,9,-4,6,portugal
Casa Pia,6,2,0,4,6,12,-6,6,portugal
Estrela Amadora,6,1,2,3,7,10,-3,5,portugal
Gil Vicente,6,1,2,3,5,11,-6,5,portugal
Portimonense,6,1,1,4,7,16,-9,4,portugal
Chaves,6,1,0,5,4,13,-9,3,portugal
Boavista,6,0,2,4,4,13,-9,2,portugal
Santa Clara,6,5,1,0,11,5,6,16,portugal2
Nacional,6,5,0,1,14,5,9,15,portugal2
Tondela,6,4,1,1,10,5,5,13,portugal2
AVS,6,4,0,2,9,5,4,12,portugal2
Academico Viseu,6,3,2,1,7,6,1,11,portugal2
Maritimo,6,3,1,2,8,4,4,10,portugal2
Torreense,6,2,3,1,5,3,2,9,portugal2
Mafra,6,2,2,2,7,7,0,8,portugal2
Feirense,6,2,2,2,5,6,-1,8,portugal2
Penafiel,6,2,1,3,5,8,-3,7,portugal2
Os Belenense,6,2,1,3,4,9,-5,7,portugal2
FC Porto B,6,2,0,4,13,12,1,6,portugal2
Benfica B,6,1,3,2,6,7,-1,6,portugal2
Uniao de Leiria,6,1,3,2,3,4,-1,6,portugal2
Vilaverdense,6,2,0,4,4,10,-6,6,portugal2
Pacos Ferreira,6,1,2,3,6,10,-4,5,portugal2
Leixoes,6,0,3,3,1,4,-3,3,portugal2
Oliveirense,6,0,2,4,3,9,-6,2,portugal2
Al Sadd,6,5,0,1,22,2,20,15,qatar
Al Gharafa,6,4,2,0,15,11,4,14,qatar
Al Wakrah,6,4,1,1,13,9,4,13,qatar
Al Arabi,6,3,2,1,13,8,5,11,qatar
Al Ahli Doha,6,3,0,3,13,14,-1,9,qatar
Al Shamal,6,2,2,2,6,8,-2,8,qatar
Al Rayyan,6,2,1,3,15,11,4,7,qatar
Qatar SC,6,2,1,3,9,8,1,7,qatar
Umm Salal,6,2,1,3,7,12,-5,7,qatar
Al Duhail,6,1,1,4,10,15,-5,4,qatar
Al Muaidar,6,0,2,4,7,14,-7,2,qatar
Al Markhiya,6,0,1,5,1,22,-21,1,qatar
FCSB,6,4,1,1,10,5,5,13,romania
U Craiova 1948,6,4,0,2,9,5,4,12,romania
Univ. Craiova,6,3,2,1,10,7,3,11,romania
Sepsi OSK,6,3,2,1,9,7,2,11,romania
U. Cluj,6,3,1,2,6,8,-2,10,romania
Farul Constanta,6,2,3,1,9,8,1,9,romania
Otelul,6,3,0,3,10,10,0,9,romania
Voluntari,6,2,2,2,9,8,1,8,romania
CFR Cluj,6,1,3,2,9,7,2,6,romania
UTA Arad,6,1,3,2,6,7,-1,6,romania
Din. Bucharest,6,2,0,4,4,5,-1,6,romania
P. Iasi,6,1,3,2,9,11,-2,6,romania
Petrolul,6,1,3,2,3,6,-3,6,romania
Hermannstadt,6,1,3,2,4,8,-4,6,romania
Botosani,6,1,2,3,6,9,-3,5,romania
Rapid Bucharest,6,0,4,2,3,5,-2,4,romania
Rubin Kazan,6,5,0,1,6,1,5,15,russia
Dinamo Moscow,6,4,2,0,12,7,5,14,russia
Zenit,6,4,1,1,10,5,5,13,russia
Lokomotiv M.,6,3,2,1,11,7,4,11,russia
Spartak Moscow,6,3,1,2,9,6,3,10,russia
CSKA Moscow,6,3,1,2,9,7,2,10,russia
FC Krasnodar,6,3,1,2,7,7,0,10,russia
Fakel Voronezh,6,2,3,1,6,4,2,9,russia
Krylya Sovetov,6,2,2,2,10,10,0,8,russia
Rostov,6,2,2,2,4,5,-1,8,russia
Nizhny Novgorod,6,2,1,3,4,5,-1,7,russia
Akhmat Grozny,6,1,2,3,6,8,-2,5,russia
Orenburg,6,0,4,2,5,8,-3,4,russia
Ural,6,1,0,5,5,10,-5,3,russia
Baltika,6,0,2,4,0,6,-6,2,russia
PFC Sochi,6,0,2,4,4,12,-8,2,russia
Arsenal Tula,6,5,1,0,12,2,10,16,russia2
Khimki,6,3,3,0,12,6,6,12,russia2
Tyumen,6,4,0,2,9,4,5,12,russia2
Rodina Moskva,6,3,2,1,11,3,8,11,russia2
Akron,6,3,2,1,10,6,4,11,russia2
Makhachkala,6,3,1,2,6,4,2,10,russia2
V. Astrakhan,6,3,1,2,6,6,0,10,russia2
Yenisey,6,3,0,3,13,11,2,9,russia2
Torpedo Moscow,6,2,3,1,6,5,1,9,russia2
Leningradets,6,3,0,3,6,6,0,9,russia2
Neftekhimik,6,2,2,2,3,4,-1,8,russia2
Urozhay,6,2,2,2,8,10,-2,8,russia2
Kamaz,6,1,3,2,6,9,-3,6,russia2
SKA Khabarovsk,6,1,2,3,3,7,-4,5,russia2
A. Vladikavkaz,6,0,4,2,7,11,-4,4,russia2
Shinnik,6,0,4,2,8,13,-5,4,russia2
Chernomorets,6,0,1,5,3,12,-9,1,russia2
Sokol Saratov,6,0,1,5,4,14,-10,1,russia2
Al Hilal,6,6,0,0,25,1,24,18,saudiarabia
Al Nassr,6,5,0,1,19,8,11,15,saudiarabia
Damak,6,5,0,1,15,6,9,15,saudiarabia
Al Ahli Jeddah,6,4,2,0,15,0,15,14,saudiarabia
Al Raed,6,3,1,2,12,9,3,10,saudiarabia
Al Akhdoud,6,3,1,2,3,5,-2,10,saudiarabia
Al Khaleej,6,3,0,3,10,9,1,9,saudiarabia
Al Wahda,6,3,0,3,8,7,1,9,saudiarabia
Al Taawon,6,3,0,3,11,11,0,9,saudiarabia
Al Ittihad,6,2,1,3,13,16,-3,7,saudiarabia
Al Riyadh,6,2,1,3,5,9,-4,7,saudiarabia
Al Shabab,6,1,3,2,3,4,-1,6,saudiarabia
Al Tai,6,2,0,4,7,12,-5,6,saudiarabia
Al Hazm,6,1,3,2,4,15,-11,6,saudiarabia
Al Fateh,6,1,2,3,4,6,-2,5,saudiarabia
Al Ittifaq,6,0,3,3,3,8,-5,3,saudiarabia
Al Feiha,6,1,0,5,4,17,-13,3,saudiarabia
Abha,6,0,1,5,7,25,-18,1,saudiarabia
Al Quadisiya,6,4,2,0,16,5,11,14,saudiarabia2
Al Kholood,6,4,2,0,11,4,7,14,saudiarabia2
Al Arabi,6,4,1,1,11,3,8,13,saudiarabia2
Al Jabalain,6,4,1,1,10,6,4,13,saudiarabia2
Al Batin,6,4,0,2,7,7,0,12,saudiarabia2
Al-Jndal,6,3,1,2,8,6,2,10,saudiarabia2
Al Najma,6,3,1,2,10,9,1,10,saudiarabia2
Ohod,6,2,3,1,5,4,1,9,saudiarabia2
Jeddah,6,2,2,2,12,13,-1,8,saudiarabia2
Al-Ain,6,1,4,1,9,8,1,7,saudiarabia2
Al Qaisoma,6,2,1,3,10,13,-3,7,saudiarabia2
Al Faisaly,6,2,1,3,9,14,-5,7,saudiarabia2
Al Adalh,6,0,5,1,6,7,-1,5,saudiarabia2
Hajer,6,0,5,1,6,9,-3,5,saudiarabia2
Al Safa,6,1,2,3,5,9,-4,5,saudiarabia2
Al Orubah,6,1,0,5,6,13,-7,3,saudiarabia2
Al Bukayriyah,6,0,2,4,6,11,-5,2,saudiarabia2
Al Taraji,6,0,1,5,2,8,-6,1,saudiarabia2
Rangers,6,5,0,1,12,4,8,15,scotland
Hearts,6,4,1,1,10,5,5,13,scotland
Celtic,6,4,0,2,11,5,6,12,scotland
Kilmarnock,6,3,2,1,8,7,1,11,scotland
Aberdeen,6,3,0,3,7,8,-1,9,scotland
St. Johnstone,6,2,2,2,4,5,-1,8,scotland
St. Mirren,6,2,1,3,5,6,-1,7,scotland
Hibernian,6,2,1,3,6,8,-2,7,scotland
Ross County,6,2,1,3,6,8,-2,7,scotland
Motherwell,6,1,3,2,6,9,-3,6,scotland
Dundee FC,6,1,2,3,8,13,-5,5,scotland
Livingston,6,0,2,4,3,9,-6,2,scotland
Greenock Morton,6,4,2,0,8,2,6,14,scotland2
Raith Rovers,6,4,2,0,15,11,4,14,scotland2
Dundee Utd,6,4,1,1,9,2,7,13,scotland2
Partick Thistle,6,3,1,2,11,12,-1,10,scotland2
Airdrieonians,6,2,1,3,6,6,0,7,scotland2
Inverness,6,1,2,3,7,8,-1,5,scotland2
Dunfermline,6,1,2,3,8,10,-2,5,scotland2
Arbroath,6,1,2,3,7,11,-4,5,scotland2
Ayr Utd,6,1,2,3,8,13,-5,5,scotland2
Queen`s Park,6,1,1,4,6,11,-5,4,scotland2
Falkirk,6,5,1,0,15,3,12,16,scotland3
Cove Rangers,6,4,1,1,16,7,9,13,scotland3
Hamilton,6,3,2,1,14,7,7,11,scotland3
Alloa Athletic,6,3,2,1,7,6,1,11,scotland3
Queen of South,6,3,1,2,11,12,-1,10,scotland3
Montrose,6,1,3,2,5,8,-3,6,scotland3
Kelty Hearts,6,1,2,3,7,8,-1,5,scotland3
Stirling Albion,6,1,2,3,6,16,-10,5,scotland3
Edinburgh City,6,1,0,5,10,20,-10,3,scotland3
Annan Athletic,6,0,2,4,5,12,-7,2,scotland3
Stenhousemuir,6,6,0,0,11,2,9,18,scotland4
Dumbarton,6,4,1,1,14,7,7,13,scotland4
Spartans,6,4,0,2,13,6,7,12,scotland4
East Fife,6,2,1,3,11,9,2,7,scotland4
Bonnyrigg Rose,6,2,1,3,9,9,0,7,scotland4
Peterhead,6,2,1,3,7,9,-2,7,scotland4
Elgin City,6,2,0,4,3,12,-9,6,scotland4
Forfar Athletic,6,1,2,3,5,8,-3,5,scotland4
Stranraer,6,1,2,3,8,13,-5,5,scotland4
Clyde,6,0,3,3,9,15,-6,3,scotland4
Red Star,6,5,0,1,13,6,7,15,serbia
Cukaricki,6,4,0,2,11,4,7,12,serbia
Novi Pazar,6,4,0,2,9,3,6,12,serbia
Backa Topola,6,3,2,1,10,3,7,11,serbia
Vozdovac,6,3,1,2,13,11,2,10,serbia
Partizan,6,3,1,2,11,12,-1,10,serbia
Vojvodina,6,3,0,3,9,9,0,9,serbia
S. Subotica,6,3,0,3,5,8,-3,9,serbia
Radnicki 1923,6,2,2,2,8,11,-3,8,serbia
Javor Ivanjica,6,2,1,3,8,8,0,7,serbia
Napredak,6,2,1,3,5,7,-2,7,serbia
Z. Pancevo,6,2,1,3,7,11,-4,7,serbia
Mladost Lucani,6,2,1,3,5,9,-4,7,serbia
IMT N. Beograd,6,2,1,3,3,7,-4,7,serbia
Radnicki Nis,6,1,1,4,3,7,-4,4,serbia
R. Surdulica,6,0,2,4,4,8,-4,2,serbia
OFK Beograd,6,5,0,1,9,3,6,15,serbia2
Indija,6,4,0,2,8,5,3,12,serbia2
Jedinstvo Ub,6,3,2,1,10,7,3,11,serbia2
Metalac GM,6,3,2,1,9,6,3,11,serbia2
Dubocica,6,3,2,1,7,5,2,11,serbia2
Tekstilac Odzac,6,3,1,2,10,5,5,10,serbia2
Graficar,6,3,1,2,10,9,1,10,serbia2
Macva Sabac,6,3,0,3,5,5,0,9,serbia2
Smederevo,6,2,2,2,6,6,0,8,serbia2
S. Mitrovica,6,2,2,2,4,4,0,8,serbia2
OFK Vr¬öac,6,2,1,3,5,8,-3,7,serbia2
Mladost Novi S.,6,1,3,2,4,7,-3,6,serbia2
Kolubara,6,1,2,3,7,7,0,5,serbia2
Radnicki B.,6,1,2,3,9,15,-6,5,serbia2
Sloboda Uzice,6,0,2,4,0,5,-5,2,serbia2
Novi Sad,6,0,2,4,4,10,-6,2,serbia2
A. Niigata (S),6,6,0,0,30,7,23,18,singapore
Lion City,6,5,0,1,25,12,13,15,singapore
Hougang,6,3,1,2,15,19,-4,10,singapore
Geylang,6,3,0,3,12,18,-6,9,singapore
Tampines Rovers,6,2,1,3,15,19,-4,7,singapore
Tanjong Pagar,6,1,3,2,13,14,-1,6,singapore
Khalsa,6,2,0,4,14,20,-6,6,singapore
DPMM FC,6,1,2,3,8,9,-1,5,singapore
Young Lions,6,0,0,6,6,22,-16,0,singapore
S. Bratislava,6,5,1,0,17,4,13,16,slovakia
Spartak Trnava,6,5,0,1,8,2,6,15,slovakia
Zilina,6,4,1,1,7,5,2,13,slovakia
Banska Bystrica,6,3,1,2,11,8,3,10,slovakia
DAC Streda,6,2,3,1,8,3,5,9,slovakia
Ruzomberok,6,2,3,1,8,7,1,9,slovakia
Skalica,6,2,1,3,5,7,-2,7,slovakia
Trencin,6,1,3,2,5,4,1,6,slovakia
Podbrezova,6,2,0,4,6,14,-8,6,slovakia
FC Kosice,6,1,2,3,5,10,-5,5,slovakia
Z. Michalovce,6,0,2,4,3,9,-6,2,slovakia
Zlate Moravce,6,0,1,5,3,13,-10,1,slovakia
Petrzalka,6,5,1,0,16,6,10,16,slovakia2
P. Bystrica,6,4,2,0,12,4,8,14,slovakia2
Tatran Presov,6,4,2,0,9,1,8,14,slovakia2
Komarno,6,4,1,1,7,4,3,13,slovakia2
Futura Humenne,6,3,2,1,10,6,4,11,slovakia2
Zilina B,6,3,1,2,13,7,6,10,slovakia2
Samorin,6,3,1,2,18,13,5,10,slovakia2
Pohronie,6,3,1,2,16,12,4,10,slovakia2
OFK Malzenice,6,3,1,2,12,8,4,10,slovakia2
L. Mikulas,6,2,1,3,10,13,-3,7,slovakia2
Slavoj Trebisov,6,1,2,3,7,8,-1,5,slovakia2
S. Bratislava B,6,1,1,4,8,16,-8,4,slovakia2
Spartak Myjava,6,1,1,4,7,15,-8,4,slovakia2
Dolny Kubin,6,1,1,4,5,14,-9,4,slovakia2
Puchov,6,1,0,5,7,22,-15,3,slovakia2
Spisska Nova V.,6,0,0,6,5,13,-8,0,slovakia2
NK Celje,6,5,0,1,12,2,10,15,slovenia
NK Olimpija,6,4,1,1,10,6,4,13,slovenia
Domzale,6,4,0,2,12,4,8,12,slovenia
Mura,6,3,1,2,5,4,1,10,slovenia
Maribor,6,2,3,1,10,8,2,9,slovenia
Bravo,6,2,2,2,7,8,-1,8,slovenia
Aluminij,6,2,1,3,6,12,-6,7,slovenia
Koper,6,1,1,4,8,13,-5,4,slovenia
Radomlje,6,1,1,4,5,14,-9,4,slovenia
Rogaska,6,1,0,5,7,11,-4,3,slovenia
Stellenbosch,6,5,1,0,10,3,7,16,southafrica
Mamelodi S.,6,4,2,0,9,1,8,14,southafrica
Cape Town City,6,4,1,1,7,2,5,13,southafrica
Kaizer Chiefs,6,4,1,1,7,4,3,13,southafrica
AmaZulu,6,3,1,2,8,4,4,10,southafrica
Orlando Pirates,6,3,1,2,8,7,1,10,southafrica
Royal AM,6,3,1,2,6,8,-2,10,southafrica
TS Galaxy,6,3,0,3,9,5,4,9,southafrica
Richards Bay,6,2,1,3,7,7,0,7,southafrica
Sekhukhune,6,2,1,3,5,6,-1,7,southafrica
SuperSport Utd,6,2,1,3,8,10,-2,7,southafrica
Polokwane,6,1,3,2,3,6,-3,6,southafrica
Moroka Swallows,6,1,2,3,2,5,-3,5,southafrica
Chippa Utd,6,1,1,4,4,8,-4,4,southafrica
Cape Town Spurs,6,0,1,5,2,12,-10,1,southafrica
Golden Arrows,6,0,0,6,2,11,-9,0,southafrica
Pretoria U.,6,4,2,0,11,4,7,14,southafrica2
Upington City,6,4,1,1,10,4,6,13,southafrica2
Baroka,6,3,1,2,9,6,3,10,southafrica2
Milford,6,3,1,2,7,7,0,10,southafrica2
Black Leopards,6,3,1,2,10,11,-1,10,southafrica2
Casric Stars,6,2,3,1,15,9,6,9,southafrica2
NB La Masia,6,2,3,1,9,7,2,9,southafrica2
Magesi,6,2,3,1,9,8,1,9,southafrica2
Pretoria C.,6,3,0,3,11,11,0,9,southafrica2
Hungry Lions,6,2,2,2,8,8,0,8,southafrica2
Orbit College,6,2,2,2,8,11,-3,8,southafrica2
Platinum City,6,2,1,3,4,6,-2,7,southafrica2
Venda FC,6,1,2,3,6,10,-4,5,southafrica2
JDR Stars,6,1,1,4,7,11,-4,4,southafrica2
Tshakhuma,6,1,1,4,10,15,-5,4,southafrica2
Maritzburg Utd,6,0,2,4,6,12,-6,2,southafrica2
Jeonbuk Motors,6,3,2,1,8,4,4,11,southkorea
Suwon Bluewings,6,3,2,1,7,6,1,11,southkorea
Ulsan,6,3,1,2,7,6,1,10,southkorea
Incheon Utd,6,2,3,1,8,5,3,9,southkorea
Daejeon Citizen,6,2,3,1,8,6,2,9,southkorea
Gangwon,6,2,2,2,5,4,1,8,southkorea
Seoul,6,2,2,2,8,9,-1,8,southkorea
Gwangju,6,2,2,2,3,5,-2,8,southkorea
Pohang Steelers,6,1,3,2,5,6,-1,6,southkorea
Jeju Utd,6,1,3,2,4,5,-1,6,southkorea
Daegu,6,1,2,3,6,9,-3,5,southkorea
Suwon City,6,0,3,3,9,13,-4,3,southkorea
Gimcheon Sangmu,6,5,1,0,17,6,11,16,southkorea2
Gyeongnam,6,3,2,1,10,6,4,11,southkorea2
Anyang,6,3,2,1,10,8,2,11,southkorea2
Busan IPark,6,3,2,1,6,6,0,11,southkorea2
Jeonnam Dragons,6,3,0,3,12,11,1,9,southkorea2
Chungnam Asan,6,3,0,3,7,7,0,9,southkorea2
Bucheon FC,6,2,2,2,8,7,1,8,southkorea2
Gimpo,6,2,2,2,6,5,1,8,southkorea2
Seongnam,6,2,1,3,6,7,-1,7,southkorea2
Cheongju,6,1,3,2,5,8,-3,6,southkorea2
Cheonan City,6,1,2,3,5,8,-3,5,southkorea2
Ansan Greeners,6,1,1,4,12,18,-6,4,southkorea2
Seoul E-Land,6,0,0,6,4,14,-10,0,southkorea2
Real Madrid,6,5,1,0,12,2,10,16,spain
Athletic Bilbao,6,4,2,0,11,2,9,14,spain
Girona,6,4,2,0,15,8,7,14,spain
FC Barcelona,6,3,2,1,10,9,1,11,spain
Real Sociedad,6,2,4,0,7,3,4,10,spain
Getafe,6,3,1,2,9,8,1,10,spain
Celta Vigo,6,2,3,1,6,5,1,9,spain
Mallorca,6,2,3,1,5,4,1,9,spain
Valencia,6,2,2,2,6,5,1,8,spain
Osasuna,6,2,2,2,7,8,-1,8,spain
Las Palmas,6,2,1,3,5,5,0,7,spain
Real Betis,6,1,4,1,4,4,0,7,spain
Atletico Madrid,6,2,1,3,9,11,-2,7,spain
Villarreal,6,2,1,3,9,14,-5,7,spain
Cadiz,6,0,5,1,4,6,-2,5,spain
Alaves,6,1,2,3,4,7,-3,5,spain
Rayo Vallecano,6,1,2,3,3,7,-4,5,spain
Sevilla FC,6,1,1,4,4,8,-4,4,spain
Granada,6,1,1,4,4,10,-6,4,spain
Almeria,6,0,2,4,4,8,-4,2,spain
Racing,6,3,3,0,13,7,6,12,spain2
Racing Ferrol,6,3,2,1,12,9,3,11,spain2
Real Oviedo,6,3,2,1,11,8,3,11,spain2
Burgos,6,2,4,0,8,4,4,10,spain2
Mirandes,6,2,4,0,6,3,3,10,spain2
Huesca,6,3,0,3,7,4,3,9,spain2
Espanyol,6,2,3,1,9,7,2,9,spain2
Albacete,6,2,2,2,9,9,0,8,spain2
Tenerife,6,2,2,2,7,7,0,8,spain2
Levante,6,2,2,2,9,11,-2,8,spain2
Villarreal B,6,2,2,2,3,5,-2,8,spain2
Cartagena,6,2,2,2,5,9,-4,8,spain2
Sporting Gijon,6,1,4,1,4,3,1,7,spain2
Elche,6,2,1,3,7,7,0,7,spain2
Valladolid,6,2,1,3,5,6,-1,7,spain2
FC Andorra,6,1,4,1,4,5,-1,7,spain2
Alcorcon,6,2,1,3,3,6,-3,7,spain2
Real Zaragoza,6,1,3,2,5,7,-2,6,spain2
Eibar,6,1,2,3,7,8,-1,5,spain2
Leganes,6,0,5,1,6,7,-1,5,spain2
Amorebieta,6,1,1,4,5,8,-3,4,spain2
Eldense,6,0,4,2,7,12,-5,4,spain2
Sirius,6,5,1,0,15,8,7,16,sweden
Elfsborg,6,4,1,1,12,5,7,13,sweden
Varnamo,6,4,1,1,12,8,4,13,sweden
Malmo FF,6,4,0,2,11,6,5,12,sweden
Hacken,6,3,1,2,14,9,5,10,sweden
Djurgarden,6,3,1,2,7,7,0,10,sweden
Kalmar,6,3,0,3,7,9,-2,9,sweden
AIK,6,2,2,2,6,8,-2,8,sweden
Halmstad,6,1,4,1,7,5,2,7,sweden
Mjallby,6,2,1,3,8,9,-1,7,sweden
Hammarby,6,0,6,0,7,7,0,6,sweden
Brommapojkarna,6,2,0,4,8,12,-4,6,sweden
Norrkoping,6,2,0,4,7,12,-5,6,sweden
IFK Goteborg,6,1,2,3,6,9,-3,5,sweden
Degerfors,6,0,3,3,7,11,-4,3,sweden
Varberg BoIS,6,0,1,5,6,15,-9,1,sweden
GAIS,6,4,0,2,12,4,8,12,sweden2
Brage,6,4,0,2,13,6,7,12,sweden2
Oster,6,4,0,2,11,4,7,12,sweden2
Vasteras,6,4,0,2,9,5,4,12,sweden2
Skovde AIK,6,3,2,1,12,8,4,11,sweden2
Ostersunds,6,3,1,2,10,8,2,10,sweden2
Orgryte,6,3,1,2,6,6,0,10,sweden2
Utsikten,6,2,3,1,6,6,0,9,sweden2
Helsingborg,6,2,2,2,6,3,3,8,sweden2
GIF Sundsvall,6,2,2,2,6,9,-3,8,sweden2
AFC Eskilstuna,6,1,3,2,7,9,-2,6,sweden2
Trelleborg,6,1,3,2,5,12,-7,6,sweden2
Landskrona,6,1,2,3,7,12,-5,5,sweden2
Gefle,6,0,4,2,5,8,-3,4,sweden2
Orebro,6,1,0,5,8,15,-7,3,sweden2
Jonkopings,6,0,3,3,6,14,-8,3,sweden2
BSC Young Boys,6,4,1,1,15,6,9,13,switzerland
Servette,6,3,3,0,12,5,7,12,switzerland
St. Gallen,6,4,0,2,14,9,5,12,switzerland
Grasshopper,6,3,1,2,12,7,5,10,switzerland
Lugano,6,3,1,2,11,9,2,10,switzerland
FC Basel,6,3,1,2,8,7,1,10,switzerland
Lausanne Sport,6,2,2,2,7,10,-3,8,switzerland
FC Zurich,6,2,1,3,8,7,1,7,switzerland
Luzern,6,2,1,3,7,10,-3,7,switzerland
Winterthur,6,2,0,4,8,14,-6,6,switzerland
Yverdon,6,1,2,3,6,15,-9,5,switzerland
Lausanne Ouchy,6,0,1,5,5,13,-8,1,switzerland
Foutoua,6,5,1,0,8,1,7,16,syria
Jabala,6,3,2,1,7,2,5,11,syria
Al Jaish,6,3,1,2,9,6,3,10,syria
Teshrin,6,3,1,2,7,4,3,10,syria
Karama,6,3,1,2,6,6,0,10,syria
Taliya,6,3,0,3,4,11,-7,9,syria
Hottin,6,2,2,2,10,7,3,8,syria
Al Ittihad,6,2,1,3,8,9,-1,7,syria
Al Wahda,6,2,1,3,4,6,-2,7,syria
Wathbah,6,2,0,4,8,10,-2,6,syria
Al Sahel,6,1,1,4,5,8,-3,4,syria
Horriya,6,1,1,4,6,12,-6,4,syria
Azam,6,6,0,0,22,2,20,18,tanzania
Young Africans,6,6,0,0,16,4,12,18,tanzania
Coastal Union,6,4,0,2,7,4,3,12,tanzania
Singida,6,3,2,1,9,6,3,11,tanzania
Simba,6,3,2,1,11,10,1,11,tanzania
Geita Gold,6,3,2,1,4,3,1,11,tanzania
Namungo,6,3,1,2,5,3,2,10,tanzania
T. Prisons,6,3,1,2,5,3,2,10,tanzania
Dodoma Jiji,6,3,0,3,5,5,0,9,tanzania
Tabora,6,1,3,2,4,5,-1,6,tanzania
KMC,6,1,3,2,7,12,-5,6,tanzania
JKT Tanzania,6,1,2,3,6,8,-2,5,tanzania
Ihefu,6,1,2,3,4,8,-4,5,tanzania
Kagera Sugar,6,1,2,3,3,10,-7,5,tanzania
Mtibwa Sugar,6,1,0,5,5,15,-10,3,tanzania
Mashujaa,6,0,1,5,5,14,-9,1,tanzania
Lamphun Warrior,6,3,3,0,16,9,7,12,thailand
Bangkok Utd,6,3,3,0,9,3,6,12,thailand
Buriram Utd,6,3,2,1,13,8,5,11,thailand
Pathum Utd,6,3,2,1,12,9,3,11,thailand
Port FC,6,3,1,2,12,7,5,10,thailand
Sukhothai,6,3,1,2,11,9,2,10,thailand
Police Tero,6,2,2,2,9,10,-1,8,thailand
Muang Thong Utd,6,2,2,2,8,9,-1,8,thailand
Nakhon Pathom,6,2,2,2,8,10,-2,8,thailand
Khon Kaen Utd,6,1,4,1,10,13,-3,7,thailand
Chiangrai Utd,6,1,3,2,7,10,-3,6,thailand
Uthai Thani,6,1,3,2,7,11,-4,6,thailand
Ratchaburi,6,1,2,3,6,8,-2,5,thailand
Prachuap,6,1,1,4,6,9,-3,4,thailand
Trat,6,1,1,4,9,14,-5,4,thailand
Chonburi,6,1,1,4,4,10,-6,4,thailand
Nakhon Si Thamm,6,4,2,0,16,5,11,14,thailand2
N. Bua Pitchaya,6,4,1,1,15,8,7,13,thailand2
N. Ratchasima,6,4,1,1,14,8,6,13,thailand2
Rayong,6,3,3,0,12,4,8,12,thailand2
Pattaya United,6,3,2,1,12,5,7,11,thailand2
Chiangmai FC,6,3,2,1,11,5,6,11,thailand2
Samut Prakan,6,3,1,2,10,10,0,10,thailand2
Chanthaburi,6,2,3,1,4,3,1,9,thailand2
Chiangmai Utd,6,2,2,2,7,9,-2,8,thailand2
Chainat,6,2,1,3,8,13,-5,7,thailand2
Kanchanaburi,6,1,3,2,6,8,-2,6,thailand2
Ayutthaya Utd,6,1,3,2,8,11,-3,6,thailand2
Lampang,6,2,0,4,5,9,-4,6,thailand2
Customs Utd,6,1,2,3,5,8,-3,5,thailand2
Krabi,6,1,2,3,1,4,-3,5,thailand2
Phrae Utd,6,1,2,3,5,12,-7,5,thailand2
Kasetsart,6,1,0,5,3,11,-8,3,thailand2
Suphanburi,6,0,2,4,2,11,-9,2,thailand2
Fenerbahce,6,4,2,0,13,6,7,14,turkey
Galatasaray,6,4,1,1,11,3,8,13,turkey
Rizespor,6,3,3,0,12,6,6,12,turkey
Trabzonspor,6,3,2,1,11,8,3,11,turkey
Alanyaspor,6,3,2,1,9,8,1,11,turkey
Basaksehir,6,3,1,2,11,7,4,10,turkey
Kayserispor,6,3,1,2,11,10,1,10,turkey
Konyaspor,6,2,2,2,8,6,2,8,turkey
Kasimpasa,6,2,2,2,11,11,0,8,turkey
Antalyaspor,6,1,4,1,6,6,0,7,turkey
Samsunspor,6,2,1,3,10,11,-1,7,turkey
Ankaragucu,6,1,4,1,4,7,-3,7,turkey
Besiktas,6,2,1,3,8,12,-4,7,turkey
Sivasspor,6,2,1,3,7,13,-6,7,turkey
F. Karagumruk,6,2,0,4,8,8,0,6,turkey
Adana Demirspor,6,1,3,2,8,10,-2,6,turkey
Gaziantep,6,1,2,3,10,12,-2,5,turkey
Hatayspor,6,1,2,3,7,9,-2,5,turkey
Istanbulspor,6,1,0,5,3,9,-6,3,turkey
Pendikspor,6,0,2,4,5,16,-11,2,turkey
Sakaryaspor,6,5,1,0,17,8,9,16,turkey2
Eyupspor,6,5,0,1,20,7,13,15,turkey2
Corum,6,4,1,1,14,4,10,13,turkey2
Umraniyespor,6,4,1,1,10,4,6,13,turkey2
Goztepe,6,4,0,2,15,7,8,12,turkey2
Kocaelispor,6,3,1,2,11,9,2,10,turkey2
Bodrumspor,6,2,3,1,8,4,4,9,turkey2
Boluspor,6,3,0,3,6,9,-3,9,turkey2
Tuzlaspor,6,2,2,2,8,8,0,8,turkey2
Genclerbirligi,6,2,2,2,5,7,-2,8,turkey2
Bandirmaspor,6,2,1,3,8,9,-1,7,turkey2
Adanaspor,6,2,1,3,5,9,-4,7,turkey2
Erzurum BB,6,1,3,2,8,13,-5,6,turkey2
Altay,6,2,0,4,4,15,-11,6,turkey2
Manisa BB,6,1,2,3,6,7,-1,5,turkey2
Sanliurfaspor,6,1,2,3,3,9,-6,5,turkey2
Keciorengucu,6,0,2,4,5,12,-7,2,turkey2
Giresunspor,6,0,0,6,4,16,-12,0,turkey2
Al Wasl,6,5,1,0,17,8,9,16,uae
Al Wahda,6,3,2,1,12,7,5,11,uae
Al Sharjah,6,2,4,0,14,8,6,10,uae
Shabab Al Ahli,6,3,1,2,14,8,6,10,uae
Al Ain,6,3,1,2,13,9,4,10,uae
Al Jazira,6,3,1,2,12,12,0,10,uae
Bani Yas,6,3,0,3,7,9,-2,9,uae
Ajman,6,2,2,2,9,8,1,8,uae
Al Nasr,6,2,2,2,7,7,0,8,uae
Al Bataeh,6,2,2,2,9,11,-2,8,uae
Al Khaleej,6,2,0,4,9,14,-5,6,uae
Ittihad Kalba,6,1,2,3,9,11,-2,5,uae
Hatta,6,1,2,3,7,11,-4,5,uae
Emirates,6,0,0,6,6,22,-16,0,uae
Dnipro-1,6,4,1,1,13,6,7,13,ukraine
Dynamo Kyiv,6,4,1,1,11,4,7,13,ukraine
Shakhtar,6,4,1,1,9,3,6,13,ukraine
Kryvbas KR,6,3,2,1,9,6,3,11,ukraine
LNZ Cherkasy,6,3,2,1,9,6,3,11,ukraine
Polessya,6,2,4,0,6,4,2,10,ukraine
Vorskla Poltava,6,2,4,0,6,4,2,10,ukraine
Kolos Kovalivka,6,2,3,1,5,3,2,9,ukraine
Oleksandria,6,2,1,3,5,4,1,7,ukraine
Zorya Luhansk,6,1,3,2,9,9,0,6,ukraine
Veres,6,1,3,2,7,9,-2,6,ukraine
Chornomorets,6,2,0,4,10,13,-3,6,ukraine
Rukh Lviv,6,1,3,2,6,9,-3,6,ukraine
FC Minaj,6,0,3,3,0,6,-6,3,ukraine
Metalist 1925,6,1,0,5,8,16,-8,3,ukraine
Obolon,6,0,2,4,4,12,-8,2,ukraine
Nacional,6,4,2,0,14,2,12,14,uruguay
Penarol,6,4,2,0,9,2,7,14,uruguay
La Luz,6,4,1,1,13,9,4,13,uruguay
Liverpool M.,6,3,2,1,12,8,4,11,uruguay
D. Maldonado,6,2,2,2,9,11,-2,8,uruguay
Defensor S.,6,1,4,1,9,6,3,7,uruguay
Cerro,6,1,4,1,4,5,-1,7,uruguay
Cerro Largo,6,1,4,1,4,5,-1,7,uruguay
Wanderers,6,2,1,3,5,7,-2,7,uruguay
Fenix,6,2,1,3,5,9,-4,7,uruguay
Plaza Colonia,6,1,3,2,7,8,-1,6,uruguay
Boston River,6,1,3,2,7,9,-2,6,uruguay
River Plate,6,1,3,2,6,9,-3,6,uruguay
Racing CM,6,1,2,3,5,7,-2,5,uruguay
Montevideo City,6,1,2,3,6,11,-5,5,uruguay
Danubio,6,0,2,4,3,10,-7,2,uruguay
Liverpool M.,6,4,1,1,12,6,6,13,uruguay2
Defensor S.,6,4,1,1,10,4,6,13,uruguay2
Wanderers,6,3,2,1,9,5,4,11,uruguay2
Cerro,6,3,2,1,5,3,2,11,uruguay2
Nacional,6,3,1,2,11,7,4,10,uruguay2
Danubio,6,3,1,2,5,3,2,10,uruguay2
Racing CM,6,3,1,2,10,9,1,10,uruguay2
Penarol,6,3,1,2,7,6,1,10,uruguay2
River Plate,6,2,3,1,5,6,-1,9,uruguay2
Fenix,6,2,2,2,6,4,2,8,uruguay2
Montevideo City,6,2,1,3,7,7,0,7,uruguay2
Cerro Largo,6,2,1,3,5,6,-1,7,uruguay2
Boston River,6,2,0,4,7,7,0,6,uruguay2
D. Maldonado,6,1,1,4,6,12,-6,4,uruguay2
Plaza Colonia,6,0,3,3,6,14,-8,3,uruguay2
La Luz,6,0,1,5,3,15,-12,1,uruguay2
New York RB,6,4,1,1,12,6,6,13,usa
Orlando City,6,4,1,1,10,5,5,13,usa
Columbus Crew,6,3,3,0,10,5,5,12,usa
Seattle,6,3,3,0,7,3,4,12,usa
Sporting KC,6,4,0,2,10,11,-1,12,usa
Houston Dynamo,6,3,2,1,14,6,8,11,usa
Cincinnati,6,3,2,1,11,7,4,11,usa
New York City,6,3,2,1,7,3,4,11,usa
Charlotte,6,3,1,2,9,7,2,10,usa
Real Salt Lake,6,3,1,2,9,9,0,10,usa
Portland,6,3,1,2,12,14,-2,10,usa
Atlanta Utd,6,2,3,1,15,10,5,9,usa
Los Angeles FC,6,2,3,1,10,5,5,9,usa
Dallas,6,1,5,0,8,5,3,8,usa
St. Louis City,6,2,2,2,7,8,-1,8,usa
Vancouver,6,1,4,1,9,7,2,7,usa
SJ Earthquakes,6,1,4,1,7,7,0,7,usa
Philadelphia,6,1,4,1,6,6,0,7,usa
New England,6,2,1,3,11,12,-1,7,usa
Chicago Fire,6,2,1,3,7,9,-2,7,usa
Austin,6,1,3,2,10,10,0,6,usa
Nashville SC,6,1,3,2,4,5,-1,6,usa
DC United,6,1,3,2,8,11,-3,6,usa
CF Montreal,6,1,2,3,8,12,-4,5,usa
Colorado Rapids,6,1,2,3,7,12,-5,5,usa
Minnesota Utd,6,1,1,4,12,17,-5,4,usa
Inter Miami,6,0,3,3,5,10,-5,3,usa
LA Galaxy,6,0,3,3,12,19,-7,3,usa
Toronto,6,0,0,6,2,18,-16,0,usa
Colorado S.,6,5,1,0,12,3,9,16,usa2
Pittsburgh,6,5,1,0,12,5,7,16,usa2
San Diego Loyal,6,4,2,0,14,6,8,14,usa2
New Mexico,6,4,1,1,12,6,6,13,usa2
Sacramento R.,6,4,1,1,7,4,3,13,usa2
Miami FC,6,4,0,2,11,7,4,12,usa2
Rio Grande,6,3,2,1,9,7,2,11,usa2
Memphis,6,3,1,2,15,11,4,10,usa2
Charleston,6,3,1,2,10,8,2,10,usa2
Tampa Bay,6,3,1,2,11,11,0,10,usa2
Orange County,6,3,1,2,6,7,-1,10,usa2
Indy Eleven,6,2,2,2,11,9,2,8,usa2
El Paso,6,2,2,2,6,9,-3,8,usa2
San Antonio,6,1,4,1,13,10,3,7,usa2
FC Tulsa,6,2,1,3,10,9,1,7,usa2
Birmingham L.,6,2,1,3,5,6,-1,7,usa2
Louisville City,6,2,1,3,9,11,-2,7,usa2
Detroit City,6,2,1,3,6,11,-5,7,usa2
Phoenix Rising,6,1,3,2,9,7,2,6,usa2
Monterey Bay,6,1,1,4,8,14,-6,4,usa2
Oakland Roots,6,0,2,4,8,14,-6,2,usa2
Hartford A.,6,0,2,4,5,15,-10,2,usa2
Las Vegas L.,6,0,1,5,5,12,-7,1,usa2
Loudoun Utd,6,0,1,5,5,13,-8,1,usa2
Union Omaha,6,5,1,0,15,5,10,16,usa3
North Carolina,6,4,1,1,11,5,6,13,usa3
N. Colorado,6,4,1,1,9,3,6,13,usa3
Greenville,6,3,2,1,8,7,1,11,usa3
Tormenta,6,3,1,2,7,9,-2,10,usa3
Charlotte,6,2,3,1,10,8,2,9,usa3
Chattanooga RW,6,2,1,3,13,15,-2,7,usa3
Forward Madison,6,1,2,3,4,7,-3,5,usa3
Lexington,6,0,4,2,10,13,-3,4,usa3
One Knoxville,6,0,3,3,4,7,-3,3,usa3
Central Valley,6,1,0,5,8,16,-8,3,usa3
Richmond K.,6,0,1,5,8,14,-6,1,usa3
AMGK,6,5,1,0,10,5,5,16,uzbekistan
Nasaf Qarshi,6,3,3,0,7,2,5,12,uzbekistan
Andijan,6,4,0,2,7,6,1,12,uzbekistan
Bunyodkor,6,3,2,1,9,9,0,11,uzbekistan
Navbahor,6,3,1,2,10,5,5,10,uzbekistan
Pakhtakor,6,3,1,2,9,6,3,10,uzbekistan
Termez Surkhon,6,3,1,2,7,5,2,10,uzbekistan
FK Olympic,6,3,1,2,5,4,1,10,uzbekistan
Neftchi,6,2,2,2,7,5,2,8,uzbekistan
Qizilqum,6,2,2,2,7,5,2,8,uzbekistan
Metallurg,6,1,2,3,3,6,-3,5,uzbekistan
Sogdiana,6,1,1,4,4,8,-4,4,uzbekistan
Turan,6,1,0,5,3,12,-9,3,uzbekistan
Buxoro,6,0,1,5,0,5,-5,1,uzbekistan
D. Tachira,6,6,0,0,11,3,8,18,venezuela
Zamora,6,4,1,1,12,7,5,13,venezuela
Puerto Cabello,6,3,1,2,9,6,3,10,venezuela
Rayo Zuliano,6,3,1,2,6,5,1,10,venezuela
Carabobo,6,2,3,1,5,3,2,9,venezuela
Angostura,6,2,2,2,7,6,1,8,venezuela
UCV,6,2,2,2,7,6,1,8,venezuela
Portuguesa,6,2,2,2,9,10,-1,8,venezuela
Caracas,6,0,6,0,4,4,0,6,venezuela
H. Colmenares,6,1,3,2,4,6,-2,6,venezuela
M. de Guayana,6,2,0,4,5,9,-4,6,venezuela
D. La Guaira,6,0,5,1,9,10,-1,5,venezuela
E. Merida,6,1,2,3,7,10,-3,5,venezuela
Metropolitanos,6,1,2,3,9,14,-5,5,venezuela
Monagas,6,1,1,4,6,10,-4,4,venezuela
Binh Dinh,6,5,0,1,15,5,10,15,vietnam
Nam Dinh,6,4,1,1,16,8,8,13,vietnam
Thanh Hoa,6,4,1,1,11,5,6,13,vietnam
Ha Noi,6,3,1,2,6,4,2,10,vietnam
Binh Duong,6,3,1,2,7,7,0,10,vietnam
Cong An Nhan,6,2,2,2,9,7,2,8,vietnam
Ho Chi Minh,6,2,2,2,6,5,1,8,vietnam
Quang Nam,6,2,2,2,7,7,0,8,vietnam
Hai Phong,6,2,1,3,7,7,0,7,vietnam
Song Lam Nghe,6,2,1,3,7,10,-3,7,vietnam
S. Khanh Hoa,6,2,0,4,4,9,-5,6,vietnam
Viettel,6,2,0,4,4,12,-8,6,vietnam
Gia Lai,6,1,1,4,5,10,-5,4,vietnam
Hong Linh Ha T.,6,1,1,4,4,11,-7,4,vietnam
Da Nang,6,4,2,0,16,5,11,14,vietnam2
Hue,6,4,1,1,8,3,5,13,vietnam2
PVF-CAND,6,3,3,0,6,3,3,12,vietnam2
Ba Ria Vung Tau,6,3,0,3,10,7,3,9,vietnam2
Long An,6,2,2,2,12,10,2,8,vietnam2
Dong Nai,6,2,2,2,5,6,-1,8,vietnam2
Dong Thap,6,2,1,3,3,5,-2,7,vietnam2
Hoa Binh,6,2,1,3,4,7,-3,7,vietnam2
Phu Dong,6,1,3,2,4,6,-2,6,vietnam2
Binh Phuoc,6,1,2,3,6,8,-2,5,vietnam2
Phu Tho,6,0,1,5,0,14,-14,1,vietnam2
Binh Thuan,0,0,0,0,0,0,0,0,vietnam2
The New Saints,6,6,0,0,15,2,13,18,wales
Bala Town,6,4,1,1,11,7,4,13,wales
Connah`s Quay,6,4,0,2,16,10,6,12,wales
Haverfordwest,6,3,2,1,7,4,3,11,wales
Cardiff MU,6,3,2,1,9,7,2,11,wales
Newtown,6,3,1,2,11,8,3,10,wales
Caernarfon Town,6,2,1,3,8,9,-1,7,wales
Penybont,6,2,1,3,6,8,-2,7,wales
Barry Town,6,1,2,3,4,13,-9,5,wales
Aberystwyth,6,1,1,4,7,13,-6,4,wales
Colwyn Bay,6,1,0,5,9,14,-5,3,wales
Pontypridd Town,6,1,0,5,5,12,-7,3,wales
