Equipe,GP,W,D,L,GF,GA,GD,Pts,albania2
Bylis,4,4,0,0,7,3,4,12,albania2
Apolonia Fier,6,3,2,1,10,4,6,11,albania2
Flamurtari,6,3,2,1,8,3,5,11,albania2
AF Elbasani,6,3,1,2,9,7,2,10,albania2
Vora,5,2,0,3,8,9,-1,6,albania2
Lushnja,5,1,2,2,7,7,0,5,albania2
Luzi 2008,5,1,0,4,6,7,-1,3,albania2
Korabi Peshkopi,6,0,3,3,0,3,-3,3,albania2
Besa Kavaje,6,0,3,3,6,13,-7,3,albania2
Burreli,6,1,0,5,2,10,-8,3,albania2
Kastrioti Kruje,5,0,2,3,3,8,-5,2,albania2
Tomori Berat,5,0,1,4,3,15,-12,1,albania2
Paradou AC,2,1,1,0,5,0,5,4,algeria
CR Belouizdad,2,1,0,1,4,2,2,3,algeria
MC Alger,2,1,0,1,2,2,0,3,algeria
CS Constantine,3,1,0,2,4,5,-1,3,algeria
JS Kabylie,3,1,0,2,2,3,-1,3,algeria
US Biskra,3,1,0,2,2,3,-1,3,algeria
US Souf,2,1,0,1,2,3,-1,3,algeria
Khenchela,2,1,0,1,3,5,-2,3,algeria
ASO Chlef,2,0,1,1,2,3,-1,1,algeria
NC Magra,2,0,1,1,0,1,-1,1,algeria
El Bayadh,3,0,1,2,1,4,-3,1,algeria
JS Saoura,2,0,1,1,1,4,-3,1,algeria
MC Oran,3,0,1,2,0,3,-3,1,algeria
USM Alger,2,0,0,2,0,2,-2,0,algeria
ES Setif,2,0,0,2,3,6,-3,0,algeria
Ben Aknoun,3,0,0,3,1,8,-7,0,algeria
Mostaganem,2,2,0,0,5,1,4,6,algeria2
Koléa,3,2,0,1,3,2,1,6,algeria2
Hussein Dey,3,1,2,0,2,1,1,5,algeria2
Khemis El K.,2,1,1,0,1,0,1,4,algeria2
MSP Batna,3,1,1,1,2,3,-1,4,algeria2
GC Mascara,2,1,0,1,4,3,1,3,algeria2
ASM Oran,1,1,0,0,2,1,1,3,algeria2
Teleghma,1,1,0,0,2,1,1,3,algeria2
RC Kouba,1,1,0,0,1,0,1,3,algeria2
Oued Akbou,2,1,0,1,4,4,0,3,algeria2
Tiaret,2,1,0,1,2,5,-3,3,algeria2
Bordj Menaïel,2,0,2,0,2,2,0,2,algeria2
Mechria,2,0,2,0,1,1,0,2,algeria2
MO Constantine,2,0,2,0,1,1,0,2,algeria2
CA Batna,1,0,1,0,0,0,0,1,algeria2
Khroub,2,0,1,1,1,2,-1,1,algeria2
WA Boufarik,2,0,1,1,1,2,-1,1,algeria2
WA Mostaganem,2,0,1,1,1,2,-1,1,algeria2
Mlila,2,0,1,1,0,1,-1,1,algeria2
Temouchent,2,0,1,1,0,1,-1,1,algeria2
El Harrach,3,0,1,2,3,5,-2,1,algeria2
Chelghoum,2,0,1,1,1,3,-2,1,algeria2
El Ghozlane,2,0,1,1,1,3,-2,1,algeria2
RB Ouargla,2,0,1,1,1,3,-2,1,algeria2
El Eulma,2,0,1,1,0,5,-5,1,algeria2
Khemis Melina,2,0,0,2,3,5,-2,0,algeria2
Oued Magrane,2,0,0,2,1,3,-2,0,algeria2
Oued Sly,2,0,0,2,0,3,-3,0,algeria2
RC Arbaa,2,0,0,2,1,6,-5,0,algeria2
FC Santa Coloma,5,4,0,1,14,3,11,12,andorra
UE Santa Coloma,3,3,0,0,8,1,7,9,andorra
Inter Escaldes,4,2,1,1,11,5,6,7,andorra
Penya Encarnada,4,2,1,1,6,5,1,7,andorra
Pas de la Casa,4,1,1,2,4,5,-1,4,andorra
Ordino,4,1,0,3,3,6,-3,3,andorra
Carroi,4,1,0,3,2,15,-13,3,andorra
A. Escaldes,4,0,1,3,2,5,-3,1,andorra
A. America,4,0,1,3,2,14,-12,1,andorra
Esperanca,4,0,0,4,3,11,-8,0,andorra
T. de Cordoba,8,4,2,2,12,8,4,14,argentina
Argentinos Jrs,8,3,3,2,5,3,2,12,argentina
Estudiantes,8,3,3,2,8,8,0,12,argentina
A. Tucuman,8,3,2,3,8,8,0,11,argentina
Boca Juniors,8,3,2,3,8,9,-1,11,argentina
River Plate,8,2,4,2,13,11,2,10,argentina
Union Santa Fe,8,2,4,2,4,4,0,10,argentina
San Lorenzo,8,2,4,2,5,6,-1,10,argentina
Barracas C.,8,2,4,2,7,9,-2,10,argentina
Gimnasia,8,2,3,3,9,12,-3,9,argentina
Lanus,8,1,5,2,11,12,-1,8,argentina
Tigre,8,2,2,4,6,7,-1,8,argentina
Defensa y J.,8,2,2,4,8,11,-3,8,argentina
Racing Club,8,1,4,3,9,11,-2,7,argentina
Central Cordoba,8,1,4,3,8,11,-3,7,argentina
Godoy Cruz,8,1,4,3,6,9,-3,7,argentina
Sarmiento,8,2,1,5,4,10,-6,7,argentina
Newells,8,1,3,4,6,9,-3,6,argentina
Banfield,8,1,3,4,6,12,-6,6,argentina
Rosario Central,8,0,5,3,4,9,-5,5,argentina
Platense,8,1,2,5,5,11,-6,5,argentina
Independiente,8,1,2,5,6,13,-7,5,argentina
Huracan,8,1,1,6,1,7,-6,4,argentina
Velez Sarsfield,8,1,1,6,5,12,-7,4,argentina
Belgrano,8,1,1,6,2,12,-10,4,argentina
Instituto,8,1,1,6,6,17,-11,4,argentina
Colon Santa Fe,8,0,3,5,1,9,-8,3,argentina
Arsenal Sarandi,8,0,2,6,1,8,-7,2,argentina
Chacarita J.,8,5,1,2,8,6,2,16,argentina3
Quilmes,8,4,3,1,11,5,6,15,argentina3
A. Rafaela,8,4,2,2,14,10,4,14,argentina3
I. Rivadavia,8,3,4,1,7,4,3,13,argentina3
E. Rio Cuarto,8,4,1,3,6,4,2,13,argentina3
D. Riestra,8,3,3,2,6,5,1,12,argentina3
Deportivo Moron,8,3,2,3,9,10,-1,11,argentina3
CA Guemes,8,3,2,3,9,11,-2,11,argentina3
Almirante Brown,8,3,2,3,6,10,-4,11,argentina3
D. de Belgrano,8,3,1,4,10,10,0,10,argentina3
Nueva Chicago,8,3,1,4,7,7,0,10,argentina3
Temperley,8,2,4,2,8,9,-1,10,argentina3
Chaco For Ever,8,3,1,4,6,10,-4,10,argentina3
Agropecuario,8,2,3,3,6,8,-2,9,argentina3
Atletico Mitre,8,3,0,5,9,14,-5,9,argentina3
Alvarado,8,2,2,4,10,11,-1,8,argentina3
Deportivo Maipu,8,2,2,4,9,11,-2,8,argentina3
SM San Juan,8,2,2,4,8,11,-3,8,argentina3
Brown de A.,8,2,2,4,5,9,-4,8,argentina3
E. Caseros,8,1,4,3,8,11,-3,7,argentina3
SM Tucuman,8,1,4,3,5,8,-3,7,argentina3
San Telmo,8,2,1,5,5,9,-4,7,argentina3
D. Madryn,8,0,6,2,2,5,-3,6,argentina3
Tristan Suarez,8,1,3,4,9,14,-5,6,argentina3
Aldosivi,8,1,3,4,2,10,-8,6,argentina3
Racing Cordoba,8,1,2,5,8,13,-5,5,argentina3
Ferro Carril,8,1,2,5,7,13,-6,5,argentina3
All Boys,8,0,4,4,4,9,-5,4,argentina3
Atlanta,8,1,1,6,4,10,-6,4,argentina3
Pyunik,8,7,1,0,23,5,18,22,armenia
Ararat-Armenia,8,4,2,2,15,8,7,14,armenia
Noah,8,4,0,4,15,13,2,12,armenia
Urartu,8,3,2,3,15,15,0,11,armenia
Ararat Yerevan,8,3,1,4,9,12,-3,10,armenia
Alashkert,8,3,0,5,13,15,-2,9,armenia
West Armenia,8,2,1,5,7,15,-8,7,armenia
BKMA,8,2,0,6,6,15,-9,6,armenia
Shirak,8,1,2,5,6,13,-7,5,armenia
Van,8,0,1,7,2,19,-17,1,armenia
Macarthur FC,2,1,1,0,5,4,1,4,australia
Newcastle Jets,3,1,1,1,6,7,-1,4,australia
Brisbane Roar,3,1,1,1,5,7,-2,4,australia
Melbourne V.,1,1,0,0,2,0,2,3,australia
Sydney FC,3,1,0,2,5,6,-1,3,australia
Western United,3,1,0,2,2,7,-5,3,australia
Wellington,2,0,2,0,1,1,0,2,australia
Western Sydney,1,0,1,0,2,2,0,1,australia
Adelaide Utd,1,0,1,0,1,1,0,1,australia
Perth Glory,2,0,0,2,1,4,-3,0,australia
Central Coast,2,0,0,2,0,5,-5,0,australia
Melbourne City,1,0,0,1,0,6,-6,0,australia
Salzburg,8,5,3,0,19,6,13,18,austria
Sturm Graz,7,5,1,1,13,6,7,16,austria
A. Klagenfurt,7,3,3,1,11,9,2,12,austria
Rapid Wien,7,3,2,2,13,4,9,11,austria
Hartberg,6,3,2,1,12,5,7,11,austria
Wolfsberger AC,7,2,4,1,11,11,0,10,austria
Austria Wien,7,3,0,4,7,8,-1,9,austria
LASK Linz,7,2,2,3,9,11,-2,8,austria
BW Linz,7,2,0,5,9,17,-8,6,austria
Altach,8,1,3,4,6,15,-9,6,austria
Tirol,7,1,1,5,4,12,-8,4,austria
A. Lustenau,6,0,3,3,3,7,-4,3,austria
Grazer AK,7,5,1,1,12,9,3,16,austria2
St. Polten,7,4,2,1,15,10,5,14,austria2
Kapfenberger,8,4,2,2,12,11,1,14,austria2
Bregenz,7,4,1,2,13,6,7,13,austria2
Floridsdorfer,7,3,3,1,14,9,5,12,austria2
Stripfing,7,3,1,3,9,8,1,10,austria2
First Vienna,7,3,1,3,7,11,-4,10,austria2
Leoben,6,2,2,2,9,8,1,8,austria2
Ried,6,1,3,2,5,6,-1,6,austria2
Sturm Graz B,7,1,2,4,9,17,-8,5,austria2
Liefering,6,1,1,4,4,11,-7,4,austria2
Lafnitz,7,1,1,5,4,15,-11,4,austria2
Dornbirn,7,1,1,5,3,15,-12,4,austria2
Admira Wacker,7,0,3,4,9,13,-4,3,austria2
SV Horn,7,1,0,6,5,17,-12,3,austria2
Amstetten,8,0,2,6,6,16,-10,2,austria2
Neftci,8,4,2,2,10,6,4,14,azerbaijan
Sebail,6,3,2,1,11,7,4,11,azerbaijan
Turan,7,3,1,3,10,7,3,10,azerbaijan
Zira,6,3,1,2,4,3,1,10,azerbaijan
Sumqayit,7,3,1,3,10,13,-3,10,azerbaijan
Qarabag,5,2,1,2,8,7,1,7,azerbaijan
Araz,6,2,1,3,8,8,0,7,azerbaijan
Sabah,6,2,1,3,6,8,-2,7,azerbaijan
Qabala,7,1,2,4,3,12,-9,5,azerbaijan
Kapaz,7,1,2,4,5,16,-11,5,azerbaijan
Bashundhara K.,8,6,1,1,21,9,12,19,bangladesh
Mohammedan,8,6,0,2,18,6,12,18,bangladesh
B. Police,8,4,2,2,16,9,7,14,bangladesh
Abahani,8,3,2,3,16,9,7,11,bangladesh
Sheikh Russel,8,3,2,3,9,10,-1,11,bangladesh
Sheikh Jamal,8,2,4,2,7,10,-3,10,bangladesh
Fortis,8,2,3,3,12,15,-3,9,bangladesh
Rahmatgonj,8,2,3,3,9,15,-6,9,bangladesh
Chittagong,8,1,5,2,9,11,-2,8,bangladesh
Muktijoddha S.,8,2,1,5,7,18,-11,7,bangladesh
A. Uttara,8,0,2,6,4,21,-17,2,bangladesh
Neman Grodno,8,6,1,1,20,7,13,19,belarus
Dinamo Minsk,8,6,1,1,20,8,12,19,belarus
T. Zhodino,8,5,2,1,10,4,6,17,belarus
BATE Borisov,8,5,1,2,14,4,10,16,belarus
Isloch,8,5,1,2,9,6,3,16,belarus
Gomel,8,4,2,2,13,9,4,14,belarus
Dinamo Brest,8,4,0,4,10,14,-4,12,belarus
Energetik-BGU,8,2,4,2,8,10,-2,10,belarus
Slavia Mozyr,8,2,3,3,11,11,0,9,belarus
FC Minsk,8,2,2,4,4,9,-5,8,belarus
Naftan,8,2,1,5,11,16,-5,7,belarus
S. Soligorsk,8,1,3,4,12,15,-3,6,belarus
Slutsk,8,1,2,5,7,12,-5,5,belarus
Smorgon,8,1,2,5,10,21,-11,5,belarus
Belshina,8,0,2,6,7,21,-14,2,belarus
Arsenal D.,8,7,0,1,17,6,11,21,belarus2
Dnepr Mogilev,8,6,2,0,26,3,23,20,belarus2
Vitebsk,8,5,2,1,18,5,13,17,belarus2
FC Ostrovets,8,4,2,2,19,11,8,14,belarus2
Zhodino Yuzhnoe,8,4,0,4,16,12,4,12,belarus2
Maxline,8,4,0,4,20,18,2,12,belarus2
Lokomotiv Gomel,8,3,3,2,8,9,-1,12,belarus2
Lida,8,3,1,4,12,15,-3,10,belarus2
Volna Pinsk,8,2,3,3,9,10,-1,9,belarus2
S.Petrikov,8,3,0,5,9,16,-7,9,belarus2
Molodechno-DYuS,8,2,2,4,13,20,-7,8,belarus2
Niva,8,2,1,5,12,20,-8,7,belarus2
Orsha,8,1,3,4,15,18,-3,6,belarus2
Bumprom,8,2,0,6,7,17,-10,6,belarus2
Slonim,8,0,3,5,7,17,-10,3,belarus2
Baranovichi,8,0,2,6,4,17,-13,2,belarus2
Osipovichy,8,0,0,8,4,22,-18,0,belarus2
Royale Union SG,6,5,0,1,13,7,6,15,belgium
KRC Genk,7,4,2,1,14,5,9,14,belgium
Anderlecht,8,3,3,2,13,10,3,12,belgium
Gent,7,3,3,1,9,6,3,12,belgium
Cercle Brugge,7,3,1,3,7,5,2,10,belgium
Sint-Truiden,7,1,5,1,11,14,-3,8,belgium
RWDM,7,2,2,3,9,14,-5,8,belgium
Standard Liege,7,2,2,3,8,14,-6,8,belgium
Club Brugge,7,2,1,4,10,8,2,7,belgium
Westerlo,7,1,4,2,10,10,0,7,belgium
Eupen,7,2,1,4,8,13,-5,7,belgium
Antwerp,7,1,3,3,9,9,0,6,belgium
KV Mechelen,7,1,2,4,6,14,-8,5,belgium
OH Leuven,7,1,1,5,9,21,-12,4,belgium
Charleroi,7,0,1,6,4,14,-10,1,belgium
Kortrijk,7,0,1,6,3,18,-15,1,belgium
U. de Vinto,8,3,4,1,7,3,4,13,bolivia
Real Tomayapo,8,4,1,3,8,8,0,13,bolivia
Aurora,8,2,4,2,9,10,-1,10,bolivia
Royal Pari,8,2,3,3,11,12,-1,9,bolivia
I. Petrolero,8,3,0,5,9,14,-5,9,bolivia
The Strongest,8,2,2,4,11,17,-6,8,bolivia
Always Ready,8,2,2,4,5,14,-9,8,bolivia
Oriente P.,8,2,1,5,13,15,-2,7,bolivia
Wilstermann,8,1,3,4,8,10,-2,6,bolivia
Santa Cruz,8,2,0,6,5,14,-9,6,bolivia
Nacional Potosi,8,0,4,4,10,15,-5,4,bolivia
Bolivar,8,0,4,4,9,14,-5,4,bolivia
Vaca Diez,8,1,1,6,8,20,-12,4,bolivia
A. Palmaflor,8,1,1,6,5,19,-14,4,bolivia
Libertad,8,0,3,5,7,21,-14,3,bolivia
Blooming,8,0,1,7,3,15,-12,1,bolivia
Guabira,8,0,0,8,2,21,-19,0,bolivia
The Strongest,8,5,2,1,14,4,10,17,bolivia2
Always Ready,8,4,2,2,12,8,4,14,bolivia2
Bolivar,8,3,3,2,17,14,3,12,bolivia2
Aurora,8,2,3,3,8,10,-2,9,bolivia2
Oriente P.,8,2,1,5,7,12,-5,7,bolivia2
Guabira,8,2,1,5,11,17,-6,7,bolivia2
Nacional Potosi,8,2,1,5,10,18,-8,7,bolivia2
U. de Vinto,8,1,2,5,6,10,-4,5,bolivia2
I. Petrolero,8,1,2,5,11,16,-5,5,bolivia2
A. Palmaflor,8,0,5,3,6,13,-7,5,bolivia2
Real Tomayapo,8,1,2,5,6,14,-8,5,bolivia2
Wilstermann,8,0,4,4,4,8,-4,4,bolivia2
Blooming,8,1,1,6,5,16,-11,4,bolivia2
U. Sucre,8,0,3,5,7,16,-9,3,bolivia2
Santa Cruz,8,1,0,7,7,21,-14,3,bolivia2
Royal Pari,8,0,2,6,3,13,-10,2,bolivia2
Atletico MG,8,4,3,1,11,5,6,15,brazil
Flamengo,8,4,2,2,12,10,2,14,brazil
Bragantino,8,4,2,2,9,7,2,14,brazil
Santos,8,4,1,3,9,15,-6,13,brazil
Gremio,8,3,2,3,17,20,-3,11,brazil
Cuiaba,8,3,1,4,7,7,0,10,brazil
Palmeiras,8,3,1,4,10,11,-1,10,brazil
Athletico PR,8,2,3,3,8,8,0,9,brazil
Botafogo,8,2,3,3,6,6,0,9,brazil
Corinthians,8,2,3,3,10,11,-1,9,brazil
Goias,8,2,3,3,9,11,-2,9,brazil
Vasco da Gama,8,2,3,3,7,9,-2,9,brazil
Coritiba,8,3,0,5,14,19,-5,9,brazil
Internacional,8,2,2,4,6,11,-5,8,brazil
Cruzeiro,8,2,1,5,4,7,-3,7,brazil
Fortaleza,8,2,1,5,6,11,-5,7,brazil
Bahia,8,2,0,6,10,16,-6,6,brazil
America MG,8,0,4,4,11,16,-5,4,brazil
Sao Paulo,8,0,4,4,4,13,-9,4,brazil
Fluminense,8,0,3,5,5,14,-9,3,brazil
CSKA Sofia,8,7,0,1,16,6,10,21,bulgaria
Ludogorets,8,5,1,2,16,5,11,16,bulgaria
Lok. Plovdiv,8,4,4,0,14,9,5,16,bulgaria
Cherno More,8,3,4,1,12,6,6,13,bulgaria
CSKA 1948 Sofia,8,3,2,3,7,7,0,11,bulgaria
Arda,8,3,1,4,7,5,2,10,bulgaria
Levski Sofia,8,2,3,3,10,9,1,9,bulgaria
Botev Plovdiv,8,2,3,3,10,10,0,9,bulgaria
Lokomotiv Sofia,8,3,0,5,6,14,-8,9,bulgaria
Hebar,8,2,1,5,9,14,-5,7,bulgaria
Pirin Blag.,8,2,1,5,5,14,-9,7,bulgaria
Slavia Sofia,8,1,2,5,4,13,-9,5,bulgaria
Etar,8,1,1,6,4,14,-10,4,bulgaria
L. Krumovgrad,8,1,1,6,2,12,-10,4,bulgaria
Botev Vratsa,8,1,1,6,3,14,-11,4,bulgaria
Beroe,8,1,1,6,5,17,-12,4,bulgaria
Forge,8,5,1,2,15,8,7,16,canada
York Utd,8,4,2,2,16,14,2,14,canada
Cavalry,8,4,1,3,13,9,4,13,canada
A. Ottawa,8,4,0,4,10,8,2,12,canada
HFX Wanderers,8,2,3,3,9,9,0,9,canada
Valour,8,2,2,4,7,11,-4,8,canada
Pacific,8,2,1,5,10,14,-4,7,canada
Vancouver FC,8,2,0,6,6,14,-8,6,canada
Everton,8,6,1,1,14,6,8,19,chile
Palestino,8,4,2,2,12,9,3,14,chile
Nublense,8,4,1,3,12,9,3,13,chile
Huachipato,8,4,1,3,11,11,0,13,chile
Cobresal,8,3,3,2,10,12,-2,12,chile
Union La Calera,8,3,2,3,11,10,1,11,chile
Colo-Colo,8,2,5,1,8,7,1,11,chile
O`Higgins,8,3,1,4,13,13,0,10,chile
Audax Italiano,8,3,0,5,10,14,-4,9,chile
U. Catolica,8,2,2,4,12,15,-3,8,chile
U. de Chile,8,2,1,5,10,15,-5,7,chile
Curico Unido,8,1,4,3,6,12,-6,7,chile
Coquimbo Unido,8,1,3,4,9,13,-4,6,chile
Union Espanola,8,1,2,5,7,12,-5,5,chile
Magallanes,8,1,1,6,6,13,-7,4,chile
Copiapo,8,0,3,5,4,10,-6,3,chile
D. Iquique,8,4,4,0,13,7,6,16,chile2
S. Wanderers,8,4,2,2,9,8,1,14,chile2
S. Morning,8,3,3,2,11,8,3,12,chile2
San Luis,8,3,2,3,8,7,1,11,chile2
Barnechea,8,3,2,3,11,11,0,11,chile2
U. Concepcion,8,3,2,3,12,14,-2,11,chile2
Deportes Temuco,8,2,4,2,9,9,0,10,chile2
Antofagasta,8,3,1,4,12,13,-1,10,chile2
Cobreloa,8,2,3,3,12,14,-2,9,chile2
Puerto Montt,8,2,3,3,7,9,-2,9,chile2
La Serena,8,3,0,5,10,14,-4,9,chile2
Recoleta,8,2,2,4,9,11,-2,8,chile2
U. San Felipe,8,2,2,4,7,10,-3,8,chile2
Rangers,8,2,2,4,10,16,-6,8,chile2
CD Santa Cruz,8,2,1,5,8,10,-2,7,chile2
San Marcos,8,1,3,4,11,18,-7,6,chile2
Zhejiang,8,5,2,1,18,10,8,17,china
Shanghai Port,8,5,1,2,21,9,12,16,china
Beijing Guoan,8,4,2,2,13,9,4,14,china
S. Taishan,8,3,4,1,10,6,4,13,china
Wuhan Three T.,8,4,1,3,15,13,2,13,china
Chengdu,8,3,2,3,12,11,1,11,china
Nantong Zhiyun,8,2,4,2,12,11,1,10,china
Tianjin T.,8,3,1,4,10,9,1,10,china
S. Shenhua,8,2,2,4,7,13,-6,8,china
Changchun Yatai,8,1,3,4,5,10,-5,6,china
Meizhou Hakka,8,1,2,5,8,19,-11,5,china
Henan SL,8,1,1,6,7,19,-12,4,china
Qingdao Jonoon,8,0,3,5,3,10,-7,3,china
Cangzhou,8,1,0,7,4,27,-23,3,china
Dalian P.,8,0,2,6,6,17,-11,2,china
Shenzhen,8,0,1,7,6,22,-16,1,china
Sichuan Jiuniu,8,8,0,0,18,3,15,24,china2
Hebei Kungfu,8,4,2,2,11,6,5,14,china2
Qingdao Y. I.,8,3,4,1,13,9,4,13,china2
Wuxi Wugou,8,3,2,3,12,16,-4,11,china2
Jinan Xingzhou,8,2,4,2,9,9,0,10,china2
Jiangxi L.,8,2,3,3,7,9,-2,9,china2
Dongguan United,8,3,0,5,6,10,-4,9,china2
Guangxi Baoyun,8,1,5,2,6,8,-2,8,china2
Nanjing,8,1,5,2,4,9,-5,8,china2
Guangzhou FC,8,2,0,6,7,13,-6,6,china2
Shanghai Jiadin,8,1,3,4,4,11,-7,6,china2
Shenyang Urban,8,1,3,4,6,16,-10,6,china2
Dantong Hantong,8,1,2,5,2,10,-8,5,china2
Suzhou Dongwu,8,0,3,5,5,17,-12,3,china2
Heilongjiang L.,8,0,2,6,7,14,-7,2,china2
Yanbian Longdin,8,0,2,6,5,13,-8,2,china2
Deportes Tolima,8,5,1,2,8,8,0,16,colombia2
R. Aguilas,8,3,5,0,12,5,7,14,colombia2
America de Cali,8,3,5,0,11,7,4,14,colombia2
I. Medelin,8,2,6,0,13,8,5,12,colombia2
Junior,8,3,2,3,10,6,4,11,colombia2
Millonarios,8,2,2,4,7,11,-4,8,colombia2
Union Magdalena,8,2,2,4,8,16,-8,8,colombia2
Once Caldas,8,2,1,5,7,10,-3,7,colombia2
Santa Fe,8,1,4,3,10,14,-4,7,colombia2
D. Pereira,8,2,1,5,8,12,-4,7,colombia2
A. Nacional,8,2,1,5,7,12,-5,7,colombia2
A. Bucaramanga,8,2,1,5,5,11,-6,7,colombia2
A. Petrolera,8,2,1,5,3,10,-7,7,colombia2
La Equidad,8,1,3,4,6,13,-7,6,colombia2
Deportivo Cali,8,1,2,5,8,16,-8,5,colombia2
Boyaca Chico,8,0,5,3,4,12,-8,5,colombia2
Atletico Huila,8,1,1,6,4,11,-7,4,colombia2
Deportivo Pasto,8,1,1,6,4,14,-10,4,colombia2
Envigado,8,0,2,6,5,17,-12,2,colombia2
Jaguares de C.,8,0,2,6,0,12,-12,2,colombia2
Saprissa,8,5,1,2,17,11,6,16,costarica
Alajuelense,8,4,2,2,14,12,2,14,costarica
Guanacasteca,8,4,2,2,7,8,-1,14,costarica
Herediano,8,2,3,3,12,10,2,9,costarica
Sporting SJ,8,2,2,4,9,15,-6,8,costarica
Cartagines,8,2,1,5,9,10,-1,7,costarica
M. Liberia,8,2,1,5,14,18,-4,7,costarica
Puntarenas,8,1,2,5,8,13,-5,5,costarica
AD Grecia,8,1,2,5,5,19,-14,5,costarica
San Carlos,8,1,1,6,9,15,-6,4,costarica
Zeledon,8,1,1,6,4,21,-17,4,costarica
Santos DG,8,0,3,5,3,12,-9,3,costarica
Slavia Prague,8,6,2,0,14,5,9,20,czechrepublic
Sparta Prague,8,5,2,1,15,7,8,17,czechrepublic
Banik Ostrava,7,3,1,3,10,9,1,10,czechrepublic
Mlada Boleslav,7,3,1,3,15,16,-1,10,czechrepublic
Teplice,8,3,1,4,9,11,-2,10,czechrepublic
Slovacko,7,3,1,3,6,10,-4,10,czechrepublic
Viktoria Plzen,6,3,0,3,15,10,5,9,czechrepublic
Bohemians,7,3,0,4,4,9,-5,9,czechrepublic
Sigma Olomouc,7,2,2,3,10,10,0,8,czechrepublic
Jablonec,8,1,4,3,6,8,-2,7,czechrepublic
Pardubice,7,2,1,4,7,14,-7,7,czechrepublic
Slovan Liberec,7,0,5,2,8,13,-5,5,czechrepublic
Zlin,8,1,2,5,4,14,-10,5,czechrepublic
Hradec Kralove,8,0,3,5,4,14,-10,3,czechrepublic
Karvina,8,1,0,7,5,17,-12,3,czechrepublic
C. Budejovice,7,0,1,6,4,19,-15,1,czechrepublic
FC Kobenhavn,7,5,2,0,17,10,7,17,denmark
Brondby IF,8,5,2,1,13,6,7,17,denmark
FC Midtjylland,7,4,1,2,13,12,1,13,denmark
Nordsjaelland,8,3,2,3,12,8,4,11,denmark
Odense BK,7,3,2,2,12,8,4,11,denmark
AGF Aarhus,7,2,4,1,9,6,3,10,denmark
Silkeborg,7,3,1,3,11,9,2,10,denmark
Lyngby,8,2,1,5,6,15,-9,7,denmark
Hvidovre,8,1,3,4,5,11,-6,6,denmark
Randers FC,8,1,3,4,9,16,-7,6,denmark
Vejle BK,7,1,1,5,6,10,-4,4,denmark
Viborg,8,1,1,6,4,14,-10,4,denmark
SonderjyskE,8,7,1,0,25,10,15,22,denmark2
Aalborg BK,8,5,3,0,16,6,10,18,denmark2
Hobro,7,5,0,2,10,4,6,15,denmark2
Fredericia,8,3,4,1,14,10,4,13,denmark2
Vendsyssel,8,4,1,3,11,9,2,13,denmark2
Hillerod,8,3,2,3,17,12,5,11,denmark2
B 93,8,3,1,4,10,10,0,10,denmark2
Kolding IF,8,3,1,4,9,14,-5,10,denmark2
AC Horsens,8,2,1,5,7,13,-6,7,denmark2
HB Koge,7,1,1,5,9,16,-7,4,denmark2
Naestved,8,0,2,6,8,18,-10,2,denmark2
Helsingor,8,0,2,6,4,15,-11,2,denmark2
Imbabura,8,3,4,1,11,8,3,13,ecuador3
Cuniburo,8,3,2,3,12,12,0,11,ecuador3
I. Juniors,8,3,2,3,7,8,-1,11,ecuador3
Macara,8,3,2,3,8,10,-2,11,ecuador3
Chacaritas,8,3,1,4,7,10,-3,10,ecuador3
Manta,8,2,3,3,10,13,-3,9,ecuador3
Vargas Torres,8,2,1,5,6,15,-9,7,ecuador3
America de Q.,8,1,3,4,8,15,-7,6,ecuador3
Nueve Octubre,8,2,0,6,6,14,-8,6,ecuador3
Guayaquil,8,0,3,5,5,19,-14,3,ecuador3
Future FC,3,3,0,0,6,1,5,9,egypt
ZED FC,3,2,1,0,6,4,2,7,egypt
Al Ahly,3,2,1,0,5,3,2,7,egypt
Pyramids FC,3,2,0,1,2,2,0,6,egypt
El Gouna,3,1,2,0,4,3,1,5,egypt
Baladiyyat,2,1,1,0,5,3,2,4,egypt
Zamalek,3,1,1,1,5,5,0,4,egypt
El Geish,3,1,1,1,3,3,0,4,egypt
Al Ittihad,3,1,1,1,4,5,-1,4,egypt
Smouha,3,1,1,1,4,6,-2,4,egypt
National Bank,3,1,0,2,5,5,0,3,egypt
Pharco,3,1,0,2,3,4,-1,3,egypt
ENPPI,3,1,0,2,1,2,-1,3,egypt
Al Masry,3,1,0,2,5,8,-3,3,egypt
Al Mokawloon,3,0,1,2,4,6,-2,1,egypt
Ceramica C.,3,0,1,2,2,4,-2,1,egypt
Ismaily,3,0,1,2,1,4,-3,1,egypt
El Daklyeh,3,0,0,3,1,8,-7,0,egypt
Tottenham,7,4,2,1,15,9,6,14,england
Manchester City,7,4,1,2,16,9,7,13,england
Chelsea,5,3,1,1,11,5,6,10,england
Arsenal,5,3,1,1,8,3,5,10,england
Everton,6,3,1,2,9,11,-2,10,england
Crystal Palace,6,3,1,2,6,8,-2,10,england
Liverpool,6,2,3,1,10,8,2,9,england
Manchester Utd,5,3,0,2,5,6,-1,9,england
Brentford,6,2,1,3,7,7,0,7,england
Brighton,5,2,1,2,10,11,-1,7,england
Wolverhampton,6,2,1,3,7,8,-1,7,england
West Ham Utd,6,2,1,3,10,13,-3,7,england
Aston Villa,6,2,1,3,6,12,-6,7,england
Fulham,7,1,3,3,6,13,-7,6,england
Newcastle Utd,6,1,2,3,13,10,3,5,england
Nottm Forest,7,1,1,5,6,13,-7,4,england
Burnley,6,1,1,4,5,12,-7,4,england
Luton Town,7,1,1,5,6,15,-9,4,england
Sheffield Utd,6,0,1,5,4,15,-11,1,england
Bournemouth,5,0,1,4,5,17,-12,1,england
Leicester City,8,7,0,1,18,6,12,21,england2
Ipswich Town,8,5,3,0,11,6,5,18,england2
Southampton,8,5,1,2,11,12,-1,16,england2
Millwall,8,3,4,1,12,7,5,13,england2
Blackburn,8,4,1,3,15,12,3,13,england2
Leeds Utd,8,4,1,3,12,10,2,13,england2
Hull City,8,4,1,3,12,12,0,13,england2
Sunderland,8,3,2,3,11,7,4,11,england2
Middlesbrough,8,3,2,3,16,16,0,11,england2
Bristol City,8,3,2,3,7,8,-1,11,england2
Preston,8,3,2,3,9,11,-2,11,england2
Swansea City,8,3,1,4,13,12,1,10,england2
West Brom,8,2,3,3,12,10,2,9,england2
Cardiff City,8,2,2,4,10,10,0,8,england2
QP Rangers,8,2,2,4,7,9,-2,8,england2
Norwich City,8,2,2,4,17,20,-3,8,england2
Stoke City,8,2,2,4,7,10,-3,8,england2
Watford,7,1,3,3,5,10,-5,6,england2
Huddersfield,8,1,3,4,7,15,-8,6,england2
Coventry City,8,1,2,5,10,14,-4,5,england2
Birmingham City,8,1,1,6,6,14,-8,4,england2
Plymouth,8,0,3,5,7,14,-7,3,england2
Sheffield Wed,8,0,1,7,3,15,-12,1,england2
Rotherham,8,0,1,7,3,21,-18,1,england2
Oxford Utd,8,6,0,2,16,9,7,18,england3
Barnsley,8,5,2,1,13,6,7,17,england3
Bolton,7,5,1,1,14,5,9,16,england3
Portsmouth,7,4,3,0,13,6,7,15,england3
Derby County,8,4,1,3,15,10,5,13,england3
Stevenage,8,4,1,3,12,10,2,13,england3
Peterborough,8,3,2,3,12,11,1,11,england3
Wycombe,8,3,2,3,13,14,-1,11,england3
Leyton Orient,8,2,4,2,8,8,0,10,england3
Port Vale,8,2,4,2,7,10,-3,10,england3
Bristol Rovers,8,3,1,4,8,12,-4,10,england3
Fleetwood,8,2,3,3,10,11,-1,9,england3
Lincoln City,8,2,3,3,7,11,-4,9,england3
Exeter City,8,3,0,5,7,13,-6,9,england3
Wigan Athletic,8,2,2,4,11,11,0,8,england3
Burton Albion,8,2,2,4,6,10,-4,8,england3
Blackpool,8,1,4,3,7,12,-5,7,england3
Charlton,7,1,3,3,8,11,-3,6,england3
Northampton,8,2,0,6,6,12,-6,6,england3
Carlisle Utd,8,1,2,5,6,10,-4,5,england3
Cambridge Utd,8,1,2,5,4,12,-8,5,england3
Cheltenham,8,1,1,6,4,12,-8,4,england3
Shrewsbury,8,1,1,6,2,14,-12,4,england3
Reading,8,0,0,8,6,20,-14,0,england3
Stockport,8,6,0,2,19,11,8,18,england4
Mansfield,8,4,4,0,18,8,10,16,england4
AFC Wimbledon,8,4,3,1,12,7,5,15,england4
Harrogate,8,4,1,3,8,9,-1,13,england4
Wrexham,8,3,4,1,7,8,-1,13,england4
Crewe Alexandra,8,3,3,2,18,15,3,12,england4
Notts County,8,3,3,2,13,10,3,12,england4
Barrow,8,3,2,3,9,8,1,11,england4
Salford City,8,3,1,4,13,12,1,10,england4
Accrington,8,3,1,4,11,13,-2,10,england4
Morecambe,8,3,0,5,11,15,-4,9,england4
Colchester Utd,8,3,0,5,10,14,-4,9,england4
Gillingham,8,3,0,5,5,12,-7,9,england4
Bradford,8,2,2,4,9,13,-4,8,england4
Walsall,8,2,2,4,13,19,-6,8,england4
Forest Green,7,2,1,4,7,12,-5,7,england4
Milton Keynes,8,1,3,4,7,11,-4,6,england4
Crawley Town,7,1,3,3,9,17,-8,6,england4
Doncaster,8,2,0,6,8,16,-8,6,england4
Newport,8,2,0,6,9,18,-9,6,england4
Swindon Town,8,0,4,4,13,19,-6,4,england4
Grimsby,8,0,3,5,9,16,-7,3,england4
Sutton Utd,8,0,1,7,9,24,-15,1,england4
Tranmere,8,0,0,8,4,17,-13,0,england4
Chesterfield,8,6,1,1,16,9,7,19,england5
Barnet,8,5,0,3,16,14,2,15,england5
Solihull Moors,8,4,3,1,11,10,1,15,england5
Woking,8,4,1,3,11,7,4,13,england5
Altrincham,8,3,4,1,12,11,1,13,england5
Bromley,8,3,4,1,10,9,1,13,england5
Gateshead FC,8,3,3,2,19,10,9,12,england5
Dagenham & R.,8,3,3,2,10,8,2,12,england5
Halifax Town,8,3,3,2,9,7,2,12,england5
Rochdale,8,3,3,2,14,13,1,12,england5
Boreham Wood,8,2,4,2,11,14,-3,10,england5
Oldham,8,2,4,2,10,14,-4,10,england5
York City,8,3,1,4,10,17,-7,10,england5
Dorking,8,3,1,4,5,13,-8,10,england5
Aldershot Town,8,3,0,5,8,12,-4,9,england5
Eastleigh,8,2,2,4,9,13,-4,8,england5
Southend Utd,8,1,4,3,8,12,-4,7,england5
Hartlepool,8,2,1,5,12,17,-5,7,england5
AFC Fylde,8,2,0,6,12,17,-5,6,england5
Kidderminster,8,1,1,6,5,14,-9,4,england5
Oxford City,8,0,4,4,8,18,-10,4,england5
Ebbsfleet Utd,8,0,3,5,10,23,-13,3,england5
Maidenhead Utd,8,0,2,6,7,20,-13,2,england5
Wealdstone,8,0,1,7,7,16,-9,1,england5
Flora,8,4,3,1,11,7,4,15,estonia
Tallinna Kalev,8,3,3,2,15,9,6,12,estonia
Levadia,8,3,3,2,14,11,3,12,estonia
Paide,8,3,2,3,11,10,1,11,estonia
Vaprus,8,1,4,3,6,7,-1,7,estonia
Nomme Kalju,8,1,4,3,8,10,-2,7,estonia
Harju Jalgpalli,8,1,3,4,7,13,-6,6,estonia
Narva Trans,8,2,0,6,8,20,-12,6,estonia
Kuressaare,8,1,0,7,3,21,-18,3,estonia
Tammeka,8,0,2,6,8,21,-13,2,estonia
Nomme Utd,8,7,1,0,34,5,29,22,estonia2
Viimsi,8,5,2,1,12,5,7,17,estonia2
Flora B,8,4,1,3,18,12,6,13,estonia2
FC Tallinn,8,4,1,3,17,16,1,13,estonia2
Paide B,8,4,1,3,17,19,-2,13,estonia2
Levadia B,8,3,1,4,8,12,-4,10,estonia2
Tabasalu,8,3,0,5,14,20,-6,9,estonia2
Elva,8,3,0,5,9,18,-9,9,estonia2
Legion,8,1,3,4,12,20,-8,6,estonia2
Alliance,8,1,2,5,11,23,-12,5,estonia2
Vikingur,8,6,0,2,21,8,13,18,faroeislands
Klaksvik,8,5,2,1,20,7,13,17,faroeislands
HB Torshavn,8,5,1,2,19,9,10,16,faroeislands
B36 Torshavn,8,3,1,4,14,14,0,10,faroeislands
07 Vestur,8,3,1,4,10,13,-3,10,faroeislands
Streymur,8,2,3,3,10,18,-8,9,faroeislands
B68 Toftir,8,1,3,4,7,13,-6,6,faroeislands
TB Tvoroyri,8,1,1,6,2,13,-11,4,faroeislands
IF Fuglafjordur,8,1,0,7,5,22,-17,3,faroeislands
AB Argir,8,0,1,7,8,26,-18,1,faroeislands
Skala,8,5,1,2,24,10,14,16,faroeislands2
NSI Runavik,8,5,1,2,22,10,12,16,faroeislands2
Klaksvik B,8,5,0,3,23,10,13,15,faroeislands2
Hoyvik,8,3,2,3,17,14,3,11,faroeislands2
Vikingur B,8,3,0,5,13,12,1,9,faroeislands2
B71 Sandur,8,1,4,3,6,13,-7,7,faroeislands2
HB B,8,2,1,5,9,20,-11,7,faroeislands2
B36 Torshavn B,8,1,1,6,14,22,-8,4,faroeislands2
B68 Toftir B,8,0,0,8,5,25,-20,0,faroeislands2
Streymur B,8,0,0,8,5,40,-35,0,faroeislands2
VPS,8,8,0,0,16,1,15,24,finland
KuPS,8,5,3,0,17,9,8,18,finland
HJK Helsinki,8,5,2,1,17,11,6,17,finland
Ilves,8,3,2,3,15,9,6,11,finland
Inter Turku,8,3,2,3,11,11,0,11,finland
Honka,8,3,1,4,7,11,-4,10,finland
SJK,8,2,3,3,9,12,-3,9,finland
Mariehamn,8,2,2,4,12,13,-1,8,finland
Lahti,8,1,4,3,6,10,-4,7,finland
Haka,8,2,1,5,7,16,-9,7,finland
Oulu,8,2,0,6,11,17,-6,6,finland
KTP,8,1,1,6,6,15,-9,4,finland
Ekenas IF,8,6,1,1,18,7,11,19,finland2
Gnistan,8,3,4,1,13,11,2,13,finland2
Mikkelin,8,3,2,3,12,11,1,11,finland2
JaPS,8,3,2,3,10,11,-1,11,finland2
TPS,8,3,1,4,9,12,-3,10,finland2
HIFK,8,3,0,5,13,15,-2,9,finland2
SJK Akatemia,8,2,3,3,14,17,-3,9,finland2
Jaro,8,2,3,3,10,15,-5,9,finland2
SalPa,8,1,4,3,7,10,-3,7,finland2
KPV Kokkola,8,1,2,5,10,19,-9,5,finland2
KaPa,8,1,1,6,10,15,-5,4,finland2
JJK,8,0,2,6,8,21,-13,2,finland2
Paris SG,6,4,2,0,14,5,9,14,france
Nice,6,4,2,0,7,3,4,14,france
Reims,6,3,2,1,10,7,3,11,france
Monaco,6,2,3,1,12,10,2,9,france
Montpellier,6,2,1,3,9,9,0,7,france
Lille,6,1,4,1,7,8,-1,7,france
Le Havre,6,1,4,1,6,8,-2,7,france
Brest,6,2,1,3,4,7,-3,7,france
Metz,6,2,1,3,5,11,-6,7,france
Toulouse,7,1,3,3,5,10,-5,6,france
Nantes,6,2,0,4,5,13,-8,6,france
Clermont,5,1,2,2,5,7,-2,5,france
Lens,6,1,2,3,4,9,-5,5,france
Lyon,5,1,1,3,2,5,-3,4,france
Strasbourg,5,1,1,3,2,9,-7,4,france
Rennes,5,0,3,2,2,5,-3,3,france
Lorient,6,0,2,4,6,13,-7,2,france
Marseille,6,0,2,4,5,12,-7,2,france
Auxerre,7,4,2,1,16,9,7,14,france2
Laval,7,4,2,1,9,4,5,14,france2
Saint-Etienne,7,4,1,2,9,9,0,13,france2
Grenoble,7,3,3,1,9,7,2,12,france2
Angers,7,3,1,3,11,12,-1,10,france2
Concarneau,7,3,1,3,7,8,-1,10,france2
USL Dunkerque,7,3,1,3,8,11,-3,10,france2
Guingamp,7,2,3,2,7,7,0,9,france2
Caen,7,2,2,3,12,12,0,8,france2
Annecy,7,2,2,3,8,11,-3,8,france2
AC Ajaccio,7,2,2,3,5,8,-3,8,france2
Paris FC,7,2,1,4,7,11,-4,7,france2
Amiens,6,2,1,3,3,7,-4,7,france2
Quevilly Rouen,7,1,3,3,10,12,-2,6,france2
Rodez Aveyron,7,1,3,3,9,13,-4,6,france2
Valenciennes,7,1,3,3,4,9,-5,6,france2
Troyes,8,0,5,3,8,11,-3,5,france2
Pau FC,6,1,2,3,8,13,-5,5,france2
Bordeaux,7,1,2,4,3,11,-8,5,france2
SC Bastia,7,0,3,4,2,8,-6,3,france2
Red Star,7,4,2,1,10,8,2,14,france3
Le Mans,7,4,1,2,11,10,1,13,france3
Rouen,7,3,3,1,10,6,4,12,france3
Martigues,7,2,4,1,3,3,0,10,france3
Sochaux,7,2,3,2,9,8,1,9,france3
Versailles,6,2,1,3,6,5,1,7,france3
Niort,6,2,1,3,9,12,-3,7,france3
Villefranche,7,1,4,2,7,10,-3,7,france3
Chateauroux,7,0,6,1,8,10,-2,6,france3
Nimes,6,1,3,2,5,11,-6,6,france3
G. O. A. L.,7,1,2,4,6,7,-1,5,france3
Marignane G.,6,1,2,3,4,8,-4,5,france3
Orleans,6,1,2,3,5,10,-5,5,france3
Dijon,6,1,2,3,3,10,-7,5,france3
Nancy,6,1,1,4,3,5,-2,4,france3
Epinal,6,1,1,4,8,13,-5,4,france3
Cholet,6,1,0,5,4,11,-7,3,france3
Avranches,7,0,2,5,6,18,-12,2,france3
Torpedo Kutaisi,8,5,3,0,12,6,6,18,georgia
Dinamo Batumi,8,5,1,2,20,7,13,16,georgia
Dinamo Tbilisi,8,4,2,2,21,12,9,14,georgia
Samtredia,8,3,3,2,9,8,1,12,georgia
Telavi,8,4,0,4,9,16,-7,12,georgia
Dila Gori,8,3,2,3,9,10,-1,11,georgia
Gagra,8,3,1,4,10,20,-10,10,georgia
Samgurali,8,1,3,4,8,15,-7,6,georgia
Saburtalo,8,1,1,6,4,15,-11,4,georgia
Shukura,8,1,0,7,7,29,-22,3,georgia
Kolkheti Poti,8,5,3,0,22,6,16,18,georgia2
Gareji Sagarejo,8,6,0,2,19,7,12,18,georgia2
WIT Georgia,8,5,2,1,17,11,6,17,georgia2
Bolnisi,8,5,1,2,13,6,7,16,georgia2
L. Tbilisi,8,3,2,3,9,9,0,11,georgia2
D. Tbilisi B,8,3,1,4,11,12,-1,10,georgia2
Spaeri,8,3,1,4,10,11,-1,10,georgia2
Kolkheti Khobi,8,1,3,4,6,12,-6,6,georgia2
Merani Martvili,8,1,1,6,9,26,-17,4,georgia2
Merani Tbilisi,8,0,1,7,10,34,-24,1,georgia2
Hoffenheim,6,5,1,0,15,8,7,16,germany
Bayern Munich,5,4,1,0,15,4,11,13,germany
Leverkusen,5,4,1,0,13,5,8,13,germany
E. Frankfurt,6,2,3,1,10,7,3,9,germany
RB Leipzig,5,3,0,2,9,6,3,9,germany
Stuttgart,5,3,0,2,9,8,1,9,germany
Dortmund,5,2,2,1,12,9,3,8,germany
Monchengladbach,5,1,3,1,14,14,0,6,germany
Bochum,6,1,2,3,5,17,-12,5,germany
FC Augsburg,5,1,1,3,7,11,-4,4,germany
Freiburg,6,1,1,4,4,14,-10,4,germany
Union Berlin,6,1,0,5,7,14,-7,3,germany
FSV Mainz,6,0,3,3,6,14,-8,3,germany
Wolfsburg,6,1,0,5,6,15,-9,3,germany
Darmstadt,5,1,0,4,4,18,-14,3,germany
FC Koln,6,0,2,4,3,14,-11,2,germany
Werder Bremen,5,0,1,4,6,12,-6,1,germany
Heidenheim,6,0,1,5,6,16,-10,1,germany
Elversberg,7,4,2,1,12,8,4,14,germany2
Holstein Kiel,6,4,1,1,10,7,3,13,germany2
Sankt Pauli,6,3,3,0,9,5,4,12,germany2
Dusseldorf,6,3,1,2,12,4,8,10,germany2
Paderborn,7,3,1,3,11,13,-2,10,germany2
FC Nurnberg,7,3,1,3,12,15,-3,10,germany2
Wehen Wiesbaden,6,3,0,3,8,7,1,9,germany2
Hannover 96,7,2,3,2,11,11,0,9,germany2
Hertha Berlin,7,2,1,4,10,16,-6,7,germany2
Hamburger SV,7,1,3,3,11,14,-3,6,germany2
Hansa Rostock,6,2,0,4,5,9,-4,6,germany2
Magdeburg,7,1,2,4,9,12,-3,5,germany2
Karlsruher SC,7,1,2,4,11,15,-4,5,germany2
Kaiserslautern,6,1,2,3,9,13,-4,5,germany2
Greuther Furth,6,1,2,3,5,11,-6,5,germany2
Schalke 04,7,1,1,5,8,17,-9,4,germany2
Osnabruck,6,0,2,4,5,18,-13,2,germany2
Braunschweig,6,0,0,6,1,13,-12,0,germany2
Regensburg,7,5,2,0,11,5,6,17,germany3
Dynamo Dresden,7,4,1,2,12,7,5,13,germany3
Sandhausen,8,3,3,2,9,9,0,12,germany3
Verl,7,3,1,3,16,13,3,10,germany3
Dortmund B,7,2,4,1,9,8,1,10,germany3
1860 Munchen,8,3,1,4,11,11,0,10,germany3
RW Essen,7,3,1,3,8,10,-2,10,germany3
Erzgebirge Aue,8,2,4,2,8,11,-3,10,germany3
Ulm,8,3,1,4,11,15,-4,10,germany3
Preuss. Munster,8,2,2,4,9,11,-2,8,germany3
Saarbrucken,7,1,4,2,12,11,1,7,germany3
Unterhaching,7,1,4,2,6,9,-3,7,germany3
Bielefeld,7,2,1,4,7,11,-4,7,germany3
FC Ingolstadt,8,2,1,5,9,15,-6,7,germany3
VfB Lubeck,8,1,4,3,8,15,-7,7,germany3
Freiburg B,7,2,0,5,6,11,-5,6,germany3
Viktoria Koln,7,1,2,4,11,14,-3,5,germany3
Hallescher,7,1,1,5,11,19,-8,4,germany3
Mannheim,8,1,1,6,6,16,-10,4,germany3
MSV Duisburg,6,0,3,3,3,7,-4,3,germany3
Panathinaikos,6,6,0,0,16,2,14,18,greece
Olympiakos,4,3,1,0,8,1,7,10,greece
AEK Athens,5,3,1,1,9,6,3,10,greece
PAOK,5,2,1,2,9,8,1,7,greece
Asteras T.,5,2,1,2,5,7,-2,7,greece
Lamia,6,1,2,3,4,12,-8,5,greece
Aris,5,1,1,3,5,8,-3,4,greece
Atromitos,7,1,1,5,6,17,-11,4,greece
PAS Giannina,6,0,3,3,6,10,-4,3,greece
OFI Crete,5,0,3,2,4,8,-4,3,greece
Panserraikos,6,0,3,3,6,14,-8,3,greece
Volos,5,0,2,3,2,10,-8,2,greece
Panaitolikos,6,0,1,5,4,13,-9,1,greece
Kifisia,5,0,1,4,3,12,-9,1,greece
Municipal,8,4,3,1,14,8,6,15,guatemala
Antigua GFC,7,3,1,3,9,10,-1,10,guatemala
Achuapa,7,3,1,3,11,14,-3,10,guatemala
Guastatoya,8,3,0,5,8,9,-1,9,guatemala
Malacateco,7,2,1,4,9,13,-4,7,guatemala
Zacapa Tellioz,6,2,0,4,5,9,-4,6,guatemala
Comunicaciones,6,1,2,3,8,11,-3,5,guatemala
Mixco,7,1,2,4,5,10,-5,5,guatemala
Xinabajul,6,1,2,3,5,11,-6,5,guatemala
Coban Imperial,7,0,3,4,6,14,-8,3,guatemala
Coatepecano IB,7,0,2,5,4,15,-11,2,guatemala
Xelaju,7,0,1,6,1,9,-8,1,guatemala
Olimpia,8,6,2,0,16,7,9,20,honduras
Marathon,8,4,1,3,9,13,-4,13,honduras
Motagua,8,3,2,3,18,15,3,11,honduras
Olancho,8,2,3,3,8,9,-1,9,honduras
Génesis,8,2,2,4,7,11,-4,8,honduras
Vida,8,2,1,5,9,18,-9,7,honduras
Victoria,8,1,2,5,9,13,-4,5,honduras
Real Sociedad,8,0,4,4,3,10,-7,4,honduras
Real Espana,8,1,0,7,9,20,-11,3,honduras
UPNFM,8,0,1,7,6,19,-13,1,honduras
HK Rangers,6,3,0,3,16,7,9,9,hongkong
North District,2,1,1,0,5,2,3,4,hongkong
Eastern,2,1,1,0,3,1,2,4,hongkong
Hong Kong FC,3,1,1,1,2,9,-7,4,hongkong
LM Warriors,1,1,0,0,3,1,2,3,hongkong
Southern D.,3,1,0,2,6,5,1,3,hongkong
Wofoo Tai Po,2,1,0,1,1,3,-2,3,hongkong
Resources C.,4,1,0,3,3,11,-8,3,hongkong
HK U23,4,0,1,3,0,12,-12,1,hongkong
Kitchee,1,0,0,1,1,4,-3,0,hongkong
Sham Shui Po,3,0,0,3,2,16,-14,0,hongkong
Puskas Akad.,7,5,1,1,15,8,7,16,hungary
Ferencvaros,5,4,0,1,20,9,11,12,hungary
Paks,7,2,3,2,11,12,-1,9,hungary
MTK,6,2,1,3,6,7,-1,7,hungary
Diosgyor VTK,6,2,1,3,8,11,-3,7,hungary
Zalaegerszegi,7,2,1,4,8,12,-4,7,hungary
MOL Fehervar,6,1,1,4,5,10,-5,4,hungary
Mezokovesd,7,1,1,5,6,12,-6,4,hungary
Ujpest,5,1,1,3,6,12,-6,4,hungary
Kecskemeti TE,6,1,0,5,6,13,-7,3,hungary
Debrecen,5,0,2,3,5,10,-5,2,hungary
Kisvarda,8,0,1,7,5,17,-12,1,hungary
Gyori ETO,8,5,1,2,17,12,5,16,hungary2
Kozarmisleny,7,4,1,2,10,6,4,13,hungary2
Pecsi MFC,8,3,4,1,4,3,1,13,hungary2
Nyiregyhaza,7,3,3,1,13,9,4,12,hungary2
Szeged,8,2,6,0,7,5,2,12,hungary2
Haladas,8,3,3,2,11,11,0,12,hungary2
Vasas,7,3,2,2,15,13,2,11,hungary2
Soroksar,8,3,2,3,8,7,1,11,hungary2
Kazincbarcika,7,2,3,2,8,7,1,9,hungary2
Gyirmot,7,2,3,2,7,6,1,9,hungary2
Csakvari,6,2,2,2,6,6,0,8,hungary2
Tiszakecske,8,2,2,4,9,11,-2,8,hungary2
Budafoki,8,2,2,4,7,13,-6,8,hungary2
BVSC,7,2,2,3,7,13,-6,8,hungary2
Honved,7,1,3,3,4,8,-4,6,hungary2
Siofok,7,1,1,5,3,11,-8,4,hungary2
Ajka,7,1,0,6,4,9,-5,3,hungary2
MTE,8,0,2,6,6,21,-15,2,hungary2
Vikingur R.,8,5,1,2,20,14,6,16,iceland
Stjarnan,8,4,2,2,14,7,7,14,iceland
Valur,8,3,2,3,18,13,5,11,iceland
Fylkir,8,3,2,3,13,15,-2,11,iceland
KA Akureyri,8,3,1,4,15,15,0,10,iceland
Hafnarfjordur,8,3,1,4,11,16,-5,10,iceland
KR Reykjavik,8,1,4,3,14,19,-5,7,iceland
Breidablik,8,1,3,4,14,21,-7,6,iceland
IBV,8,1,3,4,9,18,-9,6,iceland
Fram,8,0,3,5,6,17,-11,3,iceland
Keflavik,8,0,2,6,7,19,-12,2,iceland
HK Kopavogur,8,0,2,6,6,20,-14,2,iceland
Dalvik / Reynir,8,5,2,1,15,6,9,17,iceland3
IR Reykjavik,8,5,0,3,18,11,7,15,iceland3
Haukar,8,4,1,3,14,11,3,13,iceland3
Fjardabyggd,8,3,3,2,14,9,5,12,iceland3
Throttur Vogar,8,3,1,4,15,16,-1,10,iceland3
Volsungur,8,3,0,5,14,16,-2,9,iceland3
Hottur / Huginn,8,3,0,5,12,18,-6,9,iceland3
KFG,8,2,2,4,13,15,-2,8,iceland3
V. Olafsvik,8,2,2,4,9,15,-6,8,iceland3
Fjallabyggd,8,2,1,5,14,18,-4,7,iceland3
KV Reykjavik,8,0,1,7,6,24,-18,1,iceland3
Sindri,8,0,1,7,6,32,-26,1,iceland3
Mumbai City,8,7,0,1,25,11,14,21,india
Hyderabad,8,5,1,2,14,7,7,16,india
Bengaluru,8,4,0,4,12,12,0,12,india
Jamshedpur,8,4,0,4,11,11,0,12,india
ATK Mohun Bagan,8,2,3,3,3,5,-2,9,india
East Bengal,8,3,0,5,8,14,-6,9,india
Chennaiyin,8,2,2,4,17,17,0,8,india
Odisha FC,8,2,1,5,10,15,-5,7,india
Kerala Blasters,8,2,1,5,5,12,-7,7,india
Goa,8,0,3,5,9,18,-9,3,india
NorthEast Utd,8,0,1,7,10,25,-15,1,india
Persib,8,5,2,1,13,9,4,17,indonesia
Borneo,8,4,2,2,10,7,3,14,indonesia
Madura Utd,8,4,2,2,13,11,2,14,indonesia
R. Nusantara,8,3,3,2,11,10,1,12,indonesia
Bali Utd,8,3,2,3,10,11,-1,11,indonesia
Persija,8,3,1,4,11,13,-2,10,indonesia
PSIS Semarang,8,2,3,3,12,12,0,9,indonesia
Persik Kediri,8,2,3,3,10,14,-4,9,indonesia
PSS Sleman,8,2,2,4,10,15,-5,8,indonesia
Barito Putera,8,1,4,3,10,10,0,7,indonesia
TIRA Persikabo,8,2,1,5,8,15,-7,7,indonesia
PSM,8,1,3,4,7,10,-3,6,indonesia
Bhayangkara S.,8,1,3,4,7,14,-7,6,indonesia
Arema,8,1,3,4,10,18,-8,6,indonesia
Dewa United,8,1,2,5,9,13,-4,5,indonesia
Persis Solo,8,1,2,5,8,14,-6,5,indonesia
Persebaya S.,8,1,2,5,4,15,-11,5,indonesia
Persita,8,1,2,5,4,17,-13,5,indonesia
Zob Ahan,6,4,2,0,10,6,4,14,iran
Shams A. Qazvin,6,3,2,1,9,6,3,11,iran
Persepolis,5,3,1,1,6,2,4,10,iran
Tractor Sazi,6,3,0,3,7,6,1,9,iran
Havadar,5,2,2,1,9,7,2,8,iran
Sepahan,3,2,1,0,6,2,4,7,iran
Esteghlal,4,2,1,1,6,3,3,7,iran
Mes Rafsanjan,5,2,1,2,3,4,-1,7,iran
Paykan,5,1,3,1,3,4,-1,6,iran
Aluminium Arak,6,2,0,4,3,6,-3,6,iran
Malavan,4,1,2,1,5,5,0,5,iran
Gol Gohar,4,1,2,1,2,2,0,5,iran
Sanat Naft,4,1,1,2,6,10,-4,4,iran
Foolad,4,1,0,3,1,10,-9,3,iran
E. Khuzestan,5,0,2,3,2,5,-3,2,iran
N. Mazandaran,3,0,1,2,1,5,-4,1,iran
Al Quwa Al J.,2,2,0,0,2,0,2,6,iraq
Naft Maysan,2,1,1,0,4,0,4,4,iraq
Al Hudod,2,1,1,0,3,1,2,4,iraq
Al Zawraa,2,1,1,0,2,1,1,4,iraq
Duhok,2,1,1,0,1,0,1,4,iraq
Al Kahrabaa,2,1,0,1,3,2,1,3,iraq
Al Shorta,2,1,0,1,3,2,1,3,iraq
Karbala,2,1,0,1,3,2,1,3,iraq
Newroz SC,2,1,0,1,3,2,1,3,iraq
Al-Qasim,2,1,0,1,1,1,0,3,iraq
Baghdad,2,1,0,1,1,3,-2,3,iraq
Al Naft,2,0,2,0,3,3,0,2,iraq
Naft Al-Janoob,3,0,2,1,3,4,-1,2,iraq
Al Najaf,1,0,1,0,1,1,0,1,iraq
Al Karkh,2,0,1,1,1,2,-1,1,iraq
Al Talaba,2,0,1,1,1,2,-1,1,iraq
Zakho,2,0,1,1,1,2,-1,1,iraq
Naft Al-Wasat,2,0,1,1,2,4,-2,1,iraq
Al Minaa Basra,2,0,1,1,1,4,-3,1,iraq
Erbil,2,0,0,2,2,4,-2,0,iraq
Shelbourne,8,4,3,1,13,5,8,15,ireland
St. Patricks,8,4,1,3,9,8,1,13,ireland
Derry City,8,3,3,2,12,6,6,12,ireland
Dundalk,8,4,0,4,14,11,3,12,ireland
Shamrock Rovers,8,1,6,1,6,6,0,9,ireland
Drogheda Utd,8,2,2,4,9,18,-9,8,ireland
Bohemians,8,1,4,3,4,10,-6,7,ireland
Cork City,8,1,1,6,6,20,-14,4,ireland
Sligo Rovers,8,0,1,7,7,18,-11,1,ireland
UC Dublin,8,0,1,7,3,28,-25,1,ireland
Galway Utd,8,4,3,1,18,8,10,15,ireland2
Waterford,8,4,3,1,14,7,7,15,ireland2
Wexford,8,4,2,2,12,8,4,14,ireland2
Longford Town,8,3,3,2,10,10,0,12,ireland2
Cobh Ramblers,8,3,2,3,16,17,-1,11,ireland2
Bray Wanderers,8,2,4,2,11,12,-1,10,ireland2
Treaty Utd,8,3,1,4,9,13,-4,10,ireland2
Athlone Town,8,3,1,4,13,21,-8,10,ireland2
Finn Harps,8,1,2,5,7,21,-14,5,ireland2
Kerry,8,0,1,7,7,17,-10,1,ireland2
M. Tel Aviv,2,2,0,0,8,0,8,6,israel
Hapoel Haifa,2,2,0,0,4,2,2,6,israel
Maccabi Haifa,3,2,0,1,7,6,1,6,israel
Hapoel Tel Aviv,3,1,2,0,4,1,3,5,israel
M. Bnei Raina,3,1,2,0,4,3,1,5,israel
B. Jerusalem,2,1,0,1,3,3,0,3,israel
Hapoel Hadera,3,1,0,2,1,5,-4,3,israel
M. Petah Tikva,2,0,2,0,3,3,0,2,israel
Bnei Sakhnin,3,0,2,1,3,7,-4,2,israel
H. Beer Sheva,2,0,1,1,1,2,-1,1,israel
Maccabi Netanya,2,0,1,1,1,3,-2,1,israel
H. Jerusalem,3,0,1,2,2,6,-4,1,israel
Ashdod,2,0,0,2,1,6,-5,0,israel
H. Petah Tikva,2,0,0,2,1,6,-5,0,israel
Ramat Hasharon,3,2,1,0,8,3,5,7,israel2
H. Umm al-Fahm,3,1,2,0,4,2,2,5,israel2
H. Ramat Gan,3,1,2,0,5,4,1,5,israel2
H. Ironi Rishon,4,1,2,1,3,3,0,5,israel2
Bnei Yehuda,3,1,1,1,5,5,0,4,israel2
H. Kfar Saba,3,1,1,1,2,2,0,4,israel2
Kafr Qasim,3,1,1,1,2,2,0,4,israel2
H. Nof Hagalil,4,1,1,2,4,6,-2,4,israel2
Hapoel Afula,4,1,1,2,4,10,-6,4,israel2
Kiryat Shmona,3,1,0,2,4,4,0,3,israel2
Maccabi Jaffa,3,1,0,2,6,8,-2,3,israel2
Ihud B. Shfaram,3,1,0,2,5,8,-3,3,israel2
M. Herziliya,3,1,0,2,3,7,-4,3,israel2
Hapoel Akko,4,0,2,2,0,2,-2,2,israel2
Ironi Tiberias,3,0,2,1,3,6,-3,2,israel2
Nes Tziona,4,0,1,3,4,12,-8,1,israel2
Inter Milan,5,5,0,0,12,1,11,15,italy
Napoli,6,4,2,0,14,4,10,14,italy
AC Milan,7,4,2,1,13,11,2,14,italy
Juventus,6,4,1,1,9,4,5,13,italy
Atalanta,7,3,1,3,12,9,3,10,italy
Fiorentina,6,3,1,2,10,8,2,10,italy
Udinese,6,1,4,1,4,6,-2,7,italy
Torino,6,2,1,3,6,9,-3,7,italy
Monza,6,2,1,3,5,8,-3,7,italy
Lazio,6,2,0,4,6,9,-3,6,italy
Empoli,6,2,0,4,4,14,-10,6,italy
Bologna,6,0,5,1,5,6,-1,5,italy
AS Roma,6,1,2,3,7,9,-2,5,italy
Sassuolo,5,1,1,3,6,10,-4,4,italy
Genoa,6,1,1,4,4,8,-4,4,italy
Hellas Verona,7,1,1,5,3,8,-5,4,italy
Lecce,5,0,3,2,5,7,-2,3,italy
Frosinone,6,0,2,4,5,11,-6,2,italy
Cagliari,6,0,2,4,4,11,-7,2,italy
Salernitana,6,0,2,4,4,11,-7,2,italy
Cremonese,6,5,1,0,13,5,8,16,italy2
Palermo,6,4,1,1,9,3,6,13,italy2
Parma,6,4,0,2,16,9,7,12,italy2
Modena,6,3,3,0,7,4,3,12,italy2
Venezia,6,3,2,1,6,3,3,11,italy2
Catanzaro,7,3,2,2,10,9,1,11,italy2
Como,7,3,2,2,8,7,1,11,italy2
Pisa,7,3,2,2,6,5,1,11,italy2
Bari,7,2,4,1,9,8,1,10,italy2
Sampdoria,7,2,3,2,8,8,0,9,italy2
Sudtirol,6,2,2,2,7,7,0,8,italy2
Cittadella,6,2,2,2,6,7,-1,8,italy2
Cosenza,6,2,2,2,4,5,-1,8,italy2
Reggiana,7,2,2,3,7,9,-2,8,italy2
Lecco,6,2,2,2,6,8,-2,8,italy2
Brescia,5,2,1,2,5,4,1,7,italy2
Spezia,7,1,3,3,7,13,-6,6,italy2
Ascoli,7,1,2,4,6,11,-5,5,italy2
FeralpiSalo,7,1,2,4,4,14,-10,5,italy2
Ternana,6,0,2,4,7,12,-5,2,italy2
Arnett Gardens,8,5,3,0,14,5,9,18,jamaica
Portmore Utd,8,4,2,2,11,6,5,14,jamaica
Harbour View,8,4,2,2,10,6,4,14,jamaica
Waterhouse,8,4,2,2,10,8,2,14,jamaica
Cavalier,8,4,2,2,12,11,1,14,jamaica
Mount Pleasant,8,2,4,2,11,8,3,10,jamaica
Dunbeholden,8,3,1,4,12,12,0,10,jamaica
Molynes Utd,8,2,3,3,14,13,1,9,jamaica
Humble Lions,8,2,3,3,5,6,-1,9,jamaica
Tivoli Gardens,8,2,1,5,12,18,-6,7,jamaica
Faulkland,8,1,4,3,7,13,-6,7,jamaica
Vere Utd,8,1,3,4,9,11,-2,6,jamaica
Montego Bay,8,0,4,4,3,14,-11,4,jamaica
Chapelton,8,0,2,6,6,26,-20,2,jamaica
Avispa Fukuoka,8,6,0,2,12,9,3,18,japan
Yokohama M.,8,4,2,2,13,11,2,14,japan
Vissel Kobe,8,4,2,2,9,8,1,14,japan
Albirex Niigata,8,4,2,2,7,6,1,14,japan
Urawa RD,8,3,3,2,8,7,1,12,japan
Kashiwa Reysol,8,3,2,3,8,10,-2,11,japan
Shonan Bellmare,8,3,2,3,10,13,-3,11,japan
K. Frontale,8,2,3,3,9,12,-3,9,japan
Cerezo Osaka,8,2,2,4,7,8,-1,8,japan
S. Hiroshima,8,2,2,4,4,6,-2,8,japan
Gamba Osaka,8,2,2,4,8,15,-7,8,japan
Sagan Tosu,8,1,4,3,14,11,3,7,japan
Kashima Antlers,8,1,4,3,8,10,-2,7,japan
Kyoto Sanga,8,1,3,4,9,12,-3,6,japan
Yokohama FC,8,1,3,4,8,14,-6,6,japan
FC Tokyo,8,1,2,5,5,10,-5,5,japan
C. Sapporo,8,0,4,4,7,17,-10,4,japan
Nagoya G.,8,1,0,7,5,14,-9,3,japan
Machida Zelvia,8,5,2,1,18,5,13,17,japan2
JEF Utd Chiba,8,5,1,2,19,11,8,16,japan2
Tokyo Verdy,8,4,4,0,12,5,7,16,japan2
Shimizu S-Pulse,8,4,3,1,16,7,9,15,japan2
Blaublitz Akita,8,4,1,3,11,8,3,13,japan2
Jubilo Iwata,8,4,1,3,10,7,3,13,japan2
Iwaki,8,4,1,3,13,11,2,13,japan2
Tokushima V.,8,3,4,1,11,9,2,13,japan2
Omiya Ardija,8,4,1,3,10,12,-2,13,japan2
M. Yamagata,8,4,1,3,9,14,-5,13,japan2
V-V. Nagasaki,8,2,4,2,14,13,1,10,japan2
R. Kumamoto,8,3,1,4,8,8,0,10,japan2
Fagiano Okayama,8,2,4,2,9,10,-1,10,japan2
Mito Hollyhock,8,2,3,3,7,12,-5,9,japan2
Tochigi SC,8,2,2,4,4,9,-5,8,japan2
Oita Trinita,8,1,4,3,10,12,-2,7,japan2
Ventforet Kofu,8,1,4,3,9,12,-3,7,japan2
Kusatsu,8,2,1,5,8,13,-5,7,japan2
Vegalta Sendai,8,2,1,5,10,16,-6,7,japan2
Fujieda MYFC,8,1,3,4,8,14,-6,6,japan2
Z. Kanazawa,8,1,2,5,6,11,-5,5,japan2
R. Yamaguchi,8,0,2,6,3,15,-12,2,japan2
Al Hussein,3,3,0,0,8,0,8,9,jordan
Al Ramtha,4,2,0,2,7,3,4,6,jordan
Al Wihdat,2,2,0,0,2,0,2,6,jordan
Al Faysali,3,2,0,1,4,3,1,6,jordan
Moghayer Al S.,3,1,2,0,6,4,2,5,jordan
Aqaba,2,1,1,0,1,0,1,4,jordan
Al Salt,4,1,1,2,5,5,0,4,jordan
Al Jalil,4,1,1,2,4,8,-4,4,jordan
Maan,4,1,1,2,3,8,-5,4,jordan
Sahab,3,0,3,0,6,6,0,3,jordan
Al Ahli,4,0,0,4,1,6,-5,0,jordan
Shabab Al Ordon,4,0,0,4,0,11,-11,0,jordan
Ordabasy,8,4,2,2,12,7,5,14,kazakhstan
Aktobe,8,3,5,0,8,5,3,14,kazakhstan
Zhetysu,8,4,2,2,11,9,2,14,kazakhstan
Maqtaaral,8,3,3,2,9,7,2,12,kazakhstan
Kaisar K.,8,3,3,2,9,8,1,12,kazakhstan
FC Astana,8,3,2,3,6,7,-1,11,kazakhstan
Kairat Almaty,8,2,3,3,7,9,-2,9,kazakhstan
Okzhetpes,8,3,0,5,7,13,-6,9,kazakhstan
Tobol,8,1,3,4,9,12,-3,6,kazakhstan
Atyrau,8,1,3,4,7,10,-3,6,kazakhstan
S. Karagandy,8,1,3,4,8,13,-5,6,kazakhstan
Kyzylzhar,8,1,2,5,7,13,-6,5,kazakhstan
Kaspiy Aktau,8,0,3,5,8,15,-7,3,kazakhstan
Aksu,8,0,1,7,4,16,-12,1,kazakhstan
Ballkani,5,3,2,0,8,2,6,11,kosovo
Drita,7,3,2,2,7,4,3,11,kosovo
Llapi,7,3,2,2,11,9,2,11,kosovo
Malisheva,7,2,2,3,5,7,-2,8,kosovo
Dukagjini,7,1,4,2,12,16,-4,7,kosovo
Prishtina,7,0,5,2,4,8,-4,5,kosovo
Feronikeli,7,1,1,5,9,16,-7,4,kosovo
Liria,7,0,3,4,3,11,-8,3,kosovo
Fushe Kosova,7,0,1,6,3,15,-12,1,kosovo
Gjilani,7,0,0,7,3,12,-9,0,kosovo
Al Qadsia,4,4,0,0,8,1,7,12,kuwait
Al Kuwait,3,2,1,0,10,4,6,7,kuwait
Kazma,3,2,1,0,8,4,4,7,kuwait
Al Arabi SC,4,1,2,1,6,7,-1,5,kuwait
Al Shabab,3,1,1,1,3,6,-3,4,kuwait
Al Nasar,3,1,0,2,6,7,-1,3,kuwait
Al Salmiyah,3,1,0,2,4,6,-2,3,kuwait
Khaitan,4,0,2,2,3,9,-6,2,kuwait
Al Fahaheel,4,0,1,3,2,9,-7,1,kuwait
Al Jahra,4,0,0,4,3,9,-6,0,kuwait
Riga FC,8,6,2,0,21,4,17,20,latvia
RFS,8,5,2,1,19,10,9,17,latvia
Auda,8,4,2,2,10,8,2,14,latvia
FS Jelgava,8,3,4,1,11,10,1,13,latvia
Valmiera,8,3,2,3,10,11,-1,11,latvia
Liepaja,8,2,3,3,10,12,-2,9,latvia
Daugavpils,8,2,1,5,4,12,-8,7,latvia
Super Nova,8,1,3,4,5,13,-8,6,latvia
Metta / LU,8,1,1,6,8,18,-10,4,latvia
Tukums,8,1,1,6,6,24,-18,4,latvia
Panevezys,8,5,3,0,12,4,8,18,lithuania
Zalgiris,8,5,1,2,19,9,10,16,lithuania
Kauno Zalgiris,8,4,4,0,17,7,10,16,lithuania
Hegelmann L.,8,4,1,3,14,18,-4,13,lithuania
Riteriai,8,3,1,4,10,11,-1,10,lithuania
FA Siauliai,8,2,3,3,10,14,-4,9,lithuania
Dziugas Telsiai,8,1,5,2,3,6,-3,8,lithuania
Suduva,8,2,1,5,8,15,-7,7,lithuania
Banga,8,2,0,6,3,11,-8,6,lithuania
Dainava,8,1,2,5,5,10,-5,5,lithuania
Be1 NFA,8,6,1,1,11,2,9,19,lithuania2
Neptuna K.,8,5,1,2,19,12,7,16,lithuania2
Riteriai B,8,4,3,1,16,11,5,15,lithuania2
TransINVEST,8,4,2,2,17,10,7,14,lithuania2
BFA Vilnius,8,3,2,3,16,11,5,11,lithuania2
Ekranas,8,3,1,4,11,16,-5,10,lithuania2
Babrungas,8,3,1,4,12,19,-7,10,lithuania2
Minija,8,3,0,5,10,14,-4,9,lithuania2
Zalgiris B,8,2,2,4,11,16,-5,8,lithuania2
Garliava,8,1,4,3,10,12,-2,7,lithuania2
Marijampole C.,8,2,1,5,10,21,-11,7,lithuania2
Nevezis,8,1,3,4,8,14,-6,6,lithuania2
FA Siauliai B,8,2,0,6,10,25,-15,6,lithuania2
Panevezys B,8,1,2,5,14,25,-11,5,lithuania2
Kauno Z. B,8,1,2,5,6,19,-13,5,lithuania2
Jonava,8,1,1,6,11,20,-9,4,lithuania2
Hesperang,7,4,0,3,15,7,8,12,luxembourg
Differdange,6,2,4,0,10,7,3,10,luxembourg
Jeunesse Esch,5,2,2,1,7,5,2,8,luxembourg
V. Rosport,5,2,2,1,9,8,1,8,luxembourg
Wiltz,6,2,2,2,8,9,-1,8,luxembourg
Mondercange,6,2,2,2,6,10,-4,8,luxembourg
Racing,6,2,1,3,9,9,0,7,luxembourg
Marisca Mersch,6,2,1,3,10,11,-1,7,luxembourg
Dudelange,6,2,1,3,8,10,-2,7,luxembourg
Niedercorn,6,1,3,2,10,12,-2,6,luxembourg
UNA Strassen,5,1,2,2,7,7,0,5,luxembourg
UN Käerjéng,6,1,1,4,10,14,-4,4,luxembourg
Schifflange,6,1,1,4,6,13,-7,4,luxembourg
Petange,6,1,1,4,5,12,-7,4,luxembourg
Mondorf,6,0,3,3,8,14,-6,3,luxembourg
Fola Esch,6,1,0,5,7,17,-10,3,luxembourg
Johor Darul,8,7,1,0,25,5,20,22,malaysia
Terengganu,8,4,4,0,24,8,16,16,malaysia
Selangor,8,5,0,3,30,7,23,15,malaysia
Pahang,8,5,0,3,15,11,4,15,malaysia
Kedah,8,5,0,3,10,12,-2,15,malaysia
PDRM,8,4,1,3,14,17,-3,13,malaysia
Kuala Lumpur,8,3,1,4,13,16,-3,10,malaysia
Perak,8,3,0,5,7,16,-9,9,malaysia
Sabah,8,2,1,5,7,12,-5,7,malaysia
Negeri Sembilan,8,0,3,5,7,17,-10,3,malaysia
Kelantan United,8,0,3,5,7,19,-12,3,malaysia
Kuching,8,0,2,6,10,17,-7,2,malaysia
Pulau Pinang,8,0,2,6,2,13,-11,2,malaysia
Kelantan,8,0,1,7,8,37,-29,1,malaysia
Valletta,8,6,1,1,20,8,12,19,malta
Hamrun Spartans,8,6,1,1,14,7,7,19,malta
Balzan,8,6,1,1,14,8,6,19,malta
Gzira Utd,8,5,2,1,16,3,13,17,malta
Mosta,8,5,1,2,14,8,6,16,malta
Hibernians,8,5,0,3,16,12,4,15,malta
Floriana,8,4,1,3,14,8,6,13,malta
Sirens,8,4,1,3,6,7,-1,13,malta
Birkirkara,8,3,3,2,13,8,5,12,malta
Marsaxlokk,8,2,4,2,10,9,1,10,malta
Gudja Utd,8,1,3,4,6,13,-7,6,malta
Pieta Hotspurs,8,1,2,5,9,16,-7,5,malta
Zebbug Rangers,8,1,1,6,4,19,-15,4,malta
Santa Lucia,8,1,0,7,6,17,-11,3,malta
CF America,7,5,2,0,12,5,7,17,mexico
Monterrey,8,4,2,2,9,6,3,14,mexico
Puebla,8,4,2,2,10,10,0,14,mexico
Tigres,8,3,2,3,13,10,3,11,mexico
Guadalajara,8,3,2,3,9,11,-2,11,mexico
Pachuca,8,3,2,3,7,16,-9,11,mexico
Cruz Azul,8,3,1,4,11,11,0,10,mexico
Queretaro,8,3,0,5,9,20,-11,9,mexico
Pumas UNAM,8,2,2,4,10,11,-1,8,mexico
Mazatlan,8,2,2,4,11,15,-4,8,mexico
Atlas,8,2,2,4,7,15,-8,8,mexico
A. San Luis,8,2,1,5,13,17,-4,7,mexico
Santos Laguna,8,2,1,5,15,20,-5,7,mexico
Toluca,8,1,3,4,7,10,-3,6,mexico
Necaxa,8,1,3,4,9,16,-7,6,mexico
Club Leon,8,1,2,5,9,15,-6,5,mexico
Juarez,8,1,1,6,9,21,-12,4,mexico
Tijuana,8,0,1,7,3,15,-12,1,mexico
Monterrey,8,6,1,1,14,7,7,19,mexico2
CF America,8,5,3,0,19,10,9,18,mexico2
Pachuca,8,6,0,2,15,9,6,18,mexico2
Guadalajara,8,4,3,1,12,8,4,15,mexico2
Tigres,8,4,2,2,9,7,2,14,mexico2
Club Leon,8,3,4,1,9,7,2,13,mexico2
Atlas,8,2,5,1,14,9,5,11,mexico2
Toluca,8,3,2,3,14,11,3,11,mexico2
Queretaro,8,2,3,3,6,9,-3,9,mexico2
Puebla,8,2,2,4,11,13,-2,8,mexico2
Cruz Azul,8,2,2,4,10,12,-2,8,mexico2
Santos Laguna,8,1,3,4,9,16,-7,6,mexico2
Juarez,8,1,3,4,7,15,-8,6,mexico2
Pumas UNAM,8,1,2,5,7,15,-8,5,mexico2
Necaxa,8,1,1,6,6,13,-7,4,mexico2
Tijuana,8,1,1,6,9,21,-12,4,mexico2
Mazatlan,8,1,1,6,8,23,-15,4,mexico2
A. San Luis,8,0,1,7,3,14,-11,1,mexico2
SP Falcons,5,5,0,0,12,0,12,15,mongolia
Khoromkhon,5,4,0,1,12,11,1,12,mongolia
Deren,5,3,2,0,13,3,10,11,mongolia
FC Ulaanbaatar,4,3,0,1,9,2,7,9,mongolia
Erchim,5,2,2,1,15,14,1,8,mongolia
Bavarians,4,2,0,2,7,11,-4,6,mongolia
Khangarid,5,1,2,2,12,8,4,5,mongolia
Tuv Buganuud,3,1,1,1,9,10,-1,4,mongolia
Khovd,4,0,1,3,3,11,-8,1,mongolia
Bayanzurkh S.,4,0,0,4,2,13,-11,0,mongolia
Decic,8,6,2,0,10,3,7,20,montenegro
Buducnost,8,4,2,2,15,8,7,14,montenegro
Jezero,8,3,5,0,10,7,3,14,montenegro
Sutjeska,8,2,5,1,9,5,4,11,montenegro
Mornar,8,2,5,1,7,7,0,11,montenegro
Arsenal Tivat,8,2,3,3,9,11,-2,9,montenegro
Petrovac,8,2,2,4,9,11,-2,8,montenegro
Rudar,7,2,0,5,2,8,-6,6,montenegro
Jedinstvo,8,0,3,5,11,17,-6,3,montenegro
Mladost DG,8,0,3,5,8,16,-8,3,montenegro
Wydad,3,2,1,0,6,2,4,7,morocco
Raja Casablanca,5,1,4,0,7,5,2,7,morocco
FUS Rabat,5,2,1,2,6,5,1,7,morocco
Moghreb Tetouan,5,2,1,2,5,4,1,7,morocco
Maghreb de Fes,4,1,3,0,6,4,2,6,morocco
Berkane,4,1,3,0,4,2,2,6,morocco
Union Touarga,4,2,0,2,5,4,1,6,morocco
Olympic Safi,4,1,2,1,4,4,0,5,morocco
C. Mohammedia,5,1,2,2,3,5,-2,5,morocco
FAR Rabat,4,1,1,2,6,5,1,4,morocco
R. Zemamra,5,1,1,3,7,10,-3,4,morocco
Mouloudia Oujda,4,0,3,1,2,4,-2,3,morocco
Salmi,4,1,0,3,2,8,-6,3,morocco
Ittihad Tanger,4,0,2,2,4,6,-2,2,morocco
Hassania Agadir,5,0,2,3,2,7,-5,2,morocco
Youssoufia B.,4,0,0,4,3,10,-7,0,morocco
Meknes,6,3,2,1,7,5,2,11,morocco2
Chabab Atlas K.,6,2,3,1,4,3,1,9,morocco2
Difaa El Jadida,6,2,3,1,3,2,1,9,morocco2
Ittifaq M.,6,2,2,2,4,6,-2,8,morocco2
C. Benguerir,5,2,1,2,4,4,0,7,morocco2
El Massira,5,1,3,1,5,5,0,6,morocco2
Kawkab M.,4,2,0,2,4,5,-1,6,morocco2
Dcheira,4,1,2,1,5,5,0,5,morocco2
Khouribga,5,1,2,2,3,4,-1,5,morocco2
R. Beni Mellal,4,1,1,2,6,5,1,4,morocco2
Stade Marocain,5,0,4,1,4,6,-2,4,morocco2
RAC Casablanca,5,1,1,3,3,5,-2,4,morocco2
Rapide Oued Z.,5,1,1,3,2,5,-3,4,morocco2
USM Oujda,5,0,3,2,4,8,-4,3,morocco2
Wydad Fès,4,0,2,2,2,5,-3,2,morocco2
AS Salé,5,0,1,4,4,11,-7,1,morocco2
Yangon Utd,8,7,0,1,22,5,17,21,myanmar
Shan Utd,8,6,2,0,19,6,13,20,myanmar
Rakhine Utd,8,4,2,2,15,13,2,14,myanmar
Myawady,8,4,2,2,11,12,-1,14,myanmar
Hantharwady,8,4,1,3,12,9,3,13,myanmar
Ispe FC,8,3,3,2,13,11,2,12,myanmar
Dagon,8,2,3,3,6,8,-2,9,myanmar
Sagaing Utd,8,2,2,4,10,20,-10,8,myanmar
Ayeyawady,8,2,1,5,8,18,-10,7,myanmar
Yadanarbon,8,1,2,5,10,16,-6,5,myanmar
Kachin Utd,8,1,1,6,8,18,-10,4,myanmar
Chinland,8,0,1,7,6,31,-25,1,myanmar
PSV Eindhoven,5,5,0,0,21,1,20,15,netherlands
Feyenoord,6,4,1,1,16,6,10,13,netherlands
AZ Alkmaar,6,4,1,1,11,4,7,13,netherlands
FC Twente,6,3,2,1,12,5,7,11,netherlands
Sparta,6,3,1,2,10,7,3,10,netherlands
Excelsior,6,2,2,2,11,11,0,8,netherlands
Almere City,6,2,2,2,7,10,-3,8,netherlands
PEC Zwolle,6,2,1,3,9,13,-4,7,netherlands
Vitesse Arnhem,6,2,0,4,6,13,-7,6,netherlands
Heerenveen,7,2,0,5,9,18,-9,6,netherlands
Go Ahead Eagles,6,1,2,3,4,12,-8,5,netherlands
FC Utrecht,6,1,1,4,3,8,-5,4,netherlands
NEC Nijmegen,5,0,3,2,6,11,-5,3,netherlands
Ajax Amsterdam,6,0,3,3,10,16,-6,3,netherlands
RKC Waalwijk,5,1,0,4,3,9,-6,3,netherlands
Fortuna Sittard,6,0,2,4,3,14,-11,2,netherlands
Heracles Almelo,6,0,2,4,5,18,-13,2,netherlands
FC Volendam,6,0,1,5,7,17,-10,1,netherlands
ADO Den Haag,8,5,3,0,12,5,7,18,netherlands2
FC Eindhoven,7,4,2,1,9,6,3,14,netherlands2
FC Emmen,7,3,4,0,11,7,4,13,netherlands2
VVV,7,3,3,1,10,9,1,12,netherlands2
De Graafschap,7,4,0,3,11,13,-2,12,netherlands2
MVV Maastricht,8,3,2,3,14,13,1,11,netherlands2
Cambuur,7,3,1,3,19,15,4,10,netherlands2
Roda JC,6,2,3,1,8,4,4,9,netherlands2
FC Dordrecht,6,2,3,1,9,8,1,9,netherlands2
Jong PSV,6,3,0,3,11,16,-5,9,netherlands2
Willem II,6,2,2,2,4,3,1,8,netherlands2
NAC Breda,7,2,2,3,11,12,-1,8,netherlands2
Helmond Sport,7,2,1,4,11,12,-1,7,netherlands2
FC Groningen,7,2,1,4,8,9,-1,7,netherlands2
FC Den Bosch,7,1,0,6,7,17,-10,3,netherlands2
Jong AZ,6,0,2,4,6,13,-7,2,netherlands2
Jong Utrecht,8,0,2,6,6,19,-13,2,netherlands2
TOP Oss,7,0,1,6,3,12,-9,1,netherlands2
Telstar,7,0,1,6,3,14,-11,1,netherlands2
Jong Ajax,8,0,1,7,10,25,-15,1,netherlands2
Real Esteli,8,5,2,1,18,5,13,17,nicaragua
Diriangen,8,5,1,2,13,7,6,16,nicaragua
UNAN Managua,8,3,2,3,11,13,-2,11,nicaragua
Export Sebaco,8,3,1,4,8,17,-9,10,nicaragua
Managua FC,8,1,5,2,8,8,0,8,nicaragua
Jalapa,8,2,2,4,11,16,-5,8,nicaragua
D. Ocotal,8,1,1,6,9,16,-7,4,nicaragua
Matagalpa,8,1,1,6,9,16,-7,4,nicaragua
Walter Ferreti,8,0,2,6,4,15,-11,2,nicaragua
O. Masachapa,8,0,2,6,2,17,-15,2,nicaragua
Bendel,8,2,6,0,8,6,2,12,nigeria
Enyimba,8,3,1,4,6,7,-1,10,nigeria
Akwa Utd,8,2,3,3,9,8,1,9,nigeria
Remo Stars,8,2,3,3,7,12,-5,9,nigeria
Rivers Utd,8,1,5,2,9,10,-1,8,nigeria
Plateau Utd,8,1,3,4,11,14,-3,6,nigeria
Lobi Stars,8,1,3,4,4,10,-6,6,nigeria
Sunshine Stars,8,1,2,5,7,10,-3,5,nigeria
Enugu Rangers,8,0,5,3,4,7,-3,5,nigeria
Bayelsa Utd,8,1,2,5,7,13,-6,5,nigeria
Shooting Stars,8,1,2,5,3,10,-7,5,nigeria
Niger Tornadoes,8,1,1,6,6,13,-7,4,nigeria
Wikki Tourist,8,1,1,6,4,13,-9,4,nigeria
Gombe Utd,8,0,4,4,1,12,-11,4,nigeria
Kwara Utd,8,1,1,6,4,16,-12,4,nigeria
Abia Warriors,8,1,1,6,6,19,-13,4,nigeria
Nasarawa Utd,8,0,3,5,4,10,-6,3,nigeria
Doma Utd,8,0,3,5,2,10,-8,3,nigeria
El Kanemi,8,1,0,7,3,16,-13,3,nigeria
Dakkada,8,0,0,8,2,15,-13,0,nigeria
Linfield,8,7,0,1,15,6,9,21,northernireland
Crusaders,8,5,2,1,19,8,11,17,northernireland
Cliftonville,8,5,0,3,13,6,7,15,northernireland
Larne,8,4,3,1,11,5,6,15,northernireland
Glentoran,8,4,2,2,10,7,3,14,northernireland
Coleraine,8,4,1,3,11,14,-3,13,northernireland
Loughgall,7,3,2,2,11,15,-4,11,northernireland
Carrick Rangers,8,3,1,4,15,27,-12,10,northernireland
Newry City,8,3,0,5,10,18,-8,9,northernireland
Glenavon,8,2,1,5,11,19,-8,7,northernireland
Ballymena Utd,7,2,0,5,5,12,-7,6,northernireland
Dungannon,8,0,4,4,8,17,-9,4,northernireland
Dundela,8,5,1,2,14,12,2,16,northernireland2
Portadown,7,4,0,3,10,7,3,12,northernireland2
Ards,7,3,2,2,11,10,1,11,northernireland2
Bangor,8,3,1,4,13,12,1,10,northernireland2
Ballinamallard,8,3,1,4,12,12,0,10,northernireland2
Institute,6,3,1,2,9,9,0,10,northernireland2
Newington Youth,7,3,0,4,13,13,0,9,northernireland2
Annagh Utd,8,2,2,4,8,16,-8,8,northernireland2
H&W Welders,7,1,2,4,9,13,-4,5,northernireland2
Ballyclare,6,1,1,4,8,14,-6,4,northernireland2
Dergview,7,1,1,5,12,21,-9,4,northernireland2
Knockbreda,8,0,1,7,4,21,-17,1,northernireland2
Skendija,7,4,1,2,11,8,3,13,northmacedonia
Struga,7,3,0,4,9,8,1,9,northmacedonia
Shkupi,7,2,3,2,7,8,-1,9,northmacedonia
Gostivar,7,2,1,4,7,12,-5,7,northmacedonia
Sileks,7,1,3,3,7,10,-3,6,northmacedonia
Voska Sport,7,1,3,3,7,12,-5,6,northmacedonia
A. Pandev,7,1,2,4,4,7,-3,5,northmacedonia
Makedonija,7,1,1,5,7,11,-4,4,northmacedonia
Tikves,7,1,1,5,5,9,-4,4,northmacedonia
Vardar,7,1,1,5,3,11,-8,4,northmacedonia
Rabotnicki,7,1,1,5,2,10,-8,4,northmacedonia
Bregalnica Stip,7,0,1,6,1,9,-8,1,northmacedonia
Bodo / Glimt,8,5,2,1,24,12,12,17,norway
Brann,8,5,1,2,11,7,4,16,norway
Tromso,8,5,0,3,15,13,2,15,norway
Viking,8,4,1,3,9,10,-1,13,norway
Molde,8,3,3,2,15,12,3,12,norway
HamKam,8,4,0,4,11,14,-3,12,norway
Stromsgodset,8,3,0,5,4,8,-4,9,norway
Rosenborg,8,3,0,5,11,19,-8,9,norway
Valerenga,8,2,2,4,11,14,-3,8,norway
Odd,8,2,1,5,12,16,-4,7,norway
Haugesund,8,1,3,4,7,9,-2,6,norway
Sandefjord,8,2,0,6,17,24,-7,6,norway
Stabaek,8,0,4,4,7,14,-7,4,norway
Sarpsborg 08,8,1,1,6,11,22,-11,4,norway
Lillestrom,8,1,1,6,6,17,-11,4,norway
Aalesund,8,1,0,7,7,28,-21,3,norway
Kristiansund,8,5,2,1,18,8,10,17,norway2
Fredrikstad,8,5,2,1,18,11,7,17,norway2
KFUM Oslo,8,5,2,1,13,7,6,17,norway2
Kongsvinger,8,4,2,2,17,12,5,14,norway2
Raufoss,8,4,1,3,12,14,-2,13,norway2
Ranheim,8,4,0,4,8,13,-5,12,norway2
Sogndal,8,3,1,4,13,15,-2,10,norway2
Bryne,8,3,0,5,10,11,-1,9,norway2
Jerv,8,2,2,4,13,20,-7,8,norway2
Sandnes Ulf,8,2,2,4,5,14,-9,8,norway2
Hodd,8,2,1,5,3,10,-7,7,norway2
Asane,8,1,3,4,10,15,-5,6,norway2
Moss,8,1,3,4,7,12,-5,6,norway2
Mjondalen,8,1,3,4,6,11,-5,6,norway2
Start,8,1,2,5,5,10,-5,5,norway2
Skeid,8,0,1,7,0,14,-14,1,norway2
Al Seeb,5,4,1,0,11,0,11,13,oman
Sohar,5,3,1,1,9,4,5,10,oman
Al-Nahda,5,2,3,0,10,7,3,9,oman
Al-Shabab Club,5,2,2,1,7,6,1,8,oman
Al Wehda,4,2,1,1,5,5,0,7,oman
Al Nasr,5,2,1,2,4,4,0,7,oman
Ibri,4,2,0,2,5,4,1,6,oman
Al-Rustaq,4,1,2,1,4,4,0,5,oman
Sur,4,1,1,2,2,3,-1,4,oman
Dhofar,4,1,1,2,6,8,-2,4,oman
Oman Club,4,1,1,2,3,6,-3,4,oman
Bahla,5,1,0,4,1,7,-6,3,oman
Independiente,8,4,2,2,15,10,5,14,panama
Plaza Amador,8,4,2,2,13,9,4,14,panama
Arabe Unido,8,3,3,2,8,5,3,12,panama
San Miguelito,8,3,3,2,7,5,2,12,panama
Tauro,8,3,3,2,7,7,0,12,panama
Herrera,8,2,4,2,8,7,1,10,panama
Alianza,8,2,2,4,5,10,-5,8,panama
UMECIT,8,1,4,3,2,7,-5,7,panama
San Francisco,8,1,4,3,3,9,-6,7,panama
Costa del Este,8,2,1,5,9,17,-8,7,panama
Universitario,8,2,1,5,7,15,-8,7,panama
A. Chiriqui,8,0,0,8,5,22,-17,0,panama
Tauro,8,4,3,1,14,5,9,15,panama2
Independiente,8,4,3,1,18,11,7,15,panama2
San Francisco,8,4,1,3,10,5,5,13,panama2
Arabe Unido,8,3,3,2,9,6,3,12,panama2
Alianza,8,3,3,2,9,11,-2,12,panama2
Costa del Este,8,3,2,3,10,11,-1,11,panama2
San Miguelito,8,2,3,3,8,9,-1,9,panama2
Universitario,8,2,3,3,8,14,-6,9,panama2
UMECIT,8,2,1,5,10,13,-3,7,panama2
Herrera,8,2,1,5,10,16,-6,7,panama2
Plaza Amador,8,1,1,6,7,12,-5,4,panama2
A. Chiriqui,8,0,2,6,1,28,-27,2,panama2
S. Ameliano,8,4,2,2,10,7,3,14,paraguay
Cerro Porteno,8,4,2,2,14,14,0,14,paraguay
Libertad,8,4,1,3,12,9,3,13,paraguay
Guarani,8,3,4,1,10,8,2,13,paraguay
Olimpia,8,3,2,3,10,8,2,11,paraguay
S. Trinidense,8,3,2,3,10,9,1,11,paraguay
Nacional,8,3,2,3,8,10,-2,11,paraguay
S. Luqueno,8,2,3,3,12,14,-2,9,paraguay
G. Caballero,8,2,2,4,6,11,-5,8,paraguay
Guairena,8,1,4,3,6,10,-4,7,paraguay
Resistencia,8,1,1,6,4,15,-11,4,paraguay
Tacuary,8,1,0,7,2,10,-8,3,paraguay
Libertad,8,5,3,0,16,5,11,18,paraguay2
S. Trinidense,8,4,1,3,13,9,4,13,paraguay2
Cerro Porteno,8,2,5,1,14,9,5,11,paraguay2
Olimpia,8,3,2,3,4,7,-3,11,paraguay2
Tacuary,8,2,3,3,9,11,-2,9,paraguay2
Guarani,8,2,3,3,6,11,-5,9,paraguay2
Nacional,8,1,5,2,7,7,0,8,paraguay2
S. Ameliano,8,2,2,4,14,17,-3,8,paraguay2
S. Luqueno,8,2,1,5,7,11,-4,7,paraguay2
G. Caballero,8,2,1,5,8,13,-5,7,paraguay2
Guairena,8,1,3,4,4,10,-6,6,paraguay2
Resistencia,8,1,1,6,6,20,-14,4,paraguay2
Alianza Lima,8,5,0,3,12,9,3,15,peru
S. Cristal,8,3,4,1,15,10,5,13,peru
Universitario,8,3,1,4,8,9,-1,10,peru
Carlos Manucci,8,3,0,5,5,13,-8,9,peru
D. Garcilaso,8,2,2,4,12,13,-1,8,peru
FBC Melgar,8,1,5,2,7,8,-1,8,peru
D. Municipal,8,2,2,4,6,9,-3,8,peru
Sport Huancayo,8,2,2,4,10,14,-4,8,peru
Cusco,8,2,2,4,8,12,-4,8,peru
ADT,8,1,3,4,9,12,-3,6,peru
Cienciano,8,2,0,6,9,19,-10,6,peru
Sport Boys,8,1,2,5,3,11,-8,5,peru
Cajamarca,8,1,2,5,8,17,-9,5,peru
Alianza A.,8,1,1,6,12,20,-8,4,peru
Cesar Vallejo,8,0,4,4,5,15,-10,4,peru
Union Comercio,8,1,1,6,7,20,-13,4,peru
Atletico Grau,8,0,2,6,7,14,-7,2,peru
Binacional,8,0,2,6,6,18,-12,2,peru
AD Cantolao,8,0,1,7,2,21,-19,1,peru
FBC Melgar,8,6,2,0,10,3,7,20,peru2
Alianza Lima,8,4,3,1,9,5,4,15,peru2
Cesar Vallejo,8,4,1,3,12,6,6,13,peru2
Universitario,8,3,4,1,9,6,3,13,peru2
ADT,8,3,4,1,9,7,2,13,peru2
D. Garcilaso,8,2,4,2,9,9,0,10,peru2
S. Cristal,8,2,4,2,8,10,-2,10,peru2
Sport Boys,8,2,2,4,5,12,-7,8,peru2
AD Cantolao,8,2,1,5,6,11,-5,7,peru2
Union Comercio,8,1,3,4,7,15,-8,6,peru2
Sport Huancayo,8,1,2,5,5,10,-5,5,peru2
Cienciano,8,1,2,5,8,14,-6,5,peru2
Atletico Grau,8,1,2,5,5,14,-9,5,peru2
Cajamarca,8,0,4,4,6,14,-8,4,peru2
Carlos Manucci,8,0,3,5,5,14,-9,3,peru2
D. Municipal,8,1,0,7,6,22,-16,3,peru2
Alianza A.,8,0,2,6,2,14,-12,2,peru2
Cusco,8,0,1,7,4,15,-11,1,peru2
Binacional,8,0,1,7,8,20,-12,1,peru2
Comerciantes U.,8,5,1,2,12,7,5,16,peru3
A. Huanuco,8,3,3,2,10,8,2,12,peru3
Santa Rosa,8,3,2,3,13,11,2,11,peru3
Llacuabamba,8,3,2,3,14,15,-1,11,peru3
D. Coopsol,8,2,3,3,8,9,-1,9,peru3
Juan Aurich,8,2,2,4,6,9,-3,8,peru3
U. San Martin,8,1,4,3,9,10,-1,7,peru3
Ayacucho,8,1,3,4,11,17,-6,6,peru3
Santos FC,8,1,3,4,7,13,-6,6,peru3
Comerciantes,8,1,2,5,3,11,-8,5,peru3
Alfonso Ugarte,8,0,3,5,4,18,-14,3,peru3
Huaral,8,0,2,6,3,12,-9,2,peru3
Carlos Stein,8,0,2,6,10,34,-24,2,peru3
M. El Pirata,8,0,1,7,3,30,-27,1,peru3
Kaya,8,7,1,0,29,5,24,22,philippines
Cebu FC,8,6,2,0,19,8,11,20,philippines
Stallion,8,4,1,3,12,5,7,13,philippines
United City,6,3,1,2,18,10,8,10,philippines
Mendiola,8,3,0,5,9,15,-6,9,philippines
Azkals,8,2,0,6,7,20,-13,6,philippines
Maharlika,8,1,0,7,4,24,-20,3,philippines
Slask Wroclaw,8,5,2,1,13,7,6,17,poland
Pogon Szczecin,7,4,1,2,11,3,8,13,poland
Warta Poznan,7,3,2,2,9,7,2,11,poland
Radomiak Radom,8,3,1,4,9,12,-3,10,poland
Cracovia Krakow,7,2,3,2,6,6,0,9,poland
Jagiellonia,8,2,3,3,14,16,-2,9,poland
Lech Poznan,7,2,3,2,7,11,-4,9,poland
Gornik Zabrze,8,2,2,4,11,12,-1,8,poland
Legia Warsaw,6,2,2,2,7,11,-4,8,poland
Piast Gliwice,8,0,7,1,7,8,-1,7,poland
Rakow C.,6,2,1,3,11,13,-2,7,poland
Korona Kielce,7,1,3,3,6,9,-3,6,poland
Zaglebie Lubin,7,2,0,5,7,17,-10,6,poland
Widzew Lodz,8,0,4,4,9,14,-5,4,poland
Stal Mielec,7,1,1,5,5,12,-7,4,poland
Puszcza Niepolo,8,1,1,6,10,20,-10,4,poland
Ruch Chorzow,7,0,3,4,5,12,-7,3,poland
LKS Lodz,8,0,0,8,3,17,-14,0,poland
Polonia Warszaw,7,4,2,1,11,6,5,14,poland2
Arka Gdynia,8,4,1,3,12,11,1,13,poland2
T. Nieciecza,8,3,3,2,17,9,8,12,poland2
Miedz Legnica,7,3,3,1,13,8,5,12,poland2
Gornik Leczna,7,3,3,1,7,5,2,12,poland2
Lechia Gdansk,8,3,3,2,11,11,0,12,poland2
Motor Lublin,7,4,0,3,5,5,0,12,poland2
Odra Opole,6,3,1,2,10,8,2,10,poland2
Stal Rzeszow,7,3,1,3,9,9,0,10,poland2
Wisla Krakow,7,2,3,2,11,9,2,9,poland2
Tychy,8,3,0,5,7,12,-5,9,poland2
Z. Sosnowiec,8,1,4,3,5,7,-2,7,poland2
Katowice,8,1,4,3,8,12,-4,7,poland2
Wisla Plock,8,1,4,3,6,13,-7,7,poland2
Resovia Rzeszow,8,2,0,6,6,18,-12,6,poland2
Chrobry Glogow,7,1,2,4,7,12,-5,5,poland2
Znicz Pruszkow,8,1,1,6,5,14,-9,4,poland2
Podbeskidzie,7,0,2,5,3,13,-10,2,poland2
Radunia Stezyca,8,4,3,1,9,9,0,15,poland3
K. Kolobrzeg,8,4,2,2,21,15,6,14,poland3
Pogon Siedlce,8,4,2,2,14,9,5,14,poland3
Kalisz,8,3,2,3,9,9,0,11,poland3
Hutnik Krakow,8,3,1,4,9,11,-2,10,poland3
SKRA Czestochow,8,2,3,3,8,9,-1,9,poland3
Lech Poznan B,8,2,2,4,8,10,-2,8,poland3
Chojniczanka,8,2,2,4,11,14,-3,8,poland3
LKS Lodz B,8,2,2,4,10,13,-3,8,poland3
Stomil Olsztyn,8,2,0,6,8,14,-6,6,poland3
Olimpia Elblag,7,1,2,4,6,10,-4,5,poland3
Zaglebie L. B,8,1,2,5,10,15,-5,5,poland3
O. Grudziadz,8,1,2,5,9,18,-9,5,poland3
Stalowa Wola,8,1,2,5,3,13,-10,5,poland3
Wisla Pulawy,6,1,1,4,9,14,-5,4,poland3
Sandecja Nowy,8,1,1,6,5,14,-9,4,poland3
Jastrzebie,7,0,3,4,5,11,-6,3,poland3
Polonia Bytom,8,0,3,5,5,13,-8,3,poland3
Benfica,6,5,0,1,13,7,6,15,portugal
FC Porto,6,5,0,1,9,4,5,15,portugal
Sporting Braga,6,4,1,1,16,12,4,13,portugal
Moreirense,6,4,1,1,8,4,4,13,portugal
Sporting CP,5,3,1,1,9,6,3,10,portugal
Casa Pia,6,2,2,2,6,8,-2,8,portugal
Boavista,5,2,1,2,8,9,-1,7,portugal
Guimaraes,5,2,1,2,4,6,-2,7,portugal
Portimonense,6,2,1,3,7,16,-9,7,portugal
Farense,5,2,0,3,8,8,0,6,portugal
Famalicao,6,1,3,2,5,6,-1,6,portugal
Estrela Amadora,5,1,2,2,6,8,-2,5,portugal
Vizela,5,1,2,2,5,7,-2,5,portugal
Estoril,6,1,0,5,10,15,-5,3,portugal
Chaves,6,1,0,5,4,18,-14,3,portugal
Arouca,5,0,2,3,4,8,-4,2,portugal
Rio Ave,5,0,2,3,3,8,-5,2,portugal
Gil Vicente,5,0,0,5,5,12,-7,0,portugal
Maritimo,6,5,0,1,11,6,5,15,portugal2
AVS,5,4,0,1,8,5,3,12,portugal2
Torreense,5,2,2,1,6,5,1,8,portugal2
FC Porto B,5,2,1,2,12,7,5,7,portugal2
Uniao de Leiria,6,2,1,3,10,8,2,7,portugal2
Nacional,4,2,1,1,7,6,1,7,portugal2
Santa Clara,4,1,3,0,4,2,2,6,portugal2
Tondela,5,1,3,1,8,11,-3,6,portugal2
Leixoes,5,2,0,3,6,11,-5,6,portugal2
Oliveirense,4,2,0,2,4,9,-5,6,portugal2
Benfica B,5,1,2,2,7,7,0,5,portugal2
Mafra,6,1,2,3,6,8,-2,5,portugal2
Os Belenense,5,1,1,3,3,5,-2,4,portugal2
Pacos Ferreira,5,1,1,3,3,6,-3,4,portugal2
Vilaverdense,5,1,1,3,3,7,-4,4,portugal2
Academico Viseu,5,0,3,2,4,7,-3,3,portugal2
Feirense,5,1,0,4,4,10,-6,3,portugal2
Penafiel,5,0,1,4,1,7,-6,1,portugal2
Al Duhail,5,3,1,1,11,9,2,10,qatar
Al Sadd,3,3,0,0,8,2,6,9,qatar
Al Rayyan,5,3,0,2,11,9,2,9,qatar
Umm Salal,4,2,1,1,8,5,3,7,qatar
Al Gharafa,4,2,1,1,12,12,0,7,qatar
Al Shamal,5,1,3,1,8,8,0,6,qatar
Al Wakrah,2,1,1,0,3,0,3,4,qatar
Qatar SC,5,1,1,3,6,7,-1,4,qatar
Al Ahli Doha,3,1,0,2,6,9,-3,3,qatar
Al Arabi,2,0,0,2,4,6,-2,0,qatar
Al Muaidar,4,0,0,4,5,16,-11,0,qatar
Al Markhiya,4,0,0,4,2,16,-14,0,qatar
FCSB,8,5,2,1,17,9,8,17,romania
U. Cluj,8,3,5,0,15,10,5,14,romania
Rapid Bucharest,8,3,4,1,14,9,5,13,romania
Otelul,8,2,6,0,10,6,4,12,romania
Petrolul,8,2,5,1,7,4,3,11,romania
CFR Cluj,8,3,2,3,16,14,2,11,romania
P. Iasi,8,3,1,4,10,10,0,10,romania
Voluntari,8,2,4,2,11,12,-1,10,romania
Hermannstadt,8,1,6,1,9,8,1,9,romania
Univ. Craiova,8,2,3,3,8,10,-2,9,romania
Farul Constanta,7,3,0,4,8,13,-5,9,romania
U Craiova 1948,8,2,2,4,8,11,-3,8,romania
Sepsi OSK,8,2,1,5,7,9,-2,7,romania
UTA Arad,8,1,4,3,9,13,-4,7,romania
Din. Bucharest,8,1,1,6,6,17,-11,4,romania
Botosani,8,0,3,5,9,20,-11,3,romania
Zenit,8,5,2,1,15,6,9,17,russia
FC Krasnodar,8,3,4,1,11,6,5,13,russia
Rubin Kazan,7,4,1,2,8,7,1,13,russia
Dinamo Moscow,8,2,5,1,14,13,1,11,russia
Lokomotiv M.,7,3,2,2,11,10,1,11,russia
CSKA Moscow,8,1,5,2,12,13,-1,8,russia
Fakel Voronezh,8,2,2,4,6,11,-5,8,russia
Ural,7,2,1,4,7,13,-6,7,russia
Akhmat Grozny,8,2,1,5,5,11,-6,7,russia
Krylya Sovetov,7,1,2,4,8,13,-5,5,russia
Orenburg,8,1,2,5,7,15,-8,5,russia
Spartak Moscow,6,1,1,4,7,13,-6,4,russia
PFC Sochi,8,1,0,7,6,15,-9,3,russia
Nizhny Novgorod,7,0,2,5,3,10,-7,2,russia
Rostov,7,0,2,5,7,18,-11,2,russia
Baltika,8,0,1,7,4,13,-9,1,russia
Khimki,8,5,1,2,13,8,5,16,russia2
Makhachkala,8,4,3,1,6,2,4,15,russia2
Tyumen,8,4,2,2,10,8,2,14,russia2
Akron,8,4,2,2,7,5,2,14,russia2
Arsenal Tula,8,2,5,1,9,6,3,11,russia2
A. Vladikavkaz,8,2,4,2,9,11,-2,10,russia2
Leningradets,8,3,1,4,9,13,-4,10,russia2
Rodina Moskva,8,2,3,3,13,10,3,9,russia2
Neftekhimik,8,2,2,4,6,9,-3,8,russia2
V. Astrakhan,8,1,4,3,6,7,-1,7,russia2
Shinnik,8,2,1,5,10,18,-8,7,russia2
Sokol Saratov,8,2,1,5,9,18,-9,7,russia2
Chernomorets,8,1,3,4,5,12,-7,6,russia2
Kamaz,8,1,2,5,3,10,-7,5,russia2
Torpedo Moscow,8,0,4,4,3,9,-6,4,russia2
Urozhay,8,1,1,6,4,14,-10,4,russia2
Yenisey,8,0,2,6,5,13,-8,2,russia2
SKA Khabarovsk,8,0,1,7,4,15,-11,1,russia2
Al Nassr,7,6,0,1,22,7,15,18,saudiarabia
Al Hilal,6,5,1,0,17,5,12,16,saudiarabia
Al Ittihad,7,4,2,1,12,2,10,14,saudiarabia
Al Fateh,7,4,2,1,14,9,5,14,saudiarabia
Al Taawon,7,3,2,2,10,8,2,11,saudiarabia
Al Ittifaq,7,3,2,2,8,6,2,11,saudiarabia
Al Feiha,6,2,3,1,11,9,2,9,saudiarabia
Al Akhdoud,6,2,1,3,6,8,-2,7,saudiarabia
Al Khaleej,6,2,1,3,6,8,-2,7,saudiarabia
Al Ahli Jeddah,6,2,1,3,11,15,-4,7,saudiarabia
Al Wahda,6,2,0,4,8,14,-6,6,saudiarabia
Damak,7,1,2,4,7,11,-4,5,saudiarabia
Al Shabab,7,1,1,5,6,15,-9,4,saudiarabia
Al Riyadh,6,1,1,4,6,17,-11,4,saudiarabia
Al Raed,6,0,3,3,4,7,-3,3,saudiarabia
Al Hazm,7,0,3,4,7,16,-9,3,saudiarabia
Abha,6,0,1,5,5,16,-11,1,saudiarabia
Al Tai,7,0,1,6,5,17,-12,1,saudiarabia
Al Adalh,6,4,0,2,13,9,4,12,saudiarabia2
Al Orubah,5,4,0,1,7,3,4,12,saudiarabia2
Al Quadisiya,5,3,1,1,4,1,3,10,saudiarabia2
Jeddah,6,3,1,2,9,7,2,10,saudiarabia2
Ohod,5,3,0,2,8,6,2,9,saudiarabia2
Al Kholood,5,2,0,3,10,7,3,6,saudiarabia2
Al Najma,5,1,2,2,11,9,2,5,saudiarabia2
Al Faisaly,5,1,2,2,6,7,-1,5,saudiarabia2
Al Jabalain,5,1,2,2,4,6,-2,5,saudiarabia2
Al Arabi,4,1,1,2,8,7,1,4,saudiarabia2
Al Batin,5,1,1,3,2,4,-2,4,saudiarabia2
Al-Ain,6,1,1,4,4,11,-7,4,saudiarabia2
Al-Jndal,5,1,1,3,3,10,-7,4,saudiarabia2
Al Taraji,5,1,0,4,2,10,-8,3,saudiarabia2
Al Bukayriyah,4,0,2,2,1,3,-2,2,saudiarabia2
Al Qaisoma,5,0,1,4,5,12,-7,1,saudiarabia2
Hajer,4,0,1,3,2,9,-7,1,saudiarabia2
Al Safa,5,0,0,5,2,12,-10,0,saudiarabia2
Celtic,7,6,1,0,16,3,13,19,scotland
Rangers,6,5,0,1,14,1,13,15,scotland
Hearts,6,3,0,3,6,5,1,9,scotland
St. Mirren,6,2,2,2,7,10,-3,8,scotland
Aberdeen,7,2,2,3,9,15,-6,8,scotland
Hibernian,6,1,3,2,9,12,-3,6,scotland
Ross County,7,1,3,3,8,14,-6,6,scotland
Dundee FC,5,1,2,2,5,7,-2,5,scotland
Motherwell,6,1,2,3,4,7,-3,5,scotland
Livingston,7,1,2,4,6,13,-7,5,scotland
Kilmarnock,6,0,2,4,5,10,-5,2,scotland
St. Johnstone,5,0,2,3,0,8,-8,2,scotland
Dundee Utd,7,6,1,0,18,2,16,19,scotland2
Raith Rovers,6,4,1,1,10,7,3,13,scotland2
Partick Thistle,6,3,2,1,14,6,8,11,scotland2
Ayr Utd,7,3,1,3,13,13,0,10,scotland2
Dunfermline,6,2,2,2,6,7,-1,8,scotland2
Queen`s Park,7,2,2,3,10,14,-4,8,scotland2
Arbroath,5,2,0,3,7,10,-3,6,scotland2
Greenock Morton,6,1,2,3,6,9,-3,5,scotland2
Inverness,5,1,1,3,5,7,-2,4,scotland2
Airdrieonians,6,1,1,4,3,10,-7,4,scotland2
Falkirk,6,4,2,0,16,6,10,14,scotland3
Hamilton,7,4,2,1,12,4,8,14,scotland3
Cove Rangers,7,3,2,2,9,6,3,11,scotland3
Montrose,5,3,0,2,13,8,5,9,scotland3
Queen of South,6,3,0,3,6,7,-1,9,scotland3
Kelty Hearts,6,2,2,2,11,9,2,8,scotland3
Alloa Athletic,7,2,1,4,10,13,-3,7,scotland3
Stirling Albion,7,2,0,5,2,13,-11,6,scotland3
Edinburgh City,6,0,2,4,7,13,-6,2,scotland3
Annan Athletic,7,0,2,5,7,19,-12,2,scotland3
Stenhousemuir,6,4,2,0,8,2,6,14,scotland4
Peterhead,5,4,0,1,10,4,6,12,scotland4
Spartans,6,3,2,1,12,10,2,11,scotland4
Dumbarton,6,3,1,2,10,7,3,10,scotland4
Bonnyrigg Rose,6,2,1,3,7,11,-4,7,scotland4
Forfar Athletic,5,1,3,1,4,4,0,6,scotland4
Stranraer,6,1,1,4,5,16,-11,4,scotland4
East Fife,5,0,3,2,4,7,-3,3,scotland4
Clyde,6,0,3,3,6,10,-4,3,scotland4
Elgin City,6,0,1,5,4,18,-14,1,scotland4
Partizan,8,7,1,0,20,6,14,22,serbia
Backa Topola,7,4,3,0,12,3,9,15,serbia
Red Star,6,4,0,2,15,11,4,12,serbia
Napredak,6,3,1,2,9,9,0,10,serbia
Radnicki 1923,8,3,0,5,10,12,-2,9,serbia
Mladost Lucani,6,3,0,3,6,9,-3,9,serbia
Cukaricki,6,2,1,3,8,9,-1,7,serbia
Z. Pancevo,7,2,1,4,8,14,-6,7,serbia
IMT N. Beograd,7,2,0,5,11,12,-1,6,serbia
Vojvodina,7,1,3,3,7,15,-8,6,serbia
Radnicki Nis,8,1,2,5,6,11,-5,5,serbia
Novi Pazar,7,1,2,4,4,9,-5,5,serbia
Javor Ivanjica,8,1,2,5,7,13,-6,5,serbia
Vozdovac,7,1,2,4,5,12,-7,5,serbia
Rad. Surdulica,7,0,4,3,5,11,-6,4,serbia
Sp. Subotica,6,1,1,4,4,10,-6,4,serbia
OFK Beograd,8,6,2,0,21,6,15,20,serbia2
Indija,7,3,2,2,7,6,1,11,serbia2
Semendrija 1924,7,2,4,1,6,5,1,10,serbia2
Dubocica,8,2,4,2,7,8,-1,10,serbia2
Kolubara,7,2,3,2,6,5,1,9,serbia2
Graficar,8,1,5,2,7,10,-3,8,serbia2
OFK Vrac,7,2,2,3,5,9,-4,8,serbia2
Jedinstvo Ub,8,2,2,4,7,12,-5,8,serbia2
S. Mitrovica,7,2,1,4,5,9,-4,7,serbia2
Tekstilac Odzac,7,1,3,3,3,4,-1,6,serbia2
Mladost Novi S.,7,1,3,3,4,8,-4,6,serbia2
Metalac GM,8,1,3,4,5,11,-6,6,serbia2
Radnicki B.,7,1,2,4,7,12,-5,5,serbia2
Sloboda Uzice,8,1,2,5,4,12,-8,5,serbia2
Macva Sabac,7,0,3,4,4,8,-4,3,serbia2
Novi Sad,8,0,0,8,5,20,-15,0,serbia2
Lion City,8,6,1,1,35,16,19,19,singapore
Khalsa,8,6,0,2,26,22,4,18,singapore
A. Niigata (S),8,5,2,1,24,11,13,17,singapore
Tampines Rovers,8,4,3,1,14,12,2,15,singapore
Hougang,8,5,0,3,17,16,1,15,singapore
Geylang,8,4,1,3,15,16,-1,13,singapore
DPMM FC,8,2,2,4,10,12,-2,8,singapore
Tanjong Pagar,8,2,1,5,16,24,-8,7,singapore
Young Lions,8,0,0,8,5,29,-24,0,singapore
Spartak Trnava,7,5,2,0,13,7,6,17,slovakia
S. Bratislava,7,5,1,1,14,7,7,16,slovakia
Banska Bystrica,7,4,2,1,17,9,8,14,slovakia
Zilina,7,3,2,2,8,5,3,11,slovakia
DAC Streda,7,3,2,2,8,7,1,11,slovakia
Trencin,7,3,2,2,11,11,0,11,slovakia
Podbrezova,7,3,0,4,16,12,4,9,slovakia
Skalica,7,1,1,5,6,11,-5,4,slovakia
Ruzomberok,7,0,3,4,6,17,-11,3,slovakia
FC Kosice,7,1,0,6,7,19,-12,3,slovakia
Z. Michalovce,7,0,2,5,6,16,-10,2,slovakia
Zlate Moravce,7,0,1,6,3,11,-8,1,slovakia
Komarno,7,6,0,1,15,8,7,18,slovakia2
Tatran Presov,8,5,1,2,14,6,8,16,slovakia2
Petrzalka,8,4,3,1,16,9,7,15,slovakia2
Puchov,8,5,0,3,20,14,6,15,slovakia2
S. Bratislava B,8,4,2,2,11,6,5,14,slovakia2
Zilina B,8,4,1,3,13,12,1,13,slovakia2
P. Bystrica,7,3,3,1,10,6,4,12,slovakia2
Futura Humenne,8,2,3,3,13,17,-4,9,slovakia2
Spartak Myjava,7,2,2,3,8,10,-2,8,slovakia2
Samorin,8,2,2,4,7,14,-7,8,slovakia2
Pohronie,6,2,1,3,8,8,0,7,slovakia2
L. Mikulas,8,2,1,5,8,16,-8,7,slovakia2
OFK Malzenice,7,1,1,5,9,16,-7,4,slovakia2
Slavoj Trebisov,7,1,1,5,5,15,-10,4,slovakia2
Dolny Kubin,7,0,2,5,6,19,-13,2,slovakia2
Spisska Nova V.,8,0,1,7,7,17,-10,1,slovakia2
NK Celje,7,5,2,0,16,6,10,17,slovenia
Koper,7,4,3,0,11,5,6,15,slovenia
NK Olimpija,7,5,0,2,16,11,5,15,slovenia
Mura,8,4,1,3,10,11,-1,13,slovenia
Radomlje,8,3,2,3,9,7,2,11,slovenia
Maribor,7,2,1,4,10,10,0,7,slovenia
Bravo,8,1,4,3,8,11,-3,7,slovenia
Domzale,7,2,1,4,10,14,-4,7,slovenia
Aluminij,8,2,1,5,7,11,-4,7,slovenia
Rogaska,8,2,0,6,6,19,-13,6,slovenia
Mamelodi S.,5,5,0,0,8,1,7,15,southafrica
Golden Arrows,6,4,0,2,8,7,1,12,southafrica
SuperSport Utd,7,3,2,2,9,8,1,11,southafrica
Cape Town City,7,3,1,3,7,7,0,10,southafrica
Sekhukhune,7,3,1,3,6,6,0,10,southafrica
Moroka Swallows,4,2,2,0,5,2,3,8,southafrica
Chippa Utd,5,2,2,1,4,3,1,8,southafrica
AmaZulu,6,1,3,2,5,7,-2,6,southafrica
Polokwane,5,1,2,2,4,5,-1,5,southafrica
Stellenbosch,5,1,2,2,4,5,-1,5,southafrica
Orlando Pirates,5,1,2,2,3,4,-1,5,southafrica
Richards Bay,5,1,2,2,3,5,-2,5,southafrica
Royal AM,6,1,1,4,6,12,-6,4,southafrica
Kaizer Chiefs,5,1,0,4,4,6,-2,3,southafrica
TS Galaxy,5,0,1,4,0,6,-6,1,southafrica
Cape Town Spurs,6,0,0,6,5,14,-9,0,southafrica
Gwangju,8,4,4,0,10,5,5,16,southkorea
Incheon Utd,8,4,3,1,9,6,3,15,southkorea
Seoul,8,3,3,2,14,12,2,12,southkorea
Jeonbuk Motors,8,3,3,2,9,7,2,12,southkorea
Daegu,8,3,2,3,10,11,-1,11,southkorea
Suwon City,8,3,2,3,8,10,-2,11,southkorea
Ulsan,8,2,3,3,7,10,-3,9,southkorea
Pohang Steelers,8,1,5,2,9,9,0,8,southkorea
Gangwon,8,2,2,4,6,7,-1,8,southkorea
Suwon Bluewings,8,2,2,4,9,17,-8,8,southkorea
Daejeon Citizen,8,0,5,3,8,14,-6,5,southkorea
Jeju Utd,8,0,1,7,5,14,-9,1,southkorea
Busan IPark,8,4,1,3,9,10,-1,13,southkorea2
Gyeongnam,8,3,3,2,9,8,1,12,southkorea2
Cheongju,8,3,3,2,6,6,0,12,southkorea2
Gimcheon Sangmu,8,3,1,4,14,12,2,10,southkorea2
Gimpo,8,2,4,2,7,6,1,10,southkorea2
Cheonan City,8,2,3,3,9,8,1,9,southkorea2
Jeonnam Dragons,8,3,0,5,9,11,-2,9,southkorea2
Ansan Greeners,8,2,2,4,13,19,-6,8,southkorea2
Seongnam,8,2,2,4,8,14,-6,8,southkorea2
Bucheon FC,8,1,2,5,6,11,-5,5,southkorea2
Anyang,8,1,1,6,10,19,-9,4,southkorea2
Chungnam Asan,8,1,1,6,3,12,-9,4,southkorea2
Seoul E-Land,8,1,1,6,3,13,-10,4,southkorea2
Girona,7,6,1,0,16,8,8,19,spain
Real Madrid,7,5,1,1,13,6,7,16,spain
Rayo Vallecano,7,3,3,1,7,3,4,12,spain
FC Barcelona,6,3,3,0,11,8,3,12,spain
Atletico Madrid,6,3,1,2,13,5,8,10,spain
Athletic Bilbao,6,3,1,2,7,6,1,10,spain
Osasuna,6,3,0,3,9,10,-1,9,spain
Real Sociedad,6,2,2,2,8,7,1,8,spain
Villarreal,6,2,2,2,7,9,-2,8,spain
Las Palmas,7,2,1,4,5,8,-3,7,spain
Real Betis,7,1,4,2,8,14,-6,7,spain
Valencia,7,1,3,3,8,15,-7,6,spain
Mallorca,7,1,2,4,9,14,-5,5,spain
Celta Vigo,6,1,1,4,10,13,-3,4,spain
Getafe,7,0,4,3,9,14,-5,4,spain
Sevilla FC,5,0,3,2,6,8,-2,3,spain
Alaves,7,0,2,5,4,10,-6,2,spain
Granada,6,0,1,5,7,15,-8,1,spain
Cadiz,6,0,1,5,3,12,-9,1,spain
Almeria,6,0,1,5,5,17,-12,1,spain
Leganes,7,5,0,2,10,3,7,15,spain2
Eibar,8,4,1,3,13,14,-1,13,spain2
Levante,8,3,3,2,7,5,2,12,spain2
Espanyol,8,3,2,3,10,9,1,11,spain2
Sporting Gijon,8,3,2,3,9,8,1,11,spain2
Real Zaragoza,7,3,2,2,8,7,1,11,spain2
Eldense,8,3,2,3,10,12,-2,11,spain2
Racing Ferrol,8,3,2,3,8,10,-2,11,spain2
Huesca,7,2,3,2,5,5,0,9,spain2
Valladolid,7,3,0,4,6,12,-6,9,spain2
Mirandes,7,2,2,3,9,11,-2,8,spain2
Alcorcon,8,2,2,4,10,16,-6,8,spain2
Real Oviedo,8,1,4,3,4,5,-1,7,spain2
Cartagena,8,1,4,3,8,10,-2,7,spain2
Tenerife,7,2,1,4,6,10,-4,7,spain2
Villarreal B,8,1,3,4,8,12,-4,6,spain2
Elche,7,1,3,3,5,11,-6,6,spain2
Racing,7,1,2,4,7,13,-6,5,spain2
Albacete,7,1,2,4,4,11,-7,5,spain2
FC Andorra,7,1,0,6,6,15,-9,3,spain2
Amorebieta,8,0,2,6,6,19,-13,2,spain2
Burgos,7,0,0,7,5,17,-12,0,spain2
Mjallby,8,5,1,2,13,7,6,16,sweden
Varnamo,8,5,1,2,17,12,5,16,sweden
Sirius,8,4,1,3,14,10,4,13,sweden
Malmo FF,8,4,1,3,11,9,2,13,sweden
Djurgarden,8,4,1,3,8,7,1,13,sweden
Elfsborg,8,4,0,4,11,7,4,12,sweden
Hammarby,8,3,3,2,6,4,2,12,sweden
IFK Goteborg,8,3,3,2,10,12,-2,12,sweden
Kalmar,8,3,0,5,10,15,-5,9,sweden
AIK,8,2,2,4,8,15,-7,8,sweden
Norrkoping,8,2,1,5,12,17,-5,7,sweden
Degerfors,8,1,3,4,7,13,-6,6,sweden
Hacken,8,1,1,6,8,14,-6,4,sweden
Brommapojkarna,8,1,1,6,12,19,-7,4,sweden
Halmstad,8,0,4,4,6,13,-7,4,sweden
Varberg BoIS,8,1,0,7,9,24,-15,3,sweden
GAIS,8,5,1,2,24,5,19,16,sweden2
Oster,8,4,2,2,13,10,3,14,sweden2
Vasteras,8,4,2,2,10,9,1,14,sweden2
Trelleborg,8,3,4,1,13,11,2,13,sweden2
Landskrona,8,4,1,3,14,18,-4,13,sweden2
Orgryte,8,4,0,4,10,11,-1,12,sweden2
Ostersunds,8,2,4,2,10,12,-2,10,sweden2
Gefle,8,1,4,3,8,11,-3,7,sweden2
Utsikten,8,2,1,5,6,14,-8,7,sweden2
GIF Sundsvall,8,1,3,4,9,17,-8,6,sweden2
AFC Eskilstuna,8,1,3,4,5,14,-9,6,sweden2
Skovde AIK,8,1,2,5,13,21,-8,5,sweden2
Brage,8,1,2,5,3,12,-9,5,sweden2
Helsingborg,8,0,4,4,7,13,-6,4,sweden2
Orebro,8,1,1,6,11,20,-9,4,sweden2
Jonkopings,8,0,1,7,6,22,-16,1,sweden2
FC Zurich,7,3,4,0,14,5,9,13,switzerland
Servette,7,4,1,2,9,8,1,13,switzerland
BSC Young Boys,7,3,3,1,11,7,4,12,switzerland
St. Gallen,7,1,3,3,9,9,0,6,switzerland
Lugano,7,2,0,5,11,17,-6,6,switzerland
Lausanne Sport,7,1,2,4,10,13,-3,5,switzerland
Winterthur,7,1,2,4,16,22,-6,5,switzerland
Yverdon,7,1,2,4,7,15,-8,5,switzerland
Luzern,7,1,2,4,7,16,-9,5,switzerland
Grasshopper,7,1,1,5,8,13,-5,4,switzerland
Lausanne Ouchy,6,1,1,4,8,14,-6,4,switzerland
FC Basel,6,0,0,6,5,18,-13,0,switzerland
Hottin,3,2,0,1,3,2,1,6,syria
Foutoua,2,1,1,0,4,1,3,4,syria
Wathbah,2,1,1,0,2,0,2,4,syria
Karama,3,0,3,0,4,4,0,3,syria
Al Ittihad,2,1,0,1,1,1,0,3,syria
Taliya,3,1,0,2,1,2,-1,3,syria
Jabala,2,0,2,0,2,2,0,2,syria
Al Jaish,2,0,1,1,1,2,-1,1,syria
Teshrin,2,0,1,1,1,3,-2,1,syria
Al Sahel,2,0,1,1,1,4,-3,1,syria
Al Wahda,3,0,1,2,0,3,-3,1,syria
Horriya,3,0,0,3,1,7,-6,0,syria
Azam,5,3,1,1,9,4,5,10,tanzania
Young Africans,4,3,0,1,10,3,7,9,tanzania
Simba,3,3,0,0,9,4,5,9,tanzania
Singida,5,3,0,2,8,7,1,9,tanzania
Dodoma Jiji,5,2,1,2,6,7,-1,7,tanzania
JKT Tanzania,5,2,1,2,5,9,-4,7,tanzania
Namungo,5,1,3,1,5,4,1,6,tanzania
Geita Gold,5,1,2,2,2,4,-2,5,tanzania
KMC,4,1,2,1,3,7,-4,5,tanzania
Kagera Sugar,5,1,1,3,3,5,-2,4,tanzania
Tabora,6,0,4,2,0,5,-5,4,tanzania
Coastal Union,4,0,2,2,2,6,-4,2,tanzania
T. Prisons,5,0,2,3,4,9,-5,2,tanzania
Mtibwa Sugar,3,0,1,2,3,5,-2,1,tanzania
Mashujaa,3,0,1,2,0,3,-3,1,tanzania
Ihefu,4,0,1,3,3,7,-4,1,tanzania
Muang Thong Utd,7,3,1,3,10,12,-2,10,thailand
Bangkok Utd,3,3,0,0,8,1,7,9,thailand
Buriram Utd,4,2,2,0,3,1,2,8,thailand
Pathum Utd,5,2,2,1,6,5,1,8,thailand
Port FC,5,2,1,2,12,8,4,7,thailand
Uthai Thani,5,2,1,2,7,8,-1,7,thailand
Chonburi,6,1,3,2,11,12,-1,6,thailand
Chiangrai Utd,4,1,1,2,3,4,-1,4,thailand
Nakhon Pathom,5,1,1,3,7,11,-4,4,thailand
Sukhothai,5,1,1,3,6,11,-5,4,thailand
Khon Kaen Utd,5,1,1,3,6,13,-7,4,thailand
Police Tero,3,1,0,2,4,10,-6,3,thailand
Prachuap,5,0,2,3,5,9,-4,2,thailand
Ratchaburi,5,0,2,3,4,8,-4,2,thailand
Lamphun Warrior,5,0,1,4,4,12,-8,1,thailand
Trat,4,0,1,3,1,10,-9,1,thailand
Ayutthaya Utd,7,4,2,1,9,3,6,14,thailand2
N. Bua Pitchaya,7,4,1,2,13,11,2,13,thailand2
Rayong,6,3,2,1,11,3,8,11,thailand2
Pattaya United,6,3,1,2,10,9,1,10,thailand2
Nakhon Si Thamm,5,3,1,1,9,8,1,10,thailand2
Phrae Utd,6,3,0,3,7,12,-5,9,thailand2
N. Ratchasima,6,2,2,2,6,5,1,8,thailand2
Lampang,6,2,2,2,8,8,0,8,thailand2
Samut Prakan,6,2,2,2,7,8,-1,8,thailand2
Suphanburi,6,2,2,2,4,5,-1,8,thailand2
Chiangmai Utd,6,1,3,2,9,9,0,6,thailand2
Chiangmai FC,5,1,3,1,2,2,0,6,thailand2
Kanchanaburi,7,1,3,3,6,8,-2,6,thailand2
Customs Utd,6,1,2,3,4,14,-10,5,thailand2
Chanthaburi,7,1,1,5,11,16,-5,4,thailand2
Chainat,6,0,3,3,0,5,-5,3,thailand2
Kasetsart,6,0,1,5,6,19,-13,1,thailand2
Krabi,4,0,0,4,3,16,-13,0,thailand2
Fenerbahce,6,5,1,0,11,0,11,16,turkey
Galatasaray,7,5,1,1,10,3,7,16,turkey
Sivasspor,6,3,1,2,9,10,-1,10,turkey
Kasimpasa,5,2,2,1,8,7,1,8,turkey
Pendikspor,6,2,2,2,9,10,-1,8,turkey
Kayserispor,6,2,2,2,9,11,-2,8,turkey
Antalyaspor,6,2,1,3,9,7,2,7,turkey
Trabzonspor,6,2,1,3,10,9,1,7,turkey
Hatayspor,6,1,3,2,8,7,1,6,turkey
Besiktas,6,2,0,4,8,12,-4,6,turkey
Gaziantep,7,2,0,5,6,11,-5,6,turkey
Rizespor,6,2,0,4,7,15,-8,6,turkey
F. Karagumruk,5,1,2,2,5,5,0,5,turkey
Ankaragucu,6,1,2,3,11,12,-1,5,turkey
Konyaspor,6,1,2,3,5,10,-5,5,turkey
Basaksehir,7,1,2,4,2,8,-6,5,turkey
Adana Demirspor,5,0,3,2,6,9,-3,3,turkey
Alanyaspor,5,0,2,3,1,7,-6,2,turkey
Istanbulspor,6,0,1,5,3,11,-8,1,turkey
Samsunspor,7,0,1,6,4,13,-9,1,turkey
Eyupspor,6,5,0,1,19,6,13,15,turkey2
Bandirmaspor,7,4,2,1,8,4,4,14,turkey2
Goztepe,6,4,1,1,7,3,4,13,turkey2
Kocaelispor,5,4,0,1,7,3,4,12,turkey2
Corum,7,3,2,2,12,7,5,11,turkey2
Genclerbirligi,6,3,2,1,8,7,1,11,turkey2
Sakaryaspor,6,3,1,2,8,8,0,10,turkey2
Manisa BB,6,2,2,2,7,7,0,8,turkey2
Keciorengucu,5,2,2,1,4,5,-1,8,turkey2
Bodrumspor,7,2,2,3,6,8,-2,8,turkey2
Umraniyespor,7,2,1,4,6,10,-4,7,turkey2
Erzurum BB,6,1,3,2,2,3,-1,6,turkey2
Sanliurfaspor,6,1,3,2,5,9,-4,6,turkey2
Boluspor,5,1,2,2,2,3,-1,5,turkey2
Tuzlaspor,5,1,1,3,4,8,-4,4,turkey2
Giresunspor,6,1,1,4,7,13,-6,4,turkey2
Adanaspor,6,1,0,5,4,10,-6,3,turkey2
Altay,6,0,1,5,3,14,-11,1,turkey2
Shabab Al Ahli,4,3,1,0,9,2,7,10,uae
Al Sharjah,4,3,1,0,9,5,4,10,uae
Al Wasl,3,2,1,0,11,4,7,7,uae
Al Jazira,3,2,0,1,9,5,4,6,uae
Al Bataeh,3,2,0,1,5,4,1,6,uae
Al Ain,4,2,0,2,6,6,0,6,uae
Al Wahda,4,2,0,2,5,6,-1,6,uae
Al Nasr,3,1,1,1,8,7,1,4,uae
Ittihad Kalba,3,1,1,1,6,5,1,4,uae
Emirates,4,1,1,2,3,4,-1,4,uae
Hatta,4,1,0,3,6,7,-1,3,uae
Ajman,4,0,3,1,6,12,-6,3,uae
Al Khaleej,3,0,0,3,2,6,-4,0,uae
Bani Yas,3,0,0,3,4,11,-7,0,uae
Polessya,8,5,1,2,12,4,8,16,ukraine
Dnipro-1,7,5,1,1,11,7,4,16,ukraine
Shakhtar,7,4,3,0,14,7,7,15,ukraine
Kryvbas KR,7,4,2,1,14,5,9,14,ukraine
Rukh Lviv,5,4,0,1,13,7,6,12,ukraine
Vorskla Poltava,7,3,2,2,6,8,-2,11,ukraine
Dynamo Kyiv,6,3,1,2,15,11,4,10,ukraine
Zorya Luhansk,7,2,3,2,11,10,1,9,ukraine
Kolos Kovalivka,6,1,5,0,4,3,1,8,ukraine
LNZ Cherkasy,6,2,2,2,5,6,-1,8,ukraine
Obolon,7,2,1,4,5,11,-6,7,ukraine
Chornomorets,7,2,0,5,10,11,-1,6,ukraine
Metalist 1925,7,1,2,4,5,8,-3,5,ukraine
Oleksandria,7,0,3,4,3,8,-5,3,ukraine
Veres,6,0,2,4,1,7,-6,2,ukraine
FC Minaj,7,0,2,5,3,13,-10,2,ukraine
Wanderers,8,5,3,0,11,4,7,18,uruguay
Defensor S.,7,4,2,1,13,3,10,14,uruguay
Montevideo City,7,4,1,2,13,8,5,13,uruguay
Penarol,6,3,2,1,10,7,3,11,uruguay
Nacional,8,2,4,2,10,8,2,10,uruguay
Cerro Largo,7,2,4,1,5,3,2,10,uruguay
Racing CM,7,3,1,3,9,8,1,10,uruguay
La Luz,6,2,2,2,6,7,-1,8,uruguay
Liverpool M.,8,1,4,3,9,11,-2,7,uruguay
Boston River,8,1,3,4,9,12,-3,6,uruguay
Cerro,8,1,3,4,8,12,-4,6,uruguay
Fenix,8,2,0,6,8,17,-9,6,uruguay
River Plate,8,0,5,3,4,9,-5,5,uruguay
D. Maldonado,8,1,2,5,8,18,-10,5,uruguay
Plaza Colonia,7,1,2,4,4,16,-12,5,uruguay
Danubio,8,0,3,5,8,15,-7,3,uruguay
Cerro,3,2,1,0,3,1,2,7,uruguay2
River Plate,4,2,1,1,4,5,-1,7,uruguay2
Liverpool M.,3,2,0,1,4,2,2,6,uruguay2
Wanderers,3,2,0,1,4,4,0,6,uruguay2
Defensor S.,4,1,2,1,4,4,0,5,uruguay2
Fenix,4,1,2,1,4,4,0,5,uruguay2
Danubio,4,1,1,2,4,4,0,4,uruguay2
Montevideo City,4,1,1,2,4,5,-1,4,uruguay2
Boston River,3,1,0,2,3,5,-2,3,uruguay2
D. Maldonado,4,1,0,3,5,10,-5,3,uruguay2
Racing CM,4,1,0,3,4,9,-5,3,uruguay2
Cerro Largo,3,0,2,1,3,4,-1,2,uruguay2
Nacional,3,0,2,1,3,6,-3,2,uruguay2
Plaza Colonia,4,0,2,2,4,10,-6,2,uruguay2
Penarol,3,0,1,2,2,4,-2,1,uruguay2
La Luz,3,0,1,2,0,7,-7,1,uruguay2
Orlando City,8,5,1,2,10,9,1,16,usa
Seattle,8,4,3,1,11,8,3,15,usa
Cincinnati,8,4,3,1,13,12,1,15,usa
Real Salt Lake,8,4,2,2,12,9,3,14,usa
Vancouver,8,3,3,2,11,12,-1,12,usa
New York RB,8,3,1,4,11,14,-3,10,usa
Dallas,8,2,3,3,11,11,0,9,usa
Houston Dynamo,8,2,3,3,8,8,0,9,usa
Columbus Crew,8,2,3,3,15,16,-1,9,usa
Sporting KC,8,2,3,3,13,16,-3,9,usa
Atlanta Utd,8,2,3,3,11,14,-3,9,usa
Philadelphia,8,2,2,4,11,14,-3,8,usa
Minnesota Utd,8,2,2,4,13,19,-6,8,usa
Inter Miami,8,2,2,4,11,17,-6,8,usa
St. Louis City,8,2,2,4,8,14,-6,8,usa
Los Angeles FC,8,1,4,3,8,10,-2,7,usa
Charlotte,8,1,4,3,9,13,-4,7,usa
New York City,8,1,4,3,7,12,-5,7,usa
SJ Earthquakes,8,1,4,3,6,12,-6,7,usa
Portland,8,1,4,3,9,19,-10,7,usa
Chicago Fire,8,2,1,5,3,14,-11,7,usa
Austin,8,1,3,4,12,15,-3,6,usa
Nashville SC,8,1,3,4,5,11,-6,6,usa
LA Galaxy,8,1,3,4,15,22,-7,6,usa
DC United,8,1,2,5,4,15,-11,5,usa
CF Montreal,8,1,1,6,5,19,-14,4,usa
New England,8,0,3,5,11,16,-5,3,usa
Colorado Rapids,8,0,1,7,4,22,-18,1,usa
Toronto,8,0,0,8,1,22,-21,0,usa
Orange County,8,6,1,1,19,11,8,19,usa2
San Diego Loyal,8,5,1,2,15,7,8,16,usa2
Sacramento R.,8,5,1,2,12,9,3,16,usa2
Miami FC,8,5,0,3,11,6,5,15,usa2
Tampa Bay,8,4,2,2,14,10,4,14,usa2
Pittsburgh,8,4,2,2,10,8,2,14,usa2
Colorado S.,8,4,1,3,13,11,2,13,usa2
San Antonio,8,3,3,2,11,8,3,12,usa2
Indy Eleven,8,3,3,2,12,12,0,12,usa2
Charleston,8,3,3,2,10,10,0,12,usa2
Memphis,8,3,3,2,10,10,0,12,usa2
Oakland Roots,8,4,0,4,14,15,-1,12,usa2
FC Tulsa,8,3,1,4,12,13,-1,10,usa2
El Paso,8,3,1,4,5,15,-10,10,usa2
Louisville City,8,3,0,5,12,15,-3,9,usa2
Birmingham L.,8,3,0,5,8,14,-6,9,usa2
Phoenix Rising,8,2,2,4,7,12,-5,8,usa2
Monterey Bay,8,2,2,4,7,14,-7,8,usa2
Detroit City,8,2,1,5,9,17,-8,7,usa2
New Mexico,8,1,3,4,8,11,-3,6,usa2
Rio Grande,8,1,3,4,9,13,-4,6,usa2
Loudoun Utd,8,1,1,6,8,12,-4,4,usa2
Hartford A.,8,1,1,6,8,19,-11,4,usa2
Las Vegas L.,8,0,2,6,6,14,-8,2,usa2
North Carolina,8,6,1,1,19,9,10,19,usa3
Union Omaha,8,6,1,1,16,10,6,19,usa3
N. Colorado,8,4,2,2,13,11,2,14,usa3
Greenville,8,3,4,1,10,8,2,13,usa3
Tormenta,8,3,2,3,18,16,2,11,usa3
One Knoxville,8,3,2,3,9,9,0,11,usa3
Central Valley,8,2,1,5,16,20,-4,7,usa3
Chattanooga RW,8,2,1,5,12,17,-5,7,usa3
Lexington,8,1,3,4,12,16,-4,6,usa3
Charlotte,8,1,3,4,14,20,-6,6,usa3
Forward Madison,8,1,2,5,11,19,-8,5,usa3
Richmond K.,8,0,2,6,9,19,-10,2,usa3
Pakhtakor,8,5,2,1,11,6,5,17,uzbekistan
Navbahor,8,4,2,2,15,8,7,14,uzbekistan
Nasaf Qarshi,8,4,2,2,10,7,3,14,uzbekistan
Termez Surkhon,8,3,4,1,8,6,2,13,uzbekistan
AMGK,8,3,4,1,9,8,1,13,uzbekistan
Neftchi,8,2,4,2,9,8,1,10,uzbekistan
Metallurg,8,3,1,4,9,9,0,10,uzbekistan
FK Olympic,8,3,1,4,7,10,-3,10,uzbekistan
Andijan,8,2,2,4,6,11,-5,8,uzbekistan
Bunyodkor,8,2,2,4,5,10,-5,8,uzbekistan
Qizilqum,8,1,4,3,4,10,-6,7,uzbekistan
Sogdiana,8,1,2,5,10,15,-5,5,uzbekistan
Buxoro,8,1,1,6,3,11,-8,4,uzbekistan
Turan,8,1,1,6,6,18,-12,4,uzbekistan
D. Tachira,8,5,3,0,10,5,5,18,venezuela
Portuguesa,8,4,2,2,10,10,0,14,venezuela
Caracas,8,2,5,1,9,7,2,11,venezuela
Rayo Zuliano,8,3,2,3,11,11,0,11,venezuela
Carabobo,8,1,6,1,6,5,1,9,venezuela
Puerto Cabello,8,3,0,5,10,11,-1,9,venezuela
D. La Guaira,8,2,3,3,10,12,-2,9,venezuela
Metropolitanos,8,2,3,3,9,13,-4,9,venezuela
E. Merida,8,2,1,5,6,11,-5,7,venezuela
Zamora,8,2,1,5,8,18,-10,7,venezuela
H. Colmenares,8,1,3,4,8,11,-3,6,venezuela
UCV,8,0,4,4,2,7,-5,4,venezuela
Monagas,8,1,1,6,7,15,-8,4,venezuela
Angostura,8,1,1,6,6,16,-10,4,venezuela
M. de Guayana,8,1,1,6,6,21,-15,4,venezuela
Cong An Nhan,8,6,1,1,18,8,10,19,vietnam
Thanh Hoa,8,2,6,0,8,4,4,12,vietnam
Ha Noi,8,3,2,3,13,12,1,11,vietnam
The Cong,8,2,4,2,6,6,0,10,vietnam
Nam Dinh,8,3,1,4,8,12,-4,10,vietnam
Hai Phong,8,2,3,3,6,10,-4,9,vietnam
H. A. Gia Lai,8,2,2,4,11,13,-2,8,vietnam
Binh Duong,8,1,5,2,6,8,-2,8,vietnam
Song Lam Nghe,8,2,2,4,6,11,-5,8,vietnam
S. Khanh Hoa,8,1,4,3,5,8,-3,7,vietnam
Ho Chi Minh,8,2,1,5,10,17,-7,7,vietnam
Binh Dinh,8,1,3,4,7,12,-5,6,vietnam
Da Nang,8,1,3,4,5,10,-5,6,vietnam
Hong Linh Ha T.,8,0,4,4,8,19,-11,4,vietnam
Pho Hien,8,4,1,3,13,9,4,13,vietnam2
Long An,8,3,3,2,14,13,1,12,vietnam2
Hoa Binh,8,2,4,2,8,8,0,10,vietnam2
Binh Thuan,8,3,1,4,10,21,-11,10,vietnam2
Quang Nam,8,2,3,3,14,10,4,9,vietnam2
Phu Dong,8,2,3,3,7,9,-2,9,vietnam2
Phu Tho,8,1,2,5,8,14,-6,5,vietnam2
Binh Phuoc,8,1,1,6,9,16,-7,4,vietnam2
Ba Ria Vung Tau,8,0,3,5,3,12,-9,3,vietnam2
Hue,8,0,3,5,3,14,-11,3,vietnam2
The New Saints,8,7,1,0,22,5,17,22,wales
Connah`s Quay,8,4,1,3,18,13,5,13,wales
Penybont,7,3,1,3,14,13,1,10,wales
Caernarfon Town,7,3,1,3,15,16,-1,10,wales
Aberystwyth,8,3,1,4,5,15,-10,10,wales
Newtown,6,3,0,3,12,9,3,9,wales
Cardiff MU,7,2,2,3,8,14,-6,8,wales
Haverfordwest,8,1,3,4,7,16,-9,6,wales
Pontypridd Town,7,1,2,4,1,9,-8,5,wales
Barry Town,7,1,1,5,4,9,-5,4,wales
Bala Town,7,0,4,3,3,8,-5,4,wales
Colwyn Bay,7,1,1,5,5,17,-12,4,wales
