Equipe,GP,W,D,L,GF,GA,GD,Pts,albania2
AF Elbasani,8,7,1,0,21,8,13,22,albania2
Bylis,8,6,2,0,12,3,9,20,albania2
Flamurtari,8,6,1,1,11,4,7,19,albania2
Vora,8,5,2,1,21,11,10,17,albania2
Korabi Peshkopi,8,5,1,2,11,4,7,16,albania2
Apolonia Fier,8,4,2,2,16,8,8,14,albania2
Lushnja,8,4,2,2,11,10,1,14,albania2
Kastrioti Kruje,8,3,4,1,9,6,3,13,albania2
Burreli,8,3,2,3,8,10,-2,11,albania2
Tomori Berat,8,2,3,3,4,6,-2,9,albania2
Besa Kavaje,8,2,2,4,8,9,-1,8,albania2
Luzi 2008,8,2,2,4,9,12,-3,8,albania2
MC Alger,8,7,1,0,24,4,20,22,algeria
JS Saoura,8,5,2,1,10,6,4,17,algeria
Khenchela,7,5,1,1,9,3,6,16,algeria
CS Constantine,7,4,2,1,11,4,7,14,algeria
ASO Chlef,8,4,2,2,8,4,4,14,algeria
ES Setif,7,4,2,1,10,8,2,14,algeria
USM Alger,5,4,1,0,9,2,7,13,algeria
El Bayadh,6,4,1,1,8,2,6,13,algeria
NC Magra,8,3,3,2,9,7,2,12,algeria
Paradou AC,8,3,3,2,3,2,1,12,algeria
JS Kabylie,5,3,2,0,5,2,3,11,algeria
CR Belouizdad,5,3,1,1,6,4,2,10,algeria
US Biskra,5,2,2,1,5,7,-2,8,algeria
Ben Aknoun,5,1,2,2,5,6,-1,5,algeria
MC Oran,6,1,2,3,4,9,-5,5,algeria
US Souf,8,0,1,7,9,22,-13,1,algeria
Inter Escaldes,6,6,0,0,22,3,19,18,andorra
UE Santa Coloma,6,5,0,1,16,4,12,15,andorra
FC Santa Coloma,7,5,0,2,13,6,7,15,andorra
A. Escaldes,6,4,1,1,17,5,12,13,andorra
Ordino,5,4,1,0,12,2,10,13,andorra
Penya Encarnada,5,3,1,1,7,4,3,10,andorra
Pas de la Casa,7,1,1,5,5,19,-14,4,andorra
Esperanca,7,1,0,6,2,17,-15,3,andorra
A. America,7,0,1,6,5,17,-12,1,andorra
Carroi,5,0,1,4,3,16,-13,1,andorra
River Plate,8,8,0,0,16,4,12,24,argentina
Boca Juniors,8,6,1,1,12,4,8,19,argentina
Lanus,8,6,1,1,12,6,6,19,argentina
Estudiantes,8,5,3,0,15,4,11,18,argentina
Godoy Cruz,8,5,3,0,20,10,10,18,argentina
Defensa y J.,8,5,3,0,13,4,9,18,argentina
A. Tucuman,8,5,2,1,11,6,5,17,argentina
Rosario Central,8,4,4,0,18,8,10,16,argentina
T. de Cordoba,8,4,4,0,10,5,5,16,argentina
Belgrano,8,4,2,2,8,5,3,14,argentina
Independiente,8,4,2,2,9,7,2,14,argentina
Banfield,8,4,2,2,8,6,2,14,argentina
Union Santa Fe,8,3,4,1,8,3,5,13,argentina
Barracas C.,8,3,4,1,8,5,3,13,argentina
Platense,8,4,1,3,7,4,3,13,argentina
San Lorenzo,8,3,4,1,4,2,2,13,argentina
Racing Club,8,3,3,2,13,12,1,12,argentina
Instituto,8,3,3,2,6,6,0,12,argentina
Arsenal Sarandi,8,4,0,4,8,9,-1,12,argentina
Colon Santa Fe,8,3,3,2,9,11,-2,12,argentina
Newells,8,2,5,1,8,5,3,11,argentina
Sarmiento,8,2,5,1,7,4,3,11,argentina
Argentinos Jrs,8,3,2,3,11,11,0,11,argentina
Tigre,8,3,2,3,9,9,0,11,argentina
Gimnasia,8,2,4,2,6,8,-2,10,argentina
Velez Sarsfield,8,1,6,1,4,4,0,9,argentina
Huracan,8,2,3,3,4,5,-1,9,argentina
Central Cordoba,8,2,1,5,4,7,-3,7,argentina
G. Mendoza,8,6,1,1,20,8,12,19,argentina3
CA Guemes,8,6,1,1,10,2,8,19,argentina3
Deportivo Maipu,8,6,1,1,11,5,6,19,argentina3
E. Rio Cuarto,8,6,1,1,12,7,5,19,argentina3
I. Rivadavia,8,6,1,1,9,5,4,19,argentina3
Racing Cordoba,8,5,3,0,15,6,9,18,argentina3
D. de Belgrano,8,6,0,2,14,7,7,18,argentina3
Chacarita J.,8,5,3,0,13,6,7,18,argentina3
All Boys,8,6,0,2,11,6,5,18,argentina3
Ferro Carril,8,5,2,1,13,4,9,17,argentina3
Chaco For Ever,8,5,2,1,13,9,4,17,argentina3
SM Tucuman,8,4,4,0,11,3,8,16,argentina3
Guillermo Brown,8,5,1,2,10,5,5,16,argentina3
Almirante Brown,8,5,1,2,8,4,4,16,argentina3
Patronato,8,5,1,2,14,11,3,16,argentina3
Agropecuario,8,4,3,1,13,5,8,15,argentina3
Temperley,8,4,3,1,11,6,5,15,argentina3
D. Madryn,8,4,3,1,9,4,5,15,argentina3
Gimnasia Jujuy,8,5,0,3,9,4,5,15,argentina3
D. Riestra,8,4,3,1,8,3,5,15,argentina3
Almagro,8,4,3,1,9,6,3,15,argentina3
SM San Juan,8,4,2,2,14,9,5,14,argentina3
Atletico Mitre,8,4,2,2,12,8,4,14,argentina3
Deportivo Moron,8,3,4,1,10,8,2,13,argentina3
Flandria,8,4,1,3,10,9,1,13,argentina3
Nueva Chicago,8,3,4,1,9,8,1,13,argentina3
Brown de A.,8,3,3,2,11,9,2,12,argentina3
Alvarado,8,3,3,2,9,7,2,12,argentina3
Tristan Suarez,8,3,3,2,8,6,2,12,argentina3
Noah,8,7,0,1,23,5,18,21,armenia
Ararat-Armenia,8,7,0,1,23,8,15,21,armenia
Pyunik,8,6,2,0,22,6,16,20,armenia
Alashkert,8,5,3,0,14,6,8,18,armenia
Urartu,8,5,1,2,13,10,3,16,armenia
BKMA,8,3,1,4,14,15,-1,10,armenia
Van,8,3,1,4,13,15,-2,10,armenia
West Armenia,8,2,1,5,11,19,-8,7,armenia
Ararat Yerevan,8,2,1,5,5,14,-9,7,armenia
Shirak,8,1,2,5,8,13,-5,5,armenia
Central Coast,8,4,2,2,18,11,7,14,australia
Adelaide Utd,8,4,2,2,20,14,6,14,australia
Western Sydney,8,4,1,3,15,8,7,13,australia
Wellington,6,4,1,1,11,7,4,13,australia
Sydney FC,7,4,0,3,14,10,4,12,australia
Melbourne V.,5,3,2,0,12,5,7,11,australia
Brisbane Roar,7,3,1,3,12,13,-1,10,australia
Macarthur FC,7,2,4,1,11,12,-1,10,australia
Melbourne City,7,2,3,2,17,10,7,9,australia
Perth Glory,6,2,1,3,13,13,0,7,australia
Newcastle Jets,4,1,2,1,6,6,0,5,australia
Western United,5,1,0,4,4,8,-4,3,australia
LASK Linz,8,6,2,0,12,2,10,20,austria
Salzburg,8,6,0,2,14,4,10,18,austria
Sturm Graz,8,5,2,1,12,5,7,17,austria
Hartberg,8,5,1,2,12,11,1,16,austria
Wolfsberger AC,8,4,1,3,12,10,2,13,austria
Austria Wien,8,2,5,1,7,5,2,11,austria
Altach,8,3,1,4,7,8,-1,10,austria
BW Linz,8,2,4,2,7,9,-2,10,austria
A. Klagenfurt,8,2,4,2,9,12,-3,10,austria
Rapid Wien,8,1,4,3,11,13,-2,7,austria
Tirol,8,1,1,6,12,18,-6,4,austria
A. Lustenau,8,0,0,8,5,26,-21,0,austria
Grazer AK,7,6,0,1,13,3,10,18,austria2
Ried,7,5,2,0,21,4,17,17,austria2
SV Horn,7,5,0,2,15,6,9,15,austria2
Lafnitz,8,5,0,3,18,15,3,15,austria2
Admira Wacker,8,4,3,1,10,7,3,15,austria2
Floridsdorfer,8,4,2,2,13,7,6,14,austria2
Leoben,8,4,1,3,15,12,3,13,austria2
Stripfing,8,4,1,3,14,15,-1,13,austria2
First Vienna,7,3,3,1,11,8,3,12,austria2
Bregenz,7,3,2,2,9,7,2,11,austria2
St. Polten,8,3,0,5,10,11,-1,9,austria2
Kapfenberger,8,2,3,3,11,15,-4,9,austria2
Liefering,8,1,4,3,9,11,-2,7,austria2
Dornbirn,8,2,0,6,6,16,-10,6,austria2
Sturm Graz B,8,1,3,4,10,21,-11,6,austria2
Amstetten,7,0,2,5,7,13,-6,2,austria2
Qarabag,8,7,1,0,25,4,21,22,azerbaijan
Araz,8,5,2,1,10,4,6,17,azerbaijan
Zira,8,4,3,1,8,5,3,15,azerbaijan
Sumqayit,8,4,3,1,6,6,0,15,azerbaijan
Sebail,8,4,2,2,13,10,3,14,azerbaijan
Neftci,8,4,1,3,10,8,2,13,azerbaijan
Turan,8,3,3,2,16,11,5,12,azerbaijan
Sabah,8,2,3,3,12,11,1,9,azerbaijan
Qabala,8,3,0,5,8,12,-4,9,azerbaijan
Kapaz,8,1,2,5,3,11,-8,5,azerbaijan
Al Riffa,6,4,1,1,10,6,4,13,bahrain
Muharraq,6,3,3,0,9,5,4,12,bahrain
Al Ahli M.,4,3,1,0,9,4,5,10,bahrain
East Riffa,6,2,3,1,9,9,0,9,bahrain
Manama,5,2,1,2,8,7,1,7,bahrain
Al-Najma,4,2,1,1,6,5,1,7,bahrain
Al Shabbab,5,2,1,2,6,6,0,7,bahrain
Khalidiya,4,1,3,0,10,4,6,6,bahrain
Al Hala,6,2,0,4,5,12,-7,6,bahrain
Sitra,4,1,2,1,3,4,-1,5,bahrain
Al-Hidd,5,1,0,4,6,12,-6,3,bahrain
Busaiteen,4,0,1,3,5,10,-5,1,bahrain
Bashundhara K.,3,3,0,0,12,4,8,9,bangladesh
Abahani,2,1,1,0,4,2,2,4,bangladesh
Fortis,3,1,1,1,4,4,0,4,bangladesh
B. Police,3,1,0,2,4,4,0,3,bangladesh
Sheikh Russel,2,1,0,1,2,2,0,3,bangladesh
Rahmatgonj,2,0,2,0,3,3,0,2,bangladesh
Chittagong,1,0,1,0,2,2,0,1,bangladesh
Mohammedan,1,0,1,0,1,1,0,1,bangladesh
Brothers Union,1,0,0,1,1,5,-4,0,bangladesh
Sheikh Jamal,2,0,0,2,0,4,-4,0,bangladesh
Dinamo Minsk,8,6,1,1,22,7,15,19,belarus
Neman Grodno,8,5,2,1,19,6,13,17,belarus
BATE Borisov,8,5,0,3,18,12,6,15,belarus
Isloch,8,4,2,2,14,9,5,14,belarus
FC Minsk,8,4,2,2,7,5,2,14,belarus
Slutsk,8,3,3,2,12,11,1,12,belarus
S. Soligorsk,8,4,0,4,11,13,-2,12,belarus
Gomel,8,4,0,4,16,20,-4,12,belarus
Slavia Mozyr,8,3,2,3,7,7,0,11,belarus
Dinamo Brest,8,3,2,3,13,15,-2,11,belarus
T. Zhodino,8,1,6,1,7,7,0,9,belarus
Naftan,8,2,3,3,11,17,-6,9,belarus
Smorgon,8,2,2,4,9,13,-4,8,belarus
Energetik-BGU,8,2,0,6,10,17,-7,6,belarus
Belshina,8,1,1,6,4,17,-13,4,belarus
Vitebsk,8,7,1,0,20,4,16,22,belarus2
Dnepr Mogilev,8,7,1,0,16,2,14,22,belarus2
Arsenal D.,8,7,0,1,30,7,23,21,belarus2
Maxline,8,7,0,1,24,11,13,21,belarus2
Lokomotiv Gomel,8,5,0,3,10,10,0,15,belarus2
Molodechno-DYuS,8,4,1,3,17,7,10,13,belarus2
Baranovichi,8,4,1,3,13,13,0,13,belarus2
Niva,8,3,2,3,14,12,2,11,belarus2
Bumprom,8,3,2,3,12,18,-6,11,belarus2
Zhodino Yuzhnoe,8,3,1,4,16,15,1,10,belarus2
Volna Pinsk,8,3,1,4,11,16,-5,10,belarus2
Lida,8,2,3,3,11,12,-1,9,belarus2
Orsha,8,3,0,5,10,14,-4,9,belarus2
S.Petrikov,8,2,2,4,10,16,-6,8,belarus2
Slonim,8,2,1,5,5,20,-15,7,belarus2
FC Ostrovets,8,1,2,5,12,23,-11,5,belarus2
Osipovichy,8,0,1,7,2,17,-15,1,belarus2
Anderlecht,8,6,2,0,19,8,11,20,belgium
Royale Union SG,8,6,1,1,17,8,9,19,belgium
KRC Genk,8,4,4,0,23,10,13,16,belgium
Antwerp,8,4,4,0,17,6,11,16,belgium
Club Brugge,8,4,4,0,12,4,8,16,belgium
Charleroi,8,5,1,2,15,13,2,16,belgium
Gent,8,4,3,1,17,7,10,15,belgium
Cercle Brugge,8,5,0,3,13,11,2,15,belgium
Standard Liege,8,3,4,1,8,6,2,13,belgium
Sint-Truiden,8,3,3,2,8,10,-2,12,belgium
KV Mechelen,8,3,2,3,6,6,0,11,belgium
OH Leuven,8,3,1,4,13,8,5,10,belgium
Westerlo,8,3,1,4,13,15,-2,10,belgium
RWDM,8,2,4,2,11,13,-2,10,belgium
Kortrijk,8,2,2,4,7,14,-7,8,belgium
Eupen,8,2,1,5,11,16,-5,7,belgium
Bolivar,8,8,0,0,33,7,26,24,bolivia
The Strongest,8,7,1,0,24,3,21,22,bolivia
Always Ready,8,7,1,0,21,7,14,22,bolivia
Wilstermann,8,6,2,0,13,2,11,20,bolivia
Nacional Potosi,8,6,1,1,29,9,20,19,bolivia
Real Tomayapo,8,5,3,0,13,3,10,18,bolivia
Oriente P.,8,5,3,0,11,3,8,18,bolivia
Guabira,8,5,2,1,18,7,11,17,bolivia
Aurora,8,5,0,3,11,8,3,15,bolivia
Santa Cruz,8,4,3,1,9,9,0,15,bolivia
Blooming,8,4,2,2,9,8,1,14,bolivia
I. Petrolero,8,4,1,3,9,9,0,13,bolivia
Vaca Diez,8,3,3,2,13,12,1,12,bolivia
Libertad,8,4,0,4,10,10,0,12,bolivia
Royal Pari,8,2,5,1,11,8,3,11,bolivia
U. de Vinto,8,2,4,2,7,8,-1,10,bolivia
A. Palmaflor,8,2,3,3,10,15,-5,9,bolivia
Bolivar,8,7,1,0,19,2,17,22,bolivia2
Nacional Potosi,8,7,1,0,20,8,12,22,bolivia2
Oriente P.,8,6,2,0,16,6,10,20,bolivia2
Always Ready,8,6,0,2,18,6,12,18,bolivia2
Guabira,8,5,3,0,12,7,5,18,bolivia2
U. de Vinto,8,4,3,1,14,7,7,15,bolivia2
I. Petrolero,8,4,3,1,13,6,7,15,bolivia2
The Strongest,8,4,3,1,19,13,6,15,bolivia2
Blooming,8,4,3,1,9,4,5,15,bolivia2
Royal Pari,8,5,0,3,12,10,2,15,bolivia2
U. Sucre,8,4,2,2,14,12,2,14,bolivia2
A. Palmaflor,8,3,4,1,15,10,5,13,bolivia2
Wilstermann,8,4,1,3,12,10,2,13,bolivia2
Real Tomayapo,8,3,3,2,9,8,1,12,bolivia2
Santa Cruz,8,3,2,3,8,11,-3,11,bolivia2
Aurora,8,2,2,4,6,14,-8,8,bolivia2
Sao Paulo,8,6,1,1,11,4,7,19,brazil
Palmeiras,8,6,0,2,16,4,12,18,brazil
Atletico MG,8,6,0,2,14,6,8,18,brazil
Gremio,8,6,0,2,11,6,5,18,brazil
Vasco da Gama,8,5,1,2,14,9,5,16,brazil
Bragantino,8,5,1,2,11,7,4,16,brazil
Fluminense,8,5,1,2,15,12,3,16,brazil
Flamengo,8,5,1,2,10,7,3,16,brazil
Internacional,8,4,2,2,18,11,7,14,brazil
Athletico PR,8,3,5,0,12,7,5,14,brazil
Bahia,8,4,1,3,10,8,2,13,brazil
Fortaleza,8,3,3,2,11,11,0,12,brazil
Cuiaba,8,3,2,3,9,7,2,11,brazil
Corinthians,8,2,4,2,8,11,-3,10,brazil
Cruzeiro,8,1,5,2,9,9,0,8,brazil
Goias,8,2,2,4,8,11,-3,8,brazil
Santos,8,2,2,4,8,13,-5,8,brazil
Coritiba,8,2,1,5,5,11,-6,7,brazil
Botafogo,8,0,4,4,10,14,-4,4,brazil
America MG,8,1,1,6,8,18,-10,4,brazil
Cherno More,8,7,1,0,15,5,10,22,bulgaria
Levski Sofia,8,6,1,1,10,2,8,19,bulgaria
Lok. Plovdiv,8,6,0,2,15,6,9,18,bulgaria
Ludogorets,8,5,2,1,23,7,16,17,bulgaria
Botev Plovdiv,8,5,1,2,19,7,12,16,bulgaria
CSKA Sofia,8,4,3,1,11,3,8,15,bulgaria
CSKA 1948 Sofia,8,4,3,1,7,6,1,15,bulgaria
Arda,8,4,2,2,11,6,5,14,bulgaria
L. Krumovgrad,8,4,2,2,9,9,0,14,bulgaria
Slavia Sofia,8,4,1,3,7,7,0,13,bulgaria
Beroe,8,3,3,2,7,6,1,12,bulgaria
Hebar,8,2,3,3,9,11,-2,9,bulgaria
Pirin Blag.,8,2,2,4,6,9,-3,8,bulgaria
Lokomotiv Sofia,8,1,3,4,6,10,-4,6,bulgaria
Botev Vratsa,8,2,0,6,7,13,-6,6,bulgaria
Etar,8,1,0,7,6,18,-12,3,bulgaria
Cavalry,8,7,0,1,14,5,9,21,canada
HFX Wanderers,8,5,0,3,15,9,6,15,canada
Forge,8,3,4,1,14,10,4,13,canada
Vancouver FC,8,4,1,3,11,15,-4,13,canada
A. Ottawa,8,3,3,2,11,8,3,12,canada
Pacific,8,2,2,4,8,11,-3,8,canada
York Utd,8,2,1,5,5,15,-10,7,canada
Valour,8,1,0,7,7,17,-10,3,canada
Cobresal,8,5,2,1,19,13,6,17,chile
Copiapo,8,5,2,1,14,10,4,17,chile
Colo-Colo,8,5,1,2,16,6,10,16,chile
Palestino,8,5,1,2,13,5,8,16,chile
Huachipato,8,4,3,1,14,7,7,15,chile
Union Espanola,8,3,4,1,15,9,6,13,chile
Coquimbo Unido,8,4,1,3,11,11,0,13,chile
Union La Calera,8,3,2,3,14,14,0,11,chile
Magallanes,8,3,2,3,11,12,-1,11,chile
U. Catolica,8,3,2,3,9,11,-2,11,chile
Audax Italiano,8,3,1,4,7,9,-2,10,chile
U. de Chile,8,2,2,4,11,13,-2,8,chile
Everton,8,2,2,4,9,12,-3,8,chile
Nublense,8,1,4,3,5,7,-2,7,chile
O`Higgins,8,1,2,5,5,11,-6,5,chile
Curico Unido,8,1,0,7,7,17,-10,3,chile
Cobreloa,8,8,0,0,11,1,10,24,chile2
S. Wanderers,8,4,4,0,11,4,7,16,chile2
U. Concepcion,8,4,4,0,14,8,6,16,chile2
San Marcos,8,5,1,2,18,15,3,16,chile2
Deportes Temuco,8,5,0,3,13,10,3,15,chile2
Antofagasta,8,4,2,2,12,8,4,14,chile2
Barnechea,8,3,3,2,13,11,2,12,chile2
U. San Felipe,8,3,2,3,11,7,4,11,chile2
D. Iquique,8,3,2,3,14,15,-1,11,chile2
La Serena,8,3,2,3,6,7,-1,11,chile2
CD Santa Cruz,8,2,4,2,8,8,0,10,chile2
Rangers,8,3,1,4,8,10,-2,10,chile2
S. Morning,8,2,2,4,7,10,-3,8,chile2
San Luis,8,1,3,4,12,11,1,6,chile2
Puerto Montt,8,1,3,4,8,16,-8,6,chile2
Recoleta,8,1,2,5,12,14,-2,5,chile2
S. Taishan,8,7,0,1,25,6,19,21,china
Zhejiang,8,6,2,0,19,5,14,20,china
Wuhan Three T.,8,6,0,2,15,8,7,18,china
Henan SL,8,5,2,1,18,5,13,17,china
Meizhou Hakka,8,5,2,1,16,10,6,17,china
Beijing Guoan,8,5,1,2,17,7,10,16,china
Qingdao Jonoon,8,5,1,2,17,14,3,16,china
Chengdu,8,5,0,3,16,6,10,15,china
Shanghai Port,8,4,2,2,16,10,6,14,china
Cangzhou,8,4,2,2,9,10,-1,14,china
S. Shenhua,8,4,1,3,11,11,0,13,china
Tianjin T.,8,2,6,0,11,8,3,12,china
Changchun Yatai,8,2,4,2,12,13,-1,10,china
Dalian P.,8,2,3,3,8,12,-4,9,china
Nantong Zhiyun,8,0,2,6,4,11,-7,2,china
Shenzhen,8,0,0,8,3,22,-19,0,china
Qingdao Y. I.,8,7,1,0,14,2,12,22,china2
Sichuan Jiuniu,8,6,0,2,16,6,10,18,china2
Shanghai Jiadin,8,5,2,1,9,5,4,17,china2
Hebei Kungfu,8,4,4,0,12,6,6,16,china2
Nanjing,8,5,1,2,11,5,6,16,china2
Shenyang Urban,8,4,3,1,12,5,7,15,china2
Dongguan United,8,4,3,1,11,6,5,15,china2
Guangxi Baoyun,8,4,3,1,8,5,3,15,china2
Yanbian Longdin,8,3,5,0,12,7,5,14,china2
Jinan Xingzhou,8,3,3,2,8,7,1,12,china2
Wuxi Wugou,8,3,2,3,12,9,3,11,china2
Heilongjiang L.,8,2,4,2,10,8,2,10,china2
Dantong Hantong,8,2,4,2,11,10,1,10,china2
Guangzhou FC,8,2,2,4,6,11,-5,8,china2
Jiangxi L.,8,1,1,6,12,17,-5,4,china2
Suzhou Dongwu,8,1,1,6,6,13,-7,4,china2
R. Aguilas,8,7,1,0,15,4,11,22,colombia
A. Petrolera,8,7,0,1,17,8,9,21,colombia
Santa Fe,8,6,0,2,17,4,13,18,colombia
Millonarios,8,5,3,0,15,8,7,18,colombia
I. Medelin,8,5,2,1,16,6,10,17,colombia
America de Cali,8,5,2,1,12,6,6,17,colombia
Boyaca Chico,8,4,4,0,13,5,8,16,colombia
La Equidad,8,4,4,0,12,5,7,16,colombia
A. Nacional,8,4,3,1,12,6,6,15,colombia
Deportivo Pasto,8,4,3,1,10,4,6,15,colombia
Deportes Tolima,8,4,3,1,12,8,4,15,colombia
Junior,8,4,3,1,7,4,3,15,colombia
D. Pereira,8,3,4,1,12,9,3,13,colombia
Deportivo Cali,8,3,4,1,9,6,3,13,colombia
Once Caldas,8,3,3,2,10,7,3,12,colombia
Jaguares de C.,8,3,3,2,9,6,3,12,colombia
Union Magdalena,8,2,5,1,10,10,0,11,colombia
Atletico Huila,8,3,2,3,10,12,-2,11,colombia
A. Bucaramanga,8,2,3,3,9,9,0,9,colombia
Envigado,8,2,3,3,6,7,-1,9,colombia
R. Aguilas,8,6,2,0,18,5,13,20,colombia2
I. Medelin,8,6,2,0,11,3,8,20,colombia2
A. Nacional,8,6,0,2,20,5,15,18,colombia2
America de Cali,8,6,0,2,18,6,12,18,colombia2
Deportivo Cali,8,5,3,0,14,4,10,18,colombia2
Junior,8,5,2,1,18,8,10,17,colombia2
Deportes Tolima,8,5,2,1,11,5,6,17,colombia2
Deportivo Pasto,8,5,2,1,10,4,6,17,colombia2
Millonarios,8,5,2,1,13,8,5,17,colombia2
La Equidad,8,3,5,0,7,3,4,14,colombia2
A. Petrolera,8,4,1,3,10,12,-2,13,colombia2
Boyaca Chico,8,3,3,2,9,9,0,12,colombia2
Once Caldas,8,2,5,1,7,6,1,11,colombia2
Union Magdalena,8,3,2,3,10,12,-2,11,colombia2
D. Pereira,8,3,1,4,10,11,-1,10,colombia2
Santa Fe,8,3,1,4,7,11,-4,10,colombia2
Atletico Huila,8,1,6,1,10,8,2,9,colombia2
Envigado,8,2,3,3,11,10,1,9,colombia2
A. Bucaramanga,8,2,3,3,7,9,-2,9,colombia2
Jaguares de C.,8,1,3,4,2,5,-3,6,colombia2
Saprissa,8,8,0,0,26,2,24,24,costarica
Herediano,8,7,1,0,18,4,14,22,costarica
Alajuelense,8,6,0,2,17,6,11,18,costarica
Cartagines,8,5,2,1,19,13,6,17,costarica
San Carlos,8,4,2,2,11,9,2,14,costarica
Santos DG,8,4,2,2,8,6,2,14,costarica
Guanacasteca,8,4,1,3,13,11,2,13,costarica
Puntarenas,8,4,0,4,11,10,1,12,costarica
Sporting SJ,8,3,2,3,11,11,0,11,costarica
M. Liberia,8,2,3,3,9,10,-1,9,costarica
Zeledon,8,2,3,3,10,14,-4,9,costarica
AD Grecia,8,1,3,4,7,10,-3,6,costarica
Sparta Prague,8,8,0,0,23,3,20,24,czechrepublic
Slavia Prague,8,6,1,1,16,6,10,19,czechrepublic
Viktoria Plzen,8,6,0,2,22,11,11,18,czechrepublic
Slovacko,8,5,3,0,15,5,10,18,czechrepublic
Slovan Liberec,8,5,1,2,17,12,5,16,czechrepublic
Banik Ostrava,8,4,1,3,14,7,7,13,czechrepublic
Mlada Boleslav,8,4,1,3,14,10,4,13,czechrepublic
Jablonec,8,3,4,1,10,7,3,13,czechrepublic
Bohemians,8,3,4,1,7,6,1,13,czechrepublic
Sigma Olomouc,8,3,2,3,11,11,0,11,czechrepublic
Hradec Kralove,8,3,2,3,10,11,-1,11,czechrepublic
Karvina,8,3,1,4,13,12,1,10,czechrepublic
Teplice,8,2,4,2,4,4,0,10,czechrepublic
C. Budejovice,8,3,0,5,9,12,-3,9,czechrepublic
Zlin,8,2,3,3,15,21,-6,9,czechrepublic
Pardubice,8,2,2,4,7,8,-1,8,czechrepublic
FC Midtjylland,8,5,2,1,16,7,9,17,denmark
Silkeborg,8,5,2,1,14,6,8,17,denmark
Brondby IF,8,5,1,2,17,8,9,16,denmark
Nordsjaelland,8,4,3,1,13,5,8,15,denmark
Viborg,8,4,3,1,12,10,2,15,denmark
AGF Aarhus,8,4,2,2,10,10,0,14,denmark
Lyngby,8,3,4,1,14,10,4,13,denmark
FC Kobenhavn,8,4,1,3,12,9,3,13,denmark
Randers FC,8,2,3,3,7,13,-6,9,denmark
Vejle BK,8,2,2,4,9,10,-1,8,denmark
Odense BK,8,0,2,6,6,15,-9,2,denmark
Hvidovre,8,0,1,7,4,20,-16,1,denmark
SonderjyskE,8,6,1,1,23,4,19,19,denmark2
Aalborg BK,8,5,2,1,18,7,11,17,denmark2
Vendsyssel,8,5,1,2,11,9,2,16,denmark2
Fredericia,8,4,2,2,11,9,2,14,denmark2
AC Horsens,8,3,2,3,12,11,1,11,denmark2
Kolding IF,8,3,0,5,11,10,1,9,denmark2
Hillerod,8,2,3,3,7,8,-1,9,denmark2
Naestved,8,1,5,2,11,12,-1,8,denmark2
Hobro,8,2,1,5,7,10,-3,7,denmark2
HB Koge,8,2,1,5,7,15,-8,7,denmark2
Helsingor,8,1,2,5,12,20,-8,5,denmark2
B 93,8,1,1,6,4,23,-19,4,denmark2
Cuniburo,8,6,2,0,22,5,17,20,ecuador3
Nueve Octubre,8,5,2,1,15,5,10,17,ecuador3
America de Q.,8,5,1,2,14,7,7,16,ecuador3
Imbabura,8,4,2,2,16,11,5,14,ecuador3
Macara,8,4,2,2,12,8,4,14,ecuador3
Chacaritas,8,4,1,3,13,7,6,13,ecuador3
I. Juniors,8,3,3,2,12,10,2,12,ecuador3
Vargas Torres,8,3,3,2,7,6,1,12,ecuador3
Manta,8,2,3,3,6,7,-1,9,ecuador3
Guayaquil,8,1,3,4,6,10,-4,6,ecuador3
ENPPI,6,4,1,1,10,4,6,13,egypt
Al Ittihad,5,3,2,0,9,5,4,11,egypt
Pyramids FC,5,3,2,0,10,7,3,11,egypt
Smouha,5,3,1,1,6,4,2,10,egypt
El Geish,6,3,1,2,6,5,1,10,egypt
Al Masry,5,3,1,1,4,5,-1,10,egypt
Ceramica C.,4,3,0,1,11,4,7,9,egypt
ZED FC,4,2,2,0,8,5,3,8,egypt
Al Ahly,3,2,1,0,7,1,6,7,egypt
Ismaily,4,2,0,2,7,6,1,6,egypt
El Daklyeh,6,1,3,2,2,4,-2,6,egypt
Zamalek,3,1,1,1,7,4,3,4,egypt
El Gouna,4,1,1,2,4,4,0,4,egypt
Future FC,5,1,1,3,3,6,-3,4,egypt
Baladiyyat,5,1,1,3,5,10,-5,4,egypt
National Bank,6,1,0,5,7,10,-3,3,egypt
Al Mokawloon,4,0,2,2,4,7,-3,2,egypt
Pharco,5,0,2,3,4,8,-4,2,egypt
Aston Villa,8,7,1,0,22,7,15,22,england
Liverpool,8,6,2,0,20,7,13,20,england
Arsenal,8,6,1,1,20,6,14,19,england
Manchester City,8,5,3,0,23,9,14,18,england
Newcastle Utd,8,6,0,2,18,7,11,18,england
Wolverhampton,8,5,3,0,14,7,7,18,england
Brighton,8,4,4,0,17,10,7,16,england
Fulham,8,5,0,3,18,9,9,15,england
West Ham Utd,8,4,3,1,13,6,7,15,england
Tottenham,8,5,0,3,16,12,4,15,england
Chelsea,8,4,2,2,14,12,2,14,england
Manchester Utd,8,4,1,3,10,13,-3,13,england
Brentford,8,4,0,4,15,15,0,12,england
Everton,8,3,2,3,11,9,2,11,england
Bournemouth,8,3,2,3,10,11,-1,11,england
Nottm Forest,8,2,2,4,11,13,-2,8,england
Luton Town,8,2,1,5,11,14,-3,7,england
Sheffield Utd,8,2,1,5,9,21,-12,7,england
Crystal Palace,8,1,3,4,8,11,-3,6,england
Burnley,8,1,1,6,8,14,-6,4,england
Southampton,8,8,0,0,23,3,20,24,england2
Leeds Utd,8,7,1,0,22,7,15,22,england2
Leicester City,8,7,0,1,19,4,15,21,england2
West Brom,8,6,1,1,15,5,10,19,england2
Plymouth,8,5,3,0,22,13,9,18,england2
Ipswich Town,8,5,3,0,16,10,6,18,england2
Hull City,8,5,0,3,14,8,6,15,england2
Coventry City,8,4,3,1,11,6,5,15,england2
Sunderland,8,5,0,3,12,9,3,15,england2
Norwich City,8,4,2,2,11,7,4,14,england2
Sheffield Wed,8,4,1,3,13,12,1,13,england2
Bristol City,8,4,1,3,10,9,1,13,england2
Watford,8,3,3,2,15,12,3,12,england2
QP Rangers,8,3,2,3,10,7,3,11,england2
Middlesbrough,8,3,1,4,9,10,-1,10,england2
Preston,8,3,1,4,11,15,-4,10,england2
Swansea City,8,2,3,3,8,10,-2,9,england2
Blackburn,8,2,2,4,11,13,-2,8,england2
Millwall,8,2,2,4,7,11,-4,8,england2
Rotherham,8,1,4,3,7,10,-3,7,england2
Birmingham City,8,1,4,3,9,13,-4,7,england2
Huddersfield,8,1,4,3,8,12,-4,7,england2
Stoke City,8,1,4,3,3,7,-4,7,england2
Cardiff City,8,2,1,5,7,12,-5,7,england2
Derby County,8,6,1,1,20,8,12,19,england3
Peterborough,8,5,3,0,22,7,15,18,england3
Blackpool,8,6,0,2,20,9,11,18,england3
Bolton,8,6,0,2,19,10,9,18,england3
Barnsley,8,5,3,0,14,7,7,18,england3
Northampton,8,5,2,1,13,8,5,17,england3
Wigan Athletic,8,5,1,2,12,5,7,16,england3
Oxford Utd,8,4,3,1,15,8,7,15,england3
Bristol Rovers,8,4,3,1,13,8,5,15,england3
Cheltenham,8,4,3,1,12,7,5,15,england3
Stevenage,8,4,3,1,12,7,5,15,england3
Burton Albion,8,4,2,2,10,6,4,14,england3
Cambridge Utd,8,4,2,2,8,8,0,14,england3
Portsmouth,8,4,2,2,10,11,-1,14,england3
Shrewsbury,8,4,0,4,10,12,-2,12,england3
Reading,8,3,2,3,16,13,3,11,england3
Exeter City,8,2,4,2,4,5,-1,10,england3
Charlton,8,2,3,3,13,12,1,9,england3
Leyton Orient,8,2,3,3,6,9,-3,9,england3
Carlisle Utd,8,2,2,4,8,11,-3,8,england3
Port Vale,8,2,1,5,12,13,-1,7,england3
Lincoln City,8,1,4,3,8,10,-2,7,england3
Wycombe,8,1,3,4,8,12,-4,6,england3
Fleetwood,8,1,2,5,8,14,-6,5,england3
Wrexham,8,8,0,0,23,5,18,24,england4
Stockport,8,6,1,1,20,6,14,19,england4
Milton Keynes,8,5,2,1,16,8,8,17,england4
Tranmere,8,5,1,2,18,11,7,16,england4
Crewe Alexandra,8,5,1,2,13,11,2,16,england4
AFC Wimbledon,8,5,0,3,21,12,9,15,england4
Notts County,8,5,0,3,20,11,9,15,england4
Walsall,8,4,3,1,11,4,7,15,england4
Barrow,8,4,3,1,9,6,3,15,england4
Accrington,8,4,1,3,12,8,4,13,england4
Mansfield,8,3,4,1,9,5,4,13,england4
Newport,8,3,4,1,13,10,3,13,england4
Doncaster,8,4,0,4,12,14,-2,12,england4
Harrogate,8,3,2,3,12,13,-1,11,england4
Sutton Utd,8,2,4,2,13,11,2,10,england4
Morecambe,8,2,4,2,12,11,1,10,england4
Swindon Town,8,3,1,4,10,13,-3,10,england4
Gillingham,8,3,1,4,7,10,-3,10,england4
Forest Green,8,2,3,3,10,11,-1,9,england4
Crawley Town,8,3,0,5,12,14,-2,9,england4
Bradford,8,2,3,3,9,12,-3,9,england4
Colchester Utd,8,2,2,4,10,13,-3,8,england4
Grimsby,8,2,2,4,15,22,-7,8,england4
Salford City,8,1,3,4,12,20,-8,6,england4
Chesterfield,8,8,0,0,27,8,19,24,england5
Altrincham,8,6,1,1,23,9,14,19,england5
Bromley,8,5,2,1,18,10,8,17,england5
Aldershot Town,8,5,2,1,15,11,4,17,england5
Eastleigh,8,5,1,2,18,12,6,16,england5
Barnet,8,5,1,2,16,11,5,16,england5
Wealdstone,8,4,4,0,16,11,5,16,england5
Southend Utd,8,5,0,3,17,7,10,15,england5
Rochdale,8,4,3,1,16,9,7,15,england5
Boreham Wood,8,3,4,1,11,9,2,13,england5
Halifax Town,8,3,4,1,11,9,2,13,england5
Maidenhead Utd,8,3,4,1,9,8,1,13,england5
Solihull Moors,8,4,0,4,12,8,4,12,england5
AFC Fylde,8,3,3,2,12,10,2,12,england5
Gateshead FC,8,3,2,3,13,11,2,11,england5
Oldham,8,2,4,2,13,11,2,10,england5
York City,8,2,4,2,13,13,0,10,england5
Kidderminster,8,3,1,4,11,11,0,10,england5
Dorking,8,3,0,5,9,13,-4,9,england5
Oxford City,8,2,1,5,12,16,-4,7,england5
Hartlepool,8,2,1,5,11,17,-6,7,england5
Dagenham & R.,8,2,0,6,10,14,-4,6,england5
Ebbsfleet Utd,8,1,2,5,6,13,-7,5,england5
Woking,8,0,1,7,4,13,-9,1,england5
Paide,8,5,3,0,19,6,13,18,estonia
Nomme Kalju,8,5,3,0,21,9,12,18,estonia
Flora,8,5,3,0,15,4,11,18,estonia
Levadia,8,5,3,0,14,4,10,18,estonia
Tallinna Kalev,8,4,3,1,14,7,7,15,estonia
Kuressaare,8,4,3,1,10,7,3,15,estonia
Narva Trans,8,4,1,3,11,11,0,13,estonia
Vaprus,8,3,3,2,12,11,1,12,estonia
Tammeka,8,2,2,4,10,14,-4,8,estonia
Harju Jalgpalli,8,2,0,6,6,13,-7,6,estonia
Nomme Utd,8,6,2,0,24,7,17,20,estonia2
Viimsi,8,5,1,2,15,9,6,16,estonia2
Flora B,8,5,0,3,22,11,11,15,estonia2
Tabasalu,8,4,0,4,21,17,4,12,estonia2
Paide B,8,4,0,4,12,20,-8,12,estonia2
Elva,8,3,2,3,9,15,-6,11,estonia2
Levadia B,8,1,5,2,9,9,0,8,estonia2
FC Tallinn,8,2,1,5,13,14,-1,7,estonia2
Alliance,8,2,0,6,15,24,-9,6,estonia2
Legion,8,0,1,7,7,26,-19,1,estonia2
Vikingur,8,7,1,0,31,3,28,22,faroeislands
B36 Torshavn,8,6,2,0,14,3,11,20,faroeislands
Klaksvik,8,5,2,1,16,7,9,17,faroeislands
07 Vestur,8,5,2,1,15,9,6,17,faroeislands
HB Torshavn,8,5,1,2,22,9,13,16,faroeislands
AB Argir,8,5,1,2,17,11,6,16,faroeislands
Streymur,8,3,0,5,8,11,-3,9,faroeislands
IF Fuglafjordur,8,2,2,4,7,21,-14,8,faroeislands
B68 Toftir,8,1,3,4,11,16,-5,6,faroeislands
TB Tvoroyri,8,1,0,7,5,19,-14,3,faroeislands
B71 Sandur,8,8,0,0,28,4,24,24,faroeislands2
Skala,8,8,0,0,30,7,23,24,faroeislands2
NSI Runavik,8,5,1,2,20,8,12,16,faroeislands2
Klaksvik B,8,4,2,2,20,9,11,14,faroeislands2
Vikingur B,8,4,2,2,17,15,2,14,faroeislands2
B36 Torshavn B,8,4,1,3,17,10,7,13,faroeislands2
Hoyvik,8,4,1,3,13,12,1,13,faroeislands2
HB B,8,3,1,4,14,22,-8,10,faroeislands2
B68 Toftir B,8,3,1,4,14,25,-11,10,faroeislands2
Streymur B,8,1,1,6,7,29,-22,4,faroeislands2
VPS,8,6,1,1,19,9,10,19,finland
Honka,8,6,1,1,14,6,8,19,finland
HJK Helsinki,8,5,1,2,14,7,7,16,finland
Haka,8,3,5,0,13,8,5,14,finland
Oulu,8,4,2,2,14,11,3,14,finland
KuPS,8,4,1,3,10,6,4,13,finland
Lahti,8,4,0,4,10,15,-5,12,finland
Ilves,8,2,3,3,8,12,-4,9,finland
Inter Turku,8,2,1,5,8,13,-5,7,finland
KTP,8,2,1,5,6,13,-7,7,finland
SJK,8,2,0,6,11,18,-7,6,finland
Mariehamn,8,1,2,5,4,10,-6,5,finland
Ekenas IF,8,6,2,0,14,7,7,20,finland2
TPS,8,6,0,2,21,9,12,18,finland2
Gnistan,8,5,2,1,13,10,3,17,finland2
KaPa,8,4,3,1,18,10,8,15,finland2
SalPa,8,4,2,2,16,8,8,14,finland2
SJK Akatemia,8,4,2,2,14,12,2,14,finland2
Jaro,8,3,3,2,15,13,2,12,finland2
HIFK,8,3,3,2,14,13,1,12,finland2
KPV Kokkola,8,2,3,3,12,15,-3,9,finland2
Mikkelin,8,2,3,3,6,9,-3,9,finland2
JaPS,8,2,2,4,15,16,-1,8,finland2
JJK,8,1,1,6,5,13,-8,4,finland2
Paris SG,8,7,0,1,25,8,17,21,france
Nice,8,6,2,0,10,1,9,20,france
Marseille,8,5,3,0,13,2,11,18,france
Lille,8,5,2,1,12,4,8,17,france
Lens,8,5,1,2,13,7,6,16,france
Brest,8,4,3,1,14,5,9,15,france
Monaco,8,5,0,3,13,8,5,15,france
Reims,8,5,0,3,10,9,1,15,france
Le Havre,8,4,2,2,11,7,4,14,france
Strasbourg,8,3,3,2,10,8,2,12,france
Rennes,8,3,2,3,13,11,2,11,france
Nantes,8,3,2,3,10,9,1,11,france
Lyon,8,2,3,3,10,12,-2,9,france
Toulouse,8,1,5,2,10,9,1,8,france
Montpellier,8,1,5,2,7,8,-1,8,france
Lorient,8,2,2,4,13,16,-3,8,france
Metz,8,1,2,5,5,8,-3,5,france
Clermont,8,1,2,5,2,9,-7,5,france
Angers,8,8,0,0,15,0,15,24,france2
AC Ajaccio,8,6,2,0,14,5,9,20,france2
Auxerre,8,6,1,1,22,9,13,19,france2
Rodez Aveyron,8,5,3,0,18,9,9,18,france2
Grenoble,8,4,3,1,12,10,2,15,france2
Pau FC,8,3,4,1,15,14,1,13,france2
Guingamp,8,3,3,2,13,7,6,12,france2
SC Bastia,8,3,3,2,8,9,-1,12,france2
Saint-Etienne,8,3,2,3,9,8,1,11,france2
Paris FC,8,3,2,3,10,10,0,11,france2
Caen,8,3,2,3,9,9,0,11,france2
Laval,8,3,2,3,8,11,-3,11,france2
Troyes,8,3,1,4,9,10,-1,10,france2
Bordeaux,8,2,3,3,10,10,0,9,france2
Quevilly Rouen,8,2,2,4,11,12,-1,8,france2
Amiens,8,1,5,2,4,7,-3,8,france2
Annecy,8,1,4,3,9,11,-2,7,france2
Concarneau,8,2,1,5,9,15,-6,7,france2
Valenciennes,8,0,3,5,4,9,-5,3,france2
USL Dunkerque,8,0,1,7,2,16,-14,1,france2
Red Star,8,8,0,0,18,4,14,24,france3
Niort,8,5,2,1,15,7,8,17,france3
Avranches,8,5,2,1,13,6,7,17,france3
Villefranche,8,5,2,1,13,6,7,17,france3
Dijon,8,5,1,2,16,9,7,16,france3
Martigues,8,5,1,2,13,6,7,16,france3
Rouen,8,4,4,0,12,5,7,16,france3
Sochaux,8,5,1,2,16,10,6,16,france3
Versailles,8,3,4,1,18,9,9,13,france3
Marignane G.,8,3,4,1,12,7,5,13,france3
Nancy,8,3,4,1,11,8,3,13,france3
Orleans,8,4,1,3,12,10,2,13,france3
G. O. A. L.,7,3,2,2,10,7,3,11,france3
Epinal,8,2,3,3,11,9,2,9,france3
Nimes,8,2,3,3,9,11,-2,9,france3
Chateauroux,8,2,1,5,7,11,-4,7,france3
Cholet,8,2,1,5,3,8,-5,7,france3
Le Mans,8,1,3,4,6,11,-5,6,france3
Dinamo Tbilisi,8,6,1,1,24,9,15,19,georgia
Torpedo Kutaisi,8,5,2,1,24,7,17,17,georgia
Dinamo Batumi,8,4,4,0,21,7,14,16,georgia
Telavi,8,4,2,2,13,9,4,14,georgia
Samgurali,8,4,2,2,12,9,3,14,georgia
Gagra,8,4,1,3,13,15,-2,13,georgia
Dila Gori,8,4,0,4,11,11,0,12,georgia
Samtredia,8,3,1,4,16,16,0,10,georgia
Saburtalo,8,2,3,3,13,9,4,9,georgia
Shukura,8,0,1,7,4,33,-29,1,georgia
Kolkheti Poti,8,8,0,0,14,2,12,24,georgia2
L. Tbilisi,8,5,2,1,21,8,13,17,georgia2
Spaeri,8,5,2,1,18,12,6,17,georgia2
Gareji Sagarejo,8,4,3,1,23,13,10,15,georgia2
WIT Georgia,8,4,3,1,9,4,5,15,georgia2
Kolkheti Khobi,8,3,3,2,8,7,1,12,georgia2
Bolnisi,8,3,1,4,21,13,8,10,georgia2
D. Tbilisi B,8,3,0,5,16,11,5,9,georgia2
Merani Martvili,8,1,2,5,11,22,-11,5,georgia2
Merani Tbilisi,8,0,1,7,3,27,-24,1,georgia2
Bayern Munich,8,7,1,0,33,5,28,22,germany
Leverkusen,8,7,1,0,26,4,22,22,germany
Stuttgart,8,6,1,1,21,7,14,19,germany
Heidenheim,8,5,2,1,16,12,4,17,germany
E. Frankfurt,8,4,3,1,15,8,7,15,germany
Freiburg,8,4,3,1,15,11,4,15,germany
RB Leipzig,8,4,2,2,18,9,9,14,germany
Monchengladbach,8,4,2,2,16,10,6,14,germany
Werder Bremen,8,4,2,2,15,10,5,14,germany
Dortmund,8,4,2,2,15,14,1,14,germany
Bochum,8,3,4,1,13,9,4,13,germany
Wolfsburg,8,4,1,3,12,9,3,13,germany
FC Augsburg,8,3,3,2,12,11,1,12,germany
Union Berlin,8,3,1,4,10,14,-4,10,germany
Hoffenheim,8,2,2,4,15,17,-2,8,germany
FC Koln,8,1,3,4,6,13,-7,6,germany
Darmstadt,8,1,2,5,8,14,-6,5,germany
FSV Mainz,8,1,2,5,6,13,-7,5,germany
Hamburger SV,8,7,0,1,18,6,12,21,germany2
Sankt Pauli,8,5,3,0,20,7,13,18,germany2
Greuther Furth,8,5,2,1,14,7,7,17,germany2
Hannover 96,8,4,3,1,19,8,11,15,germany2
Hertha Berlin,8,4,2,2,19,7,12,14,germany2
Paderborn,8,4,2,2,14,10,4,14,germany2
Karlsruher SC,8,4,2,2,15,12,3,14,germany2
Holstein Kiel,8,4,1,3,16,13,3,13,germany2
Kaiserslautern,8,4,1,3,16,15,1,13,germany2
FC Nurnberg,8,4,1,3,11,12,-1,13,germany2
Wehen Wiesbaden,8,3,3,2,8,9,-1,12,germany2
Magdeburg,8,3,2,3,18,15,3,11,germany2
Dusseldorf,8,3,2,3,16,15,1,11,germany2
Elversberg,8,3,2,3,12,13,-1,11,germany2
Braunschweig,8,3,2,3,11,14,-3,11,germany2
Schalke 04,8,3,1,4,15,15,0,10,germany2
Hansa Rostock,8,2,1,5,8,14,-6,7,germany2
Osnabruck,8,1,3,4,8,13,-5,6,germany2
Dynamo Dresden,8,6,0,2,11,5,6,18,germany3
RW Essen,8,6,0,2,14,12,2,18,germany3
FC Ingolstadt,8,5,2,1,19,8,11,17,germany3
Regensburg,8,5,2,1,14,8,6,17,germany3
Ulm,8,5,1,2,14,9,5,16,germany3
Preuss. Munster,8,4,3,1,19,12,7,15,germany3
Verl,8,4,2,2,16,12,4,14,germany3
Dortmund B,8,4,2,2,13,9,4,14,germany3
Viktoria Koln,8,4,2,2,12,12,0,14,germany3
Erzgebirge Aue,8,4,1,3,12,8,4,13,germany3
Unterhaching,8,3,3,2,12,6,6,12,germany3
Bielefeld,8,3,3,2,16,13,3,12,germany3
Mannheim,8,3,3,2,11,8,3,12,germany3
Saarbrucken,8,2,5,1,9,8,1,11,germany3
1860 Munchen,8,3,1,4,9,7,2,10,germany3
MSV Duisburg,8,3,1,4,10,11,-1,10,germany3
Hallescher,8,3,1,4,13,15,-2,10,germany3
Sandhausen,8,2,3,3,14,13,1,9,germany3
VfB Lubeck,8,2,2,4,11,16,-5,8,germany3
Freiburg B,8,0,2,6,4,17,-13,2,germany3
Samartex,8,8,0,0,18,2,16,24,ghana
Aduana Stars,8,7,0,1,17,5,12,21,ghana
Nsoatreman,8,6,1,1,9,1,8,19,ghana
Bechem Utd,8,5,2,1,14,4,10,17,ghana
Nations,8,5,2,1,15,6,9,17,ghana
Dreams,8,5,2,1,13,6,7,17,ghana
Berekum Chelsea,8,5,2,1,7,2,5,17,ghana
Medeama,8,5,2,1,7,3,4,17,ghana
Legon Cities,8,5,1,2,11,9,2,16,ghana
Great Olympics,8,4,3,1,7,3,4,15,ghana
Asante Kotoko,8,4,3,1,6,3,3,15,ghana
Hearts of Oak,8,3,4,1,8,5,3,13,ghana
Bibiani GS,8,3,3,2,15,9,6,12,ghana
Real Tamale,8,3,2,3,10,10,0,11,ghana
Heart of Lions,8,2,4,2,7,6,1,10,ghana
Karela,8,1,6,1,4,7,-3,9,ghana
Bofoakwe Tano,8,2,3,3,3,6,-3,9,ghana
Accra Lions,8,3,0,5,9,13,-4,9,ghana
St Josephs,6,6,0,0,17,2,15,18,gibraltar
Lincoln RI,6,5,0,1,21,5,16,15,gibraltar
Glacis Utd,6,5,0,1,11,4,7,15,gibraltar
Manchester 62,6,4,0,2,23,9,14,12,gibraltar
Magpies,5,3,1,1,10,5,5,10,gibraltar
Lynx,5,3,1,1,10,6,4,10,gibraltar
Europa Point,6,3,0,3,6,8,-2,9,gibraltar
Mons Calpe,6,2,2,2,8,9,-1,8,gibraltar
Europa FC,5,1,0,4,5,13,-8,3,gibraltar
College 1975,6,1,0,5,7,21,-14,3,gibraltar
Lions FC,6,0,2,4,3,16,-13,2,gibraltar
PAOK,8,7,1,0,23,1,22,22,greece
AEK Athens,8,6,2,0,17,4,13,20,greece
Panathinaikos,8,6,1,1,24,5,19,19,greece
Aris,8,5,2,1,12,7,5,17,greece
Olympiakos,8,5,0,3,22,11,11,15,greece
Atromitos,8,3,5,0,12,7,5,14,greece
Lamia,8,4,1,3,13,11,2,13,greece
Panserraikos,7,3,3,1,11,8,3,12,greece
Panaitolikos,8,3,2,3,11,15,-4,11,greece
OFI Crete,8,2,4,2,7,8,-1,10,greece
Asteras T.,8,3,0,5,7,16,-9,9,greece
Volos,8,2,1,5,9,15,-6,7,greece
Kifisia,8,1,3,4,9,17,-8,6,greece
PAS Giannina,8,1,2,5,4,12,-8,5,greece
Achuapa,8,6,1,1,15,8,7,19,guatemala
Comunicaciones,8,5,3,0,17,7,10,18,guatemala
Malacateco,8,5,2,1,15,7,8,17,guatemala
Antigua GFC,8,5,2,1,15,9,6,17,guatemala
Xelaju,8,5,2,1,9,4,5,17,guatemala
Mixco,8,5,1,2,9,5,4,16,guatemala
Zacapa Tellioz,8,5,0,3,15,8,7,15,guatemala
Guastatoya,8,4,2,2,13,7,6,14,guatemala
Coban Imperial,8,4,2,2,11,9,2,14,guatemala
Municipal,8,4,1,3,13,9,4,13,guatemala
Xinabajul,8,2,4,2,12,12,0,10,guatemala
Coatepecano IB,8,2,3,3,8,6,2,9,guatemala
Municipal,1,1,0,0,5,1,4,3,guatemala2
Comunicaciones,1,1,0,0,3,0,3,3,guatemala2
Antigua GFC,1,1,0,0,2,0,2,3,guatemala2
Malacateco,1,1,0,0,1,0,1,3,guatemala2
Achuapa,0,0,0,0,0,0,0,0,guatemala2
Coatepecano IB,0,0,0,0,0,0,0,0,guatemala2
Coban Imperial,0,0,0,0,0,0,0,0,guatemala2
Guastatoya,0,0,0,0,0,0,0,0,guatemala2
Mixco,0,0,0,0,0,0,0,0,guatemala2
Xelaju,0,0,0,0,0,0,0,0,guatemala2
Xinabajul,0,0,0,0,0,0,0,0,guatemala2
Zacapa Tellioz,0,0,0,0,0,0,0,0,guatemala2
Olimpia,8,7,1,0,26,6,20,22,honduras
Motagua,8,5,1,2,13,6,7,16,honduras
Marathon,8,5,1,2,12,7,5,16,honduras
Real Sociedad,8,5,1,2,10,5,5,16,honduras
Real Espana,8,4,2,2,13,9,4,14,honduras
Vida,8,3,4,1,15,11,4,13,honduras
Génesis,8,3,2,3,12,11,1,11,honduras
UPNFM,8,3,2,3,12,16,-4,11,honduras
Olancho,8,2,2,4,6,9,-3,8,honduras
Victoria,8,2,2,4,10,15,-5,8,honduras
Marathon,1,1,0,0,3,1,2,3,honduras2
Génesis,0,0,0,0,0,0,0,0,honduras2
Motagua,0,0,0,0,0,0,0,0,honduras2
Olancho,0,0,0,0,0,0,0,0,honduras2
Olimpia,0,0,0,0,0,0,0,0,honduras2
Real Espana,0,0,0,0,0,0,0,0,honduras2
Real Sociedad,0,0,0,0,0,0,0,0,honduras2
UPNFM,0,0,0,0,0,0,0,0,honduras2
Victoria,0,0,0,0,0,0,0,0,honduras2
Vida,1,0,0,1,1,2,-1,0,honduras2
Kitchee,6,5,1,0,23,2,21,16,hongkong
LM Warriors,6,5,1,0,20,7,13,16,hongkong
Eastern,4,3,0,1,7,3,4,9,hongkong
Wofoo Tai Po,4,3,0,1,7,3,4,9,hongkong
Southern D.,2,2,0,0,8,1,7,6,hongkong
HK Rangers,1,1,0,0,9,0,9,3,hongkong
Hong Kong FC,3,1,0,2,4,6,-2,3,hongkong
Resources C.,4,0,2,2,2,10,-8,2,hongkong
North District,3,0,1,2,5,7,-2,1,hongkong
HK U23,3,0,1,2,2,9,-7,1,hongkong
Sham Shui Po,5,0,1,4,4,12,-8,1,hongkong
Paks,8,7,1,0,19,5,14,22,hungary
MOL Fehervar,8,6,2,0,24,9,15,20,hungary
Debrecen,8,6,0,2,16,8,8,18,hungary
Ferencvaros,8,5,2,1,16,4,12,17,hungary
Diosgyor VTK,8,4,2,2,15,11,4,14,hungary
Kecskemeti TE,8,4,2,2,13,9,4,14,hungary
MTK,8,4,2,2,9,14,-5,14,hungary
Ujpest,8,4,1,3,15,13,2,13,hungary
Puskas Akad.,8,2,5,1,8,6,2,11,hungary
Kisvarda,7,3,1,3,11,7,4,10,hungary
Mezokovesd,8,3,0,5,11,14,-3,9,hungary
Zalaegerszegi,8,1,2,5,10,21,-11,5,hungary
Gyori ETO,8,7,1,0,20,3,17,22,hungary2
Nyiregyhaza,8,7,1,0,17,4,13,22,hungary2
Vasas,8,6,2,0,26,4,22,20,hungary2
Kozarmisleny,8,5,3,0,22,8,14,18,hungary2
Szeged,8,4,3,1,9,5,4,15,hungary2
Budafoki,8,4,2,2,11,6,5,14,hungary2
Kazincbarcika,8,3,5,0,12,8,4,14,hungary2
Gyirmot,8,3,4,1,13,12,1,13,hungary2
Honved,8,3,3,2,12,10,2,12,hungary2
Soroksar,8,2,4,2,8,8,0,10,hungary2
Csakvari,8,3,1,4,6,11,-5,10,hungary2
Pecsi MFC,8,2,3,3,2,6,-4,9,hungary2
Siofok,8,2,2,4,10,14,-4,8,hungary2
Haladas,6,1,4,1,8,8,0,7,hungary2
Tiszakecske,8,1,4,3,8,10,-2,7,hungary2
Ajka,8,2,1,5,5,11,-6,7,hungary2
BVSC,8,1,2,5,3,9,-6,5,hungary2
MTE,8,1,2,5,6,13,-7,5,hungary2
Stjarnan,8,8,0,0,26,2,24,24,iceland
Vikingur R.,8,7,1,0,31,9,22,22,iceland
Valur,8,7,0,1,21,11,10,21,iceland
KA Akureyri,8,6,2,0,17,9,8,20,iceland
Fram,8,5,1,2,16,10,6,16,iceland
KR Reykjavik,8,5,1,2,15,13,2,16,iceland
Hafnarfjordur,8,4,0,4,16,17,-1,12,iceland
IBV,8,2,4,2,9,9,0,10,iceland
Breidablik,8,3,1,4,12,14,-2,10,iceland
HK Kopavogur,8,1,6,1,12,11,1,9,iceland
Keflavik,8,1,4,3,13,16,-3,7,iceland
Fylkir,8,1,4,3,14,18,-4,7,iceland
IA Akranes,8,6,1,1,23,11,12,19,iceland2
Vestri,8,6,1,1,15,7,8,19,iceland2
Grotta,8,5,2,1,17,10,7,17,iceland2
Fjolnir,8,5,1,2,25,11,14,16,iceland2
Leiknir R.,8,5,1,2,16,11,5,16,iceland2
Throttur R.,8,4,2,2,20,15,5,14,iceland2
Afturelding,8,4,1,3,23,13,10,13,iceland2
Thor Akureyri,8,4,0,4,13,13,0,12,iceland2
Grindavik,8,3,2,3,13,10,3,11,iceland2
Selfoss,8,3,1,4,16,16,0,10,iceland2
Njardvík,8,2,2,4,15,17,-2,8,iceland2
AEggir,8,1,2,5,9,24,-15,5,iceland2
Dalvik / Reynir,8,7,1,0,24,9,15,22,iceland3
Fjardabyggd,8,6,1,1,18,9,9,19,iceland3
V. Olafsvik,8,5,2,1,21,8,13,17,iceland3
IR Reykjavik,8,5,1,2,21,10,11,16,iceland3
Hottur / Huginn,8,5,1,2,15,14,1,16,iceland3
Throttur Vogar,8,4,3,1,16,8,8,15,iceland3
Fjallabyggd,8,5,0,3,16,15,1,15,iceland3
Volsungur,8,4,0,4,14,10,4,12,iceland3
Sindri,8,3,2,3,13,12,1,11,iceland3
KFG,8,3,1,4,15,15,0,10,iceland3
Haukar,8,3,1,4,12,16,-4,10,iceland3
KV Reykjavik,8,0,1,7,6,24,-18,1,iceland3
Kerala Blasters,7,5,2,0,12,6,6,17,india
Odisha FC,6,5,1,0,15,5,10,16,india
Mumbai City,6,4,2,0,10,4,6,14,india
Goa,5,4,1,0,6,2,4,13,india
East Bengal,7,2,3,2,9,5,4,9,india
NorthEast Utd,7,2,3,2,10,9,1,9,india
Bengaluru,6,2,3,1,7,9,-2,9,india
Chennaiyin,5,2,1,2,9,8,1,7,india
ATK Mohun Bagan,5,2,1,2,7,8,-1,7,india
Jamshedpur,5,1,2,2,5,6,-1,5,india
Punjab,5,1,2,2,3,4,-1,5,india
Hyderabad,4,0,1,3,1,9,-8,1,india
Real Kashmir,8,5,2,1,14,4,10,17,india2
Shillong Lajong,8,5,2,1,15,9,6,17,india2
Mohammedan,6,4,2,0,14,5,9,14,india2
Delhi FC,6,3,1,2,12,11,1,10,india2
Gokulam,5,2,3,0,14,6,8,9,india2
Sreenidi Deccan,5,3,0,2,11,7,4,9,india2
Rajasthan,7,2,3,2,14,13,1,9,india2
Churchill B.,4,2,1,1,9,3,6,7,india2
Aizawl,4,1,2,1,6,7,-1,5,india2
Namdhari,6,1,1,4,4,9,-5,4,india2
Inter Kashi,2,1,0,1,2,2,0,3,india2
Neroca,5,1,0,4,7,15,-8,3,india2
TRAU,5,1,0,4,5,14,-9,3,india2
Borneo,8,7,1,0,14,3,11,22,indonesia
PSIS Semarang,8,6,1,1,15,7,8,19,indonesia
Barito Putera,8,5,3,0,11,3,8,18,indonesia
Bali Utd,8,5,1,2,15,8,7,16,indonesia
Persik Kediri,8,4,3,1,15,4,11,15,indonesia
Persib,8,4,3,1,16,7,9,15,indonesia
Persis Solo,8,4,3,1,14,9,5,15,indonesia
Persita,8,4,2,2,15,12,3,14,indonesia
Persebaya S.,8,4,2,2,12,9,3,14,indonesia
Arema,8,4,2,2,9,6,3,14,indonesia
PSM,8,4,1,3,13,9,4,13,indonesia
PSS Sleman,8,3,4,1,10,7,3,13,indonesia
Persija,8,2,5,1,12,8,4,11,indonesia
Madura Utd,8,3,1,4,12,10,2,10,indonesia
R. Nusantara,8,2,4,2,6,6,0,10,indonesia
Dewa Utd,8,2,4,2,12,15,-3,10,indonesia
TIRA Persikabo,8,1,4,3,12,16,-4,7,indonesia
Bhayangkara S.,8,1,3,4,9,12,-3,6,indonesia
Esteghlal,7,7,0,0,14,3,11,21,iran
Sepahan,8,6,0,2,18,8,10,18,iran
Persepolis,8,5,3,0,10,5,5,18,iran
Tractor Sazi,7,5,0,2,13,4,9,15,iran
Gol Gohar,7,3,3,1,13,7,6,12,iran
Malavan,8,3,3,2,9,5,4,12,iran
Aluminium Arak,7,2,4,1,6,7,-1,10,iran
Foolad,7,3,1,3,4,5,-1,10,iran
N. Mazandaran,8,2,3,3,9,9,0,9,iran
Shams A. Qazvin,7,2,3,2,8,8,0,9,iran
Mes Rafsanjan,8,2,2,4,8,12,-4,8,iran
Zob Ahan,7,1,4,2,3,5,-2,7,iran
E. Khuzestan,8,1,3,4,8,12,-4,6,iran
Havadar,8,1,2,5,3,10,-7,5,iran
Paykan,7,0,4,3,3,8,-5,4,iran
Sanat Naft,8,0,3,5,4,12,-8,3,iran
Al Shorta,6,5,0,1,11,3,8,15,iraq
Al Quwa Al J.,6,4,2,0,11,7,4,14,iraq
Al Zawraa,6,3,2,1,7,3,4,11,iraq
Duhok,6,3,2,1,6,3,3,11,iraq
Al Talaba,6,3,1,2,4,5,-1,10,iraq
Newroz SC,6,2,3,1,8,4,4,9,iraq
Al Najaf,7,2,3,2,3,3,0,9,iraq
Al Kahrabaa,6,1,5,0,9,8,1,8,iraq
Naft Maysan,6,1,4,1,7,5,2,7,iraq
Zakho,6,1,4,1,3,4,-1,7,iraq
Al-Qasim,6,1,4,1,7,9,-2,7,iraq
Al Hudod,6,2,1,3,7,11,-4,7,iraq
Erbil,6,2,1,3,4,8,-4,7,iraq
Al Minaa Basra,6,2,1,3,5,11,-6,7,iraq
Al Karkh,6,2,0,4,6,6,0,6,iraq
Al Naft,5,1,2,2,4,6,-2,5,iraq
Baghdad,6,1,1,4,6,9,-3,4,iraq
Naft Al-Janoob,6,1,1,4,5,8,-3,4,iraq
Naft Al-Wasat,6,0,3,3,1,5,-4,3,iraq
Karbala,6,0,3,3,6,12,-6,3,iraq
Shamrock Rovers,8,8,0,0,21,3,18,24,ireland
Derry City,8,5,3,0,17,2,15,18,ireland
Dundalk,8,5,2,1,16,6,10,17,ireland
Bohemians,8,5,2,1,19,10,9,17,ireland
Shelbourne,8,4,4,0,12,8,4,16,ireland
St. Patricks,8,4,2,2,14,6,8,14,ireland
Sligo Rovers,8,4,1,3,9,6,3,13,ireland
Drogheda Utd,8,2,4,2,11,9,2,10,ireland
Cork City,8,1,3,4,6,8,-2,6,ireland
UC Dublin,8,0,1,7,3,22,-19,1,ireland
Galway Utd,8,8,0,0,23,2,21,24,ireland2
Cobh Ramblers,8,4,4,0,16,8,8,16,ireland2
Wexford,8,4,2,2,13,12,1,14,ireland2
Waterford,8,3,3,2,16,9,7,12,ireland2
Treaty Utd,8,3,2,3,16,14,2,11,ireland2
Finn Harps,8,3,2,3,12,13,-1,11,ireland2
Longford Town,8,3,1,4,11,14,-3,10,ireland2
Athlone Town,8,2,2,4,9,10,-1,8,ireland2
Bray Wanderers,8,1,3,4,10,18,-8,6,ireland2
Kerry,8,0,3,5,8,17,-9,3,ireland2
Maccabi Haifa,8,6,2,0,17,4,13,20,israel
M. Tel Aviv,8,5,2,1,15,7,8,17,israel
H. Beer Sheva,8,5,1,2,17,5,12,16,israel
Maccabi Netanya,8,5,1,2,13,10,3,16,israel
Hapoel Haifa,8,4,1,3,11,10,1,13,israel
H. Petah Tikva,8,3,3,2,9,7,2,12,israel
M. Petah Tikva,8,4,0,4,14,14,0,12,israel
B. Jerusalem,8,3,3,2,13,13,0,12,israel
H. Jerusalem,8,3,2,3,8,7,1,11,israel
Hapoel Tel Aviv,8,2,3,3,10,15,-5,9,israel
M. Bnei Raina,8,1,4,3,8,9,-1,7,israel
Bnei Sakhnin,8,1,4,3,7,11,-4,7,israel
Ashdod,8,2,1,5,7,12,-5,7,israel
Hapoel Hadera,8,2,1,5,7,17,-10,7,israel
Kiryat Shmona,8,7,0,1,22,4,18,21,israel2
Bnei Yehuda,8,6,0,2,19,7,12,18,israel2
Ironi Tiberias,8,5,3,0,16,5,11,18,israel2
H. Nof Hagalil,8,5,1,2,15,7,8,16,israel2
Kafr Qasim,8,4,3,1,9,4,5,15,israel2
H. Ramat Gan,8,3,2,3,15,10,5,11,israel2
Maccabi Jaffa,8,2,5,1,14,11,3,11,israel2
Ramat Hasharon,8,3,2,3,14,17,-3,11,israel2
H. Umm al-Fahm,8,2,4,2,11,8,3,10,israel2
Hapoel Akko,8,2,4,2,13,13,0,10,israel2
M. Herziliya,8,2,4,2,8,9,-1,10,israel2
Nes Tziona,8,3,1,4,8,11,-3,10,israel2
H. Ironi Rishon,8,2,3,3,7,11,-4,9,israel2
Hapoel Afula,8,1,4,3,7,11,-4,7,israel2
Ihud B. Shfaram,8,2,1,5,9,17,-8,7,israel2
H. Kfar Saba,8,1,1,6,3,14,-11,4,israel2
Juventus,8,7,1,0,12,2,10,22,italy
Bologna,8,6,2,0,12,2,10,20,italy
AS Roma,8,6,2,0,14,5,9,20,italy
Inter Milan,8,6,1,1,19,6,13,19,italy
Lazio,8,6,1,1,11,5,6,19,italy
AC Milan,8,6,0,2,13,4,9,18,italy
Atalanta,8,5,1,2,17,7,10,16,italy
Fiorentina,8,5,1,2,12,6,6,16,italy
Torino,8,4,3,1,11,6,5,15,italy
Frosinone,8,4,2,2,14,11,3,14,italy
Cagliari,8,4,2,2,13,14,-1,14,italy
Genoa,8,3,4,1,9,5,4,13,italy
Napoli,8,3,2,3,11,12,-1,11,italy
Lecce,8,2,4,2,8,11,-3,10,italy
Monza,8,2,3,3,8,10,-2,9,italy
Udinese,8,1,5,2,15,14,1,8,italy
Sassuolo,8,2,2,4,10,12,-2,8,italy
Hellas Verona,8,2,2,4,9,12,-3,8,italy
Salernitana,8,1,3,4,9,16,-7,6,italy
Empoli,8,1,2,5,5,14,-9,5,italy
Parma,4,3,1,0,6,0,6,10,italy2
Brescia,4,2,2,0,7,5,2,8,italy2
Como,4,2,1,1,5,5,0,7,italy2
Sampdoria,4,2,0,2,8,9,-1,6,italy2
Ternana,4,2,0,2,8,9,-1,6,italy2
Cittadella,4,1,2,1,3,4,-1,5,italy2
Venezia,4,1,1,2,7,7,0,4,italy2
Pisa,4,1,1,2,6,7,-1,4,italy2
Sudtirol,4,1,1,2,6,7,-1,4,italy2
Cremonese,4,1,1,2,3,4,-1,4,italy2
Reggiana,4,1,1,2,6,8,-2,4,italy2
Palermo,4,0,3,1,7,9,-2,3,italy2
FeralpiSalo,4,1,0,3,5,7,-2,3,italy2
Catanzaro,4,1,0,3,2,6,-4,3,italy2
Spezia,4,1,0,3,4,11,-7,3,italy2
Bari,4,0,2,2,4,6,-2,2,italy2
Ascoli,4,0,2,2,3,6,-3,2,italy2
Lecco,4,0,2,2,5,9,-4,2,italy2
Cosenza,4,0,1,3,0,5,-5,1,italy2
Modena,4,0,1,3,4,11,-7,1,italy2
Portmore Utd,7,5,2,0,12,2,10,17,jamaica
Cavalier,7,5,2,0,10,3,7,17,jamaica
Tivoli Gardens,8,5,0,3,16,9,7,15,jamaica
Arnett Gardens,6,4,1,1,8,3,5,13,jamaica
Mount Pleasant,6,4,1,1,7,2,5,13,jamaica
Dunbeholden,7,4,1,2,9,8,1,13,jamaica
Waterhouse,7,3,2,2,13,6,7,11,jamaica
Montego Bay,7,3,1,3,12,11,1,10,jamaica
Harbour View,8,2,3,3,12,13,-1,9,jamaica
Humble Lions,6,2,1,3,7,11,-4,7,jamaica
Molynes Utd,8,1,3,4,6,15,-9,6,jamaica
Vere Utd,7,1,2,4,6,11,-5,5,jamaica
Treasure Beach,7,1,1,5,2,9,-7,4,jamaica
Lime Hall Acade,7,0,3,4,5,14,-9,3,jamaica
S. Hiroshima,8,5,3,0,15,6,9,18,japan
Vissel Kobe,8,5,3,0,14,8,6,18,japan
Kashima Antlers,8,5,2,1,12,5,7,17,japan
Kyoto Sanga,8,5,0,3,11,5,6,15,japan
Yokohama M.,8,4,2,2,11,7,4,14,japan
Nagoya G.,8,3,5,0,10,6,4,14,japan
Albirex Niigata,8,3,4,1,10,6,4,13,japan
Cerezo Osaka,8,4,0,4,9,6,3,12,japan
K. Frontale,8,3,2,3,18,15,3,11,japan
Yokohama FC,8,3,2,3,8,5,3,11,japan
Urawa RD,8,2,4,2,7,6,1,10,japan
FC Tokyo,8,3,1,4,14,14,0,10,japan
Gamba Osaka,8,3,1,4,9,10,-1,10,japan
Avispa Fukuoka,8,3,1,4,5,10,-5,10,japan
Kashiwa Reysol,8,1,6,1,8,8,0,9,japan
C. Sapporo,8,2,2,4,8,8,0,8,japan
Shonan Bellmare,8,2,2,4,6,9,-3,8,japan
Sagan Tosu,8,2,1,5,8,13,-5,7,japan
JEF Utd Chiba,8,6,1,1,16,8,8,19,japan2
M. Yamagata,8,6,1,1,12,4,8,19,japan2
Jubilo Iwata,8,5,2,1,20,8,12,17,japan2
Shimizu S-Pulse,8,5,2,1,13,5,8,17,japan2
Tokyo Verdy,8,4,2,2,11,8,3,14,japan2
Machida Zelvia,8,4,1,3,16,12,4,13,japan2
Fujieda MYFC,8,3,2,3,14,11,3,11,japan2
Kusatsu,8,2,5,1,5,4,1,11,japan2
R. Yamaguchi,8,3,2,3,13,14,-1,11,japan2
V-V. Nagasaki,8,3,2,3,13,15,-2,11,japan2
Ventforet Kofu,8,3,2,3,9,11,-2,11,japan2
Fagiano Okayama,8,3,2,3,8,14,-6,11,japan2
Mito Hollyhock,8,2,4,2,12,9,3,10,japan2
Oita Trinita,8,3,1,4,11,12,-1,10,japan2
Tochigi SC,8,2,3,3,12,10,2,9,japan2
Vegalta Sendai,8,2,3,3,5,8,-3,9,japan2
Tokushima V.,8,2,2,4,8,10,-2,8,japan2
Omiya Ardija,8,2,2,4,4,13,-9,8,japan2
R. Kumamoto,8,2,1,5,10,15,-5,7,japan2
Iwaki,8,1,3,4,7,16,-9,6,japan2
Blaublitz Akita,8,0,5,3,5,8,-3,5,japan2
Z. Kanazawa,8,0,3,5,4,14,-10,3,japan2
Al Hussein,5,5,0,0,12,0,12,15,jordan
Al Wihdat,5,4,1,0,9,4,5,13,jordan
Al Faysali,5,3,2,0,12,4,8,11,jordan
Al Ramtha,5,3,0,2,6,2,4,9,jordan
Maan,6,2,3,1,9,6,3,9,jordan
Aqaba,6,2,2,2,10,13,-3,8,jordan
Shabab Al Ordon,5,2,1,2,6,4,2,7,jordan
Al Ahli,5,1,2,2,5,6,-1,5,jordan
Sahab,5,1,1,3,3,12,-9,4,jordan
Al Jalil,5,0,3,2,2,4,-2,3,jordan
Moghayer Al S.,5,1,0,4,3,7,-4,3,jordan
Al Salt,5,1,0,4,2,7,-5,3,jordan
Ordabasy,8,7,0,1,13,5,8,21,kazakhstan
FC Astana,8,6,2,0,17,8,9,20,kazakhstan
Aktobe,8,5,3,0,15,7,8,18,kazakhstan
Kairat Almaty,8,5,2,1,14,8,6,17,kazakhstan
Maqtaaral,8,4,2,2,15,10,5,14,kazakhstan
Tobol,8,4,2,2,7,5,2,14,kazakhstan
Atyrau,8,3,4,1,7,2,5,13,kazakhstan
Aksu,8,4,1,3,11,9,2,13,kazakhstan
S. Karagandy,8,3,3,2,10,8,2,12,kazakhstan
Kyzylzhar,8,3,3,2,7,6,1,12,kazakhstan
Kaspiy Aktau,8,2,2,4,10,12,-2,8,kazakhstan
Kaisar K.,8,2,2,4,7,9,-2,8,kazakhstan
Okzhetpes,8,1,4,3,7,12,-5,7,kazakhstan
Zhetysu,8,1,2,5,8,15,-7,5,kazakhstan
Ballkani,8,7,1,0,17,7,10,22,kosovo
Drita,8,5,2,1,15,7,8,17,kosovo
Prishtina,8,4,4,0,13,8,5,16,kosovo
Llapi,8,4,2,2,11,7,4,14,kosovo
Dukagjini,8,3,5,0,5,2,3,14,kosovo
Gjilani,8,4,2,2,6,5,1,14,kosovo
Malisheva,8,4,0,4,13,13,0,12,kosovo
Feronikeli,8,3,2,3,6,9,-3,11,kosovo
Fushe Kosova,8,2,3,3,7,9,-2,9,kosovo
Liria,8,1,3,4,9,17,-8,6,kosovo
Al Kuwait,7,6,1,0,24,4,20,19,kuwait
Al Arabi SC,7,6,1,0,19,5,14,19,kuwait
Al Qadsia,7,3,4,0,9,6,3,13,kuwait
Al Salmiyah,7,3,2,2,11,10,1,11,kuwait
Al Fahaheel,7,3,1,3,12,12,0,10,kuwait
Al Nasar,6,2,3,1,12,7,5,9,kuwait
Al Shabab,8,2,1,5,6,14,-8,7,kuwait
Kazma,6,1,1,4,5,12,-7,4,kuwait
Khaitan,8,1,1,6,4,17,-13,4,kuwait
Al Jahra,7,0,1,6,6,15,-9,1,kuwait
RFS,8,7,1,0,27,2,25,22,latvia
Riga FC,8,6,1,1,19,7,12,19,latvia
Auda,8,5,1,2,12,8,4,16,latvia
Liepaja,8,4,3,1,12,10,2,15,latvia
Valmiera,8,3,3,2,14,8,6,12,latvia
Daugavpils,8,3,2,3,9,9,0,11,latvia
Tukums,8,3,2,3,14,17,-3,11,latvia
FS Jelgava,8,2,2,4,8,11,-3,8,latvia
Metta / LU,8,1,3,4,8,10,-2,6,latvia
Super Nova,8,0,1,7,5,23,-18,1,latvia
Panevezys,8,6,2,0,15,3,12,20,lithuania
Kauno Zalgiris,8,5,3,0,19,9,10,18,lithuania
Hegelmann L.,8,5,3,0,11,3,8,18,lithuania
Zalgiris,8,5,1,2,17,7,10,16,lithuania
FA Siauliai,8,2,4,2,9,8,1,10,lithuania
Suduva,8,3,1,4,7,12,-5,10,lithuania
Banga,8,2,2,4,6,12,-6,8,lithuania
Dziugas Telsiai,8,1,3,4,9,15,-6,6,lithuania
Dainava,8,1,1,6,6,12,-6,4,lithuania
Riteriai,8,0,1,7,6,18,-12,1,lithuania
TransINVEST,8,7,0,1,29,6,23,21,lithuania2
Minija,8,7,0,1,18,8,10,21,lithuania2
Be1 NFA,8,6,1,1,16,10,6,19,lithuania2
Neptuna K.,8,5,2,1,22,6,16,17,lithuania2
Nevezis,8,5,2,1,21,9,12,17,lithuania2
Babrungas,8,5,1,2,23,12,11,16,lithuania2
Kauno Z. B,8,4,3,1,16,6,10,15,lithuania2
FA Siauliai B,8,4,3,1,20,14,6,15,lithuania2
Panevezys B,8,3,2,3,12,7,5,11,lithuania2
Riteriai B,8,3,2,3,11,8,3,11,lithuania2
Garliava,8,3,2,3,11,9,2,11,lithuania2
BFA Vilnius,8,3,2,3,11,11,0,11,lithuania2
Ekranas,8,3,1,4,12,15,-3,10,lithuania2
Zalgiris B,8,2,3,3,17,18,-1,9,lithuania2
Jonava,8,1,1,6,6,24,-18,4,lithuania2
Marijampole C.,8,0,1,7,1,22,-21,1,lithuania2
Niedercorn,8,6,2,0,17,7,10,20,luxembourg
Differdange,7,6,1,0,21,4,17,19,luxembourg
Dudelange,7,6,1,0,16,4,12,19,luxembourg
Petange,8,5,2,1,20,8,12,17,luxembourg
Mondorf,7,5,0,2,17,10,7,15,luxembourg
Hesperang,7,4,3,0,11,6,5,15,luxembourg
UNA Strassen,8,3,4,1,13,13,0,13,luxembourg
Racing,8,4,1,3,11,12,-1,13,luxembourg
Schifflange,7,3,3,1,12,10,2,12,luxembourg
Wiltz,8,3,3,2,11,10,1,12,luxembourg
Marisca Mersch,7,2,4,1,13,10,3,10,luxembourg
UN Käerjéng,7,3,1,3,7,6,1,10,luxembourg
V. Rosport,7,3,0,4,9,12,-3,9,luxembourg
Fola Esch,8,2,2,4,11,13,-2,8,luxembourg
Mondercange,8,2,2,4,9,20,-11,8,luxembourg
Jeunesse Esch,7,1,3,3,11,12,-1,6,luxembourg
Johor Darul,8,8,0,0,31,1,30,24,malaysia
Selangor,8,8,0,0,23,5,18,24,malaysia
Kedah,8,6,1,1,21,6,15,19,malaysia
Sabah,8,6,1,1,22,14,8,19,malaysia
PDRM,8,5,2,1,15,5,10,17,malaysia
Kuala Lumpur,8,3,4,1,16,7,9,13,malaysia
Pahang,8,4,1,3,14,14,0,13,malaysia
Pulau Pinang,8,3,2,3,13,14,-1,11,malaysia
Terengganu,8,3,1,4,8,14,-6,10,malaysia
Negeri Sembilan,8,2,2,4,10,16,-6,8,malaysia
Perak,8,2,1,5,13,16,-3,7,malaysia
Kelantan United,8,2,1,5,7,21,-14,7,malaysia
Kuching,8,0,3,5,6,15,-9,3,malaysia
Kelantan,8,1,0,7,7,48,-41,3,malaysia
Floriana,6,5,1,0,12,3,9,16,malta
Hamrun Spartans,6,4,2,0,9,3,6,14,malta
Sliema W.,6,4,0,2,5,3,2,12,malta
Naxxar Lions,7,3,2,2,9,9,0,11,malta
Marsaxlokk,6,3,1,2,12,5,7,10,malta
Birkirkara,6,3,1,2,8,7,1,10,malta
Balzan,6,2,1,3,5,8,-3,7,malta
Hibernians,7,2,1,4,5,8,-3,7,malta
Valletta,6,1,2,3,6,8,-2,5,malta
Gzira Utd,6,1,2,3,6,12,-6,5,malta
Santa Lucia,6,1,1,4,2,9,-7,4,malta
Gudja Utd,7,0,4,3,7,16,-9,4,malta
Mosta,6,1,1,4,3,13,-10,4,malta
Sirens,7,0,3,4,4,11,-7,3,malta
CF America,8,6,2,0,21,7,14,20,mexico
Tijuana,8,6,1,1,18,8,10,19,mexico
Tigres,8,5,3,0,18,7,11,18,mexico
Monterrey,8,6,0,2,17,8,9,18,mexico
Club Leon,8,5,3,0,13,5,8,18,mexico
Pumas UNAM,8,5,2,1,14,5,9,17,mexico
Santos Laguna,8,5,1,2,16,12,4,16,mexico
A. San Luis,8,5,0,3,17,8,9,15,mexico
Toluca,8,4,2,2,16,9,7,14,mexico
Mazatlan,8,4,1,3,13,11,2,13,mexico
Guadalajara,8,4,1,3,10,10,0,13,mexico
Juarez,8,3,2,3,13,12,1,11,mexico
Puebla,8,3,1,4,13,14,-1,10,mexico
Pachuca,8,2,4,2,8,10,-2,10,mexico
Atlas,7,2,2,3,7,8,-1,8,mexico
Necaxa,8,2,2,4,9,11,-2,8,mexico
Queretaro,8,1,4,3,7,9,-2,7,mexico
Cruz Azul,8,2,1,5,10,16,-6,7,mexico
Monterrey,8,7,0,1,21,6,15,21,mexico2
Toluca,8,5,3,0,18,7,11,18,mexico2
Guadalajara,8,5,1,2,15,10,5,16,mexico2
CF America,8,4,3,1,17,11,6,15,mexico2
A. San Luis,8,4,3,1,10,5,5,15,mexico2
Cruz Azul,8,5,0,3,10,9,1,15,mexico2
Club Leon,8,4,2,2,12,5,7,14,mexico2
Pachuca,8,4,1,3,16,11,5,13,mexico2
Pumas UNAM,8,4,1,3,17,14,3,13,mexico2
Puebla,8,4,0,4,14,14,0,12,mexico2
Tijuana,8,2,5,1,9,7,2,11,mexico2
Necaxa,8,2,4,2,8,8,0,10,mexico2
Queretaro,8,2,4,2,7,9,-2,10,mexico2
Santos Laguna,8,3,1,4,12,20,-8,10,mexico2
Juarez,8,2,3,3,9,8,1,9,mexico2
Tigres,8,2,2,4,7,9,-2,8,mexico2
Atlas,8,1,4,3,11,12,-1,7,mexico2
Mazatlan,8,1,0,7,10,16,-6,3,mexico2
Deren,4,3,1,0,13,6,7,10,mongolia
SP Falcons,4,3,1,0,8,1,7,10,mongolia
Tuv Buganuud,5,3,0,2,16,13,3,9,mongolia
FC Ulaanbaatar,4,2,0,2,7,4,3,6,mongolia
Khangarid,4,1,2,1,10,8,2,5,mongolia
Erchim,4,1,2,1,4,4,0,5,mongolia
Khoromkhon,4,1,0,3,6,10,-4,3,mongolia
Bayanzurkh S.,5,1,0,4,7,20,-13,3,mongolia
Khovd,5,0,1,4,2,9,-7,1,mongolia
Bavarians,5,0,1,4,10,19,-9,1,mongolia
Buducnost,8,6,2,0,17,9,8,20,montenegro
Mornar,8,4,2,2,10,8,2,14,montenegro
Decic,8,4,1,3,12,9,3,13,montenegro
Jezero,8,3,3,2,10,6,4,12,montenegro
Sutjeska,8,3,3,2,12,10,2,12,montenegro
Petrovac,8,1,6,1,9,8,1,9,montenegro
Rudar,8,2,3,3,6,6,0,9,montenegro
Jedinstvo,8,2,3,3,10,13,-3,9,montenegro
Arsenal Tivat,8,1,5,2,10,11,-1,8,montenegro
Mladost DG,8,2,1,5,7,12,-5,7,montenegro
FAR Rabat,8,7,1,0,18,4,14,22,morocco
Raja Casablanca,8,7,1,0,17,4,13,22,morocco
Berkane,8,5,3,0,14,4,10,18,morocco
Olympic Safi,8,3,5,0,10,6,4,14,morocco
R. Zemamra,8,4,2,2,10,8,2,14,morocco
Wydad,7,4,1,2,9,7,2,13,morocco
Salmi,8,3,3,2,10,9,1,12,morocco
Moghreb Tetouan,7,2,5,0,8,3,5,11,morocco
Maghreb de Fes,7,3,2,2,9,7,2,11,morocco
Union Touarga,8,3,2,3,9,10,-1,11,morocco
Hassania Agadir,7,2,4,1,9,9,0,10,morocco
C. Mohammedia,7,3,1,3,8,8,0,10,morocco
FUS Rabat,7,2,4,1,6,6,0,10,morocco
Mouloudia Oujda,7,3,1,3,9,13,-4,10,morocco
Youssoufia B.,7,2,2,3,5,7,-2,8,morocco
Ittihad Tanger,8,1,5,2,7,11,-4,8,morocco
USM Oujda,8,6,2,0,12,1,11,20,morocco2
Kawkab M.,8,5,3,0,13,5,8,18,morocco2
Stade Marocain,7,5,2,0,14,4,10,17,morocco2
R. Beni Mellal,8,4,3,1,13,6,7,15,morocco2
Meknes,7,5,0,2,7,5,2,15,morocco2
Difaa El Jadida,7,4,2,1,9,7,2,14,morocco2
C. Benguerir,8,2,5,1,7,5,2,11,morocco2
Khouribga,7,3,2,2,4,3,1,11,morocco2
Wydad Fès,8,3,2,3,7,8,-1,11,morocco2
Chabab Atlas K.,7,2,3,2,4,4,0,9,morocco2
Rapide Oued Z.,8,1,5,2,6,7,-1,8,morocco2
Dcheira,8,1,5,2,3,4,-1,8,morocco2
AS Salé,8,2,2,4,11,14,-3,8,morocco2
RAC Casablanca,7,1,4,2,8,7,1,7,morocco2
Ittifaq M.,7,1,4,2,3,4,-1,7,morocco2
El Massira,7,2,1,4,7,10,-3,7,morocco2
Shan Utd,8,7,1,0,24,8,16,22,myanmar
Yangon Utd,8,6,2,0,25,3,22,20,myanmar
Myawady,8,5,1,2,19,12,7,16,myanmar
Hantharwady,8,5,0,3,14,9,5,15,myanmar
Ayeyawady,8,4,2,2,18,13,5,14,myanmar
Sagaing Utd,8,4,2,2,11,8,3,14,myanmar
Dagon,8,4,0,4,12,14,-2,12,myanmar
Ispe FC,8,2,2,4,13,14,-1,8,myanmar
Yadanarbon,8,1,4,3,7,11,-4,7,myanmar
Rakhine Utd,8,1,3,4,10,15,-5,6,myanmar
Kachin Utd,8,1,2,5,7,12,-5,5,myanmar
Chinland,8,1,2,5,9,22,-13,5,myanmar
PSV Eindhoven,8,8,0,0,27,5,22,24,netherlands
Feyenoord,8,6,1,1,26,8,18,19,netherlands
FC Twente,8,6,1,1,16,11,5,19,netherlands
Ajax Amsterdam,8,5,1,2,20,11,9,16,netherlands
AZ Alkmaar,8,4,2,2,18,10,8,14,netherlands
Fortuna Sittard,8,4,2,2,11,8,3,14,netherlands
Go Ahead Eagles,8,4,1,3,18,11,7,13,netherlands
Heerenveen,8,4,1,3,15,10,5,13,netherlands
NEC Nijmegen,8,3,3,2,15,11,4,12,netherlands
Excelsior,8,2,4,2,13,13,0,10,netherlands
Sparta,8,2,3,3,10,13,-3,9,netherlands
PEC Zwolle,8,2,2,4,8,13,-5,8,netherlands
Almere City,8,2,2,4,10,17,-7,8,netherlands
Heracles Almelo,8,2,2,4,9,19,-10,8,netherlands
RKC Waalwijk,8,2,1,5,9,15,-6,7,netherlands
FC Utrecht,8,1,4,3,10,17,-7,7,netherlands
FC Volendam,8,2,1,5,8,17,-9,7,netherlands
Vitesse Arnhem,8,1,3,4,5,11,-6,6,netherlands
Willem II,8,7,1,0,22,7,15,22,netherlands2
FC Dordrecht,8,6,1,1,23,10,13,19,netherlands2
Roda JC,8,6,1,1,15,5,10,19,netherlands2
Jong Ajax,8,5,3,0,15,6,9,18,netherlands2
FC Groningen,8,5,2,1,14,8,6,17,netherlands2
ADO Den Haag,8,4,3,1,21,11,10,15,netherlands2
FC Emmen,8,5,0,3,12,8,4,15,netherlands2
NAC Breda,8,4,2,2,13,10,3,14,netherlands2
De Graafschap,8,4,2,2,10,8,2,14,netherlands2
Jong AZ,8,4,1,3,14,12,2,13,netherlands2
MVV Maastricht,8,3,3,2,13,8,5,12,netherlands2
Helmond Sport,8,3,3,2,16,12,4,12,netherlands2
Cambuur,8,3,2,3,17,15,2,11,netherlands2
Jong Utrecht,8,2,5,1,9,9,0,11,netherlands2
VVV,8,3,2,3,13,15,-2,11,netherlands2
Telstar,8,3,1,4,10,15,-5,10,netherlands2
TOP Oss,8,3,0,5,6,17,-11,9,netherlands2
FC Eindhoven,8,1,4,3,8,11,-3,7,netherlands2
FC Den Bosch,8,1,3,4,9,16,-7,6,netherlands2
Jong PSV,8,0,3,5,11,20,-9,3,netherlands2
Real Esteli,8,7,0,1,16,3,13,21,nicaragua
Diriangen,8,6,1,1,11,5,6,19,nicaragua
O. Masachapa,8,5,1,2,13,11,2,16,nicaragua
Managua FC,8,4,2,2,22,15,7,14,nicaragua
UNAN Managua,8,4,2,2,16,9,7,14,nicaragua
Export Sebaco,8,4,2,2,15,12,3,14,nicaragua
Jalapa,8,3,4,1,9,6,3,13,nicaragua
Matagalpa,8,3,2,3,12,9,3,11,nicaragua
D. Ocotal,8,3,2,3,11,10,1,11,nicaragua
Walter Ferreti,8,2,4,2,9,9,0,10,nicaragua
Linfield,8,7,0,1,21,7,14,21,northernireland
Larne,8,6,2,0,15,5,10,20,northernireland
Cliftonville,8,6,1,1,18,4,14,19,northernireland
Glentoran,8,6,0,2,28,6,22,18,northernireland
Loughgall,8,3,0,5,17,18,-1,9,northernireland
Coleraine,8,2,2,4,12,14,-2,8,northernireland
Ballymena Utd,8,2,2,4,9,12,-3,8,northernireland
Crusaders,8,2,2,4,5,10,-5,8,northernireland
Dungannon,8,2,1,5,14,16,-2,7,northernireland
Glenavon,8,2,1,5,5,12,-7,7,northernireland
Carrick Rangers,8,1,1,6,7,16,-9,4,northernireland
Newry City,8,0,1,7,2,17,-15,1,northernireland
Portadown,8,7,0,1,27,12,15,21,northernireland2
Institute,8,6,1,1,14,5,9,19,northernireland2
Dundela,8,6,0,2,21,11,10,18,northernireland2
Bangor,8,5,2,1,18,9,9,17,northernireland2
H&W Welders,8,5,1,2,17,11,6,16,northernireland2
Annagh Utd,8,4,3,1,11,6,5,15,northernireland2
Ballinamallard,8,4,2,2,13,5,8,14,northernireland2
Dergview,8,4,1,3,13,11,2,13,northernireland2
Ballyclare,8,4,0,4,15,12,3,12,northernireland2
Newington Youth,8,4,0,4,14,13,1,12,northernireland2
Ards,8,1,3,4,14,14,0,6,northernireland2
Knockbreda,8,1,0,7,9,22,-13,3,northernireland2
Shkupi,8,8,0,0,14,1,13,24,northmacedonia
Struga,8,7,0,1,16,5,11,21,northmacedonia
Skendija,8,5,3,0,10,3,7,18,northmacedonia
Sileks,8,5,3,0,15,9,6,18,northmacedonia
Rabotnicki,8,5,1,2,7,3,4,16,northmacedonia
Gostivar,8,4,3,1,10,6,4,15,northmacedonia
Voska Sport,8,4,1,3,13,13,0,13,northmacedonia
A. Pandev,8,3,3,2,8,5,3,12,northmacedonia
Tikves,8,3,3,2,11,10,1,12,northmacedonia
Bregalnica Stip,8,3,3,2,12,12,0,12,northmacedonia
Makedonija,8,3,2,3,6,6,0,11,northmacedonia
Vardar,8,3,1,4,9,12,-3,10,northmacedonia
Bodo / Glimt,8,7,0,1,18,9,9,21,norway
Brann,8,7,0,1,18,9,9,21,norway
Tromso,8,6,0,2,15,8,7,18,norway
Sarpsborg 08,8,5,1,2,21,13,8,16,norway
Lillestrom,8,5,1,2,19,11,8,16,norway
Viking,8,5,1,2,18,17,1,16,norway
Molde,8,4,2,2,20,10,10,14,norway
Odd,8,4,2,2,16,10,6,14,norway
Rosenborg,8,4,2,2,16,11,5,14,norway
Stromsgodset,8,4,1,3,12,9,3,13,norway
Sandefjord,8,3,3,2,10,8,2,12,norway
HamKam,8,3,2,3,14,14,0,11,norway
Haugesund,8,3,0,5,13,12,1,9,norway
Stabaek,8,3,0,5,8,11,-3,9,norway
Aalesund,8,2,2,4,6,16,-10,8,norway
Valerenga,8,1,4,3,11,13,-2,7,norway
Bryne,8,7,1,0,17,5,12,22,norway2
Asane,8,7,0,1,16,9,7,21,norway2
Fredrikstad,8,6,1,1,15,6,9,19,norway2
KFUM Oslo,8,6,1,1,13,5,8,19,norway2
Start,8,5,3,0,13,4,9,18,norway2
Mjondalen,8,4,1,3,15,10,5,13,norway2
Moss,8,4,1,3,14,9,5,13,norway2
Sandnes Ulf,8,4,1,3,14,12,2,13,norway2
Hodd,8,3,3,2,11,9,2,12,norway2
Kristiansund,8,3,2,3,13,8,5,11,norway2
Raufoss,8,2,3,3,9,8,1,9,norway2
Sogndal,8,2,3,3,12,15,-3,9,norway2
Kongsvinger,8,2,2,4,13,13,0,8,norway2
Ranheim,8,2,2,4,11,15,-4,8,norway2
Jerv,8,1,2,5,7,15,-8,5,norway2
Skeid,8,1,0,7,7,16,-9,3,norway2
Oman Club,6,5,0,1,7,2,5,15,oman
Al-Nahda,4,3,1,0,8,3,5,10,oman
Al Seeb,4,3,1,0,7,2,5,10,oman
Dhofar,6,3,0,3,7,6,1,9,oman
Sohar,5,2,2,1,8,5,3,8,oman
Sur,6,1,3,2,10,12,-2,6,oman
Ibri,5,2,0,3,3,6,-3,6,oman
Al Nasr,4,1,2,1,5,4,1,5,oman
Al-Rustaq,5,0,3,2,3,6,-3,3,oman
Bahla,5,0,2,3,2,8,-6,2,oman
Al-Shabab Club,4,0,1,3,2,5,-3,1,oman
Al Wehda,5,0,0,5,3,15,-12,0,oman
Herrera,8,5,2,1,16,7,9,17,panama
Independiente,8,5,1,2,18,7,11,16,panama
San Miguelito,8,4,3,1,13,8,5,15,panama
UMECIT,8,4,2,2,12,7,5,14,panama
Costa del Este,8,4,1,3,13,8,5,13,panama
Universitario,8,3,3,2,9,7,2,12,panama
A. Chiriqui,8,3,3,2,8,11,-3,12,panama
San Francisco,8,2,5,1,8,8,0,11,panama
Alianza,8,3,2,3,6,7,-1,11,panama
Tauro,8,3,1,4,8,6,2,10,panama
Arabe Unido,8,2,4,2,6,5,1,10,panama
Plaza Amador,8,2,2,4,6,8,-2,8,panama
Independiente,8,7,1,0,21,5,16,22,panama2
San Miguelito,8,6,1,1,16,2,14,19,panama2
Tauro,8,5,2,1,14,9,5,17,panama2
Herrera,8,4,4,0,18,4,14,16,panama2
Plaza Amador,8,4,3,1,15,5,10,15,panama2
Alianza,8,3,3,2,8,6,2,12,panama2
Universitario,8,3,3,2,7,5,2,12,panama2
San Francisco,8,3,3,2,9,9,0,12,panama2
Arabe Unido,8,3,2,3,7,10,-3,11,panama2
Costa del Este,8,1,2,5,10,18,-8,5,panama2
UMECIT,8,1,1,6,8,12,-4,4,panama2
A. Chiriqui,8,0,1,7,8,29,-21,1,panama2
S. Luqueno,1,1,0,0,2,0,2,3,paraguay
G. Caballero,1,1,0,0,2,1,1,3,paraguay
S. Ameliano,1,1,0,0,1,0,1,3,paraguay
Olimpia,1,0,1,0,1,1,0,1,paraguay
2 de Mayo,0,0,0,0,0,0,0,0,paraguay
Cerro Porteno,0,0,0,0,0,0,0,0,paraguay
Guarani,0,0,0,0,0,0,0,0,paraguay
Libertad,0,0,0,0,0,0,0,0,paraguay
Nacional,0,0,0,0,0,0,0,0,paraguay
S. Trinidense,0,0,0,0,0,0,0,0,paraguay
Sol de America,0,0,0,0,0,0,0,0,paraguay
Tacuary,0,0,0,0,0,0,0,0,paraguay
Nacional,8,5,1,2,18,8,10,16,paraguay2
Cerro Porteno,8,4,4,0,17,7,10,16,paraguay2
Guarani,8,5,1,2,10,6,4,16,paraguay2
Libertad,8,4,2,2,15,5,10,14,paraguay2
S. Luqueno,8,4,2,2,10,7,3,14,paraguay2
Olimpia,8,3,4,1,13,8,5,13,paraguay2
Guairena,8,3,2,3,12,14,-2,11,paraguay2
S. Ameliano,8,3,1,4,9,10,-1,10,paraguay2
Tacuary,8,2,3,3,7,12,-5,9,paraguay2
S. Trinidense,8,1,4,3,13,15,-2,7,paraguay2
G. Caballero,8,1,4,3,4,7,-3,7,paraguay2
Resistencia,8,2,1,5,5,13,-8,7,paraguay2
Alianza Lima,8,8,0,0,23,4,19,24,peru
Cusco,8,8,0,0,16,5,11,24,peru
Universitario,8,7,0,1,17,4,13,21,peru
Cesar Vallejo,8,6,1,1,16,5,11,19,peru
S. Cristal,8,5,3,0,14,7,7,18,peru
FBC Melgar,8,5,2,1,17,9,8,17,peru
Binacional,8,5,1,2,20,9,11,16,peru
Sport Huancayo,8,5,1,2,16,8,8,16,peru
Atletico Grau,8,4,3,1,17,5,12,15,peru
Cienciano,8,4,3,1,12,6,6,15,peru
Alianza A.,8,4,3,1,16,11,5,15,peru
ADT,8,4,2,2,12,8,4,14,peru
Carlos Manucci,8,4,2,2,8,4,4,14,peru
D. Municipal,8,4,1,3,11,9,2,13,peru
Cajamarca,8,3,4,1,5,3,2,13,peru
Union Comercio,8,3,3,2,15,18,-3,12,peru
D. Garcilaso,8,2,5,1,15,13,2,11,peru
Sport Boys,8,3,1,4,8,12,-4,10,peru
AD Cantolao,8,2,2,4,6,9,-3,8,peru
Universitario,8,7,1,0,16,1,15,22,peru2
S. Cristal,8,6,2,0,18,3,15,20,peru2
Sport Huancayo,8,6,2,0,15,4,11,20,peru2
ADT,8,5,3,0,10,2,8,18,peru2
Binacional,8,5,1,2,16,7,9,16,peru2
Alianza Lima,8,4,4,0,6,1,5,16,peru2
Cienciano,8,4,3,1,9,5,4,15,peru2
FBC Melgar,8,4,2,2,15,8,7,14,peru2
Cajamarca,8,3,5,0,14,7,7,14,peru2
Cusco,8,3,5,0,11,4,7,14,peru2
Carlos Manucci,8,4,2,2,12,7,5,14,peru2
Alianza A.,8,4,2,2,11,7,4,14,peru2
D. Garcilaso,8,4,1,3,12,9,3,13,peru2
Sport Boys,8,3,3,2,8,9,-1,12,peru2
Cesar Vallejo,8,3,2,3,13,8,5,11,peru2
Union Comercio,8,3,2,3,10,11,-1,11,peru2
Atletico Grau,8,2,4,2,12,11,1,10,peru2
AD Cantolao,8,2,1,5,5,13,-8,7,peru2
D. Municipal,8,2,0,6,8,15,-7,6,peru2
Santa Rosa,8,7,1,0,38,5,33,22,peru3
Santos FC,8,7,1,0,17,2,15,22,peru3
Comerciantes U.,8,7,1,0,16,1,15,22,peru3
A. Huanuco,8,7,1,0,17,5,12,22,peru3
Comerciantes,8,5,3,0,11,3,8,18,peru3
D. Coopsol,8,5,2,1,14,5,9,17,peru3
Llacuabamba,8,4,3,1,14,9,5,15,peru3
U. San Martin,8,5,0,3,13,9,4,15,peru3
Ayacucho,8,4,2,2,15,8,7,14,peru3
Alfonso Ugarte,8,2,3,3,12,13,-1,9,peru3
Juan Aurich,8,1,6,1,4,5,-1,9,peru3
M. El Pirata,8,2,2,4,12,16,-4,8,peru3
Huaral,8,1,3,4,9,13,-4,6,peru3
Carlos Stein,8,1,2,5,9,19,-10,5,peru3
Jagiellonia,8,7,1,0,22,6,16,22,poland
Rakow C.,8,6,2,0,16,2,14,20,poland
Slask Wroclaw,8,5,3,0,14,5,9,18,poland
Gornik Zabrze,8,5,2,1,9,4,5,17,poland
Lech Poznan,8,5,1,2,19,11,8,16,poland
Stal Mielec,8,4,2,2,15,10,5,14,poland
Legia Warsaw,8,4,2,2,12,9,3,14,poland
Piast Gliwice,8,3,4,1,10,6,4,13,poland
Puszcza Niepolo,8,3,3,2,12,13,-1,12,poland
Widzew Lodz,8,4,0,4,7,9,-2,12,poland
Pogon Szczecin,8,3,2,3,19,15,4,11,poland
Zaglebie Lubin,8,3,2,3,8,10,-2,11,poland
Korona Kielce,8,2,4,2,12,10,2,10,poland
Radomiak Radom,8,1,5,2,9,8,1,8,poland
Cracovia Krakow,8,1,4,3,12,17,-5,7,poland
Warta Poznan,8,1,3,4,6,10,-4,6,poland
Ruch Chorzow,8,0,5,3,9,15,-6,5,poland
LKS Lodz,8,0,4,4,7,18,-11,4,poland
Lechia Gdansk,8,6,2,0,15,3,12,20,poland2
Tychy,8,6,1,1,14,6,8,19,poland2
Arka Gdynia,8,6,1,1,12,4,8,19,poland2
Wisla Krakow,8,5,3,0,20,7,13,18,poland2
Wisla Plock,8,6,0,2,15,7,8,18,poland2
Odra Opole,8,4,3,1,8,5,3,15,poland2
Katowice,8,4,2,2,12,6,6,14,poland2
Gornik Leczna,8,3,5,0,11,6,5,14,poland2
T. Nieciecza,8,4,2,2,11,8,3,14,poland2
Motor Lublin,8,4,1,3,13,14,-1,13,poland2
Chrobry Glogow,8,4,1,3,8,9,-1,13,poland2
Miedz Legnica,8,3,3,2,14,9,5,12,poland2
Stal Rzeszow,8,3,2,3,12,10,2,11,poland2
Podbeskidzie,8,2,5,1,8,7,1,11,poland2
Resovia Rzeszow,8,3,1,4,8,10,-2,10,poland2
Znicz Pruszkow,8,3,1,4,5,7,-2,10,poland2
Polonia Warszaw,8,1,2,5,10,13,-3,5,poland2
Z. Sosnowiec,8,1,0,7,8,18,-10,3,poland2
Stalowa Wola,8,6,0,2,14,7,7,18,poland3
Kalisz,8,5,2,1,12,5,7,17,poland3
Olimpia Elblag,8,5,2,1,14,8,6,17,poland3
Jastrzebie,8,5,2,1,14,10,4,17,poland3
Zaglebie L. B,8,5,1,2,16,8,8,16,poland3
K. Kolobrzeg,8,5,1,2,13,9,4,16,poland3
Stomil Olsztyn,8,5,1,2,10,8,2,16,poland3
Chojniczanka,8,4,3,1,14,8,6,15,poland3
Pogon Siedlce,8,4,3,1,15,10,5,15,poland3
Polonia Bytom,8,4,3,1,15,12,3,15,poland3
Radunia Stezyca,8,4,2,2,13,8,5,14,poland3
Hutnik Krakow,8,4,1,3,15,13,2,13,poland3
LKS Lodz B,8,4,1,3,13,11,2,13,poland3
Lech Poznan B,8,4,1,3,10,14,-4,13,poland3
Sandecja Nowy,8,3,3,2,10,9,1,12,poland3
SKRA Czestochow,8,3,2,3,13,9,4,11,poland3
Wisla Pulawy,8,2,4,2,12,11,1,10,poland3
O. Grudziadz,8,2,2,4,8,10,-2,8,poland3
Sporting CP,8,8,0,0,21,5,16,24,portugal
Benfica,8,6,2,0,18,4,14,20,portugal
FC Porto,8,6,1,1,15,4,11,19,portugal
Guimaraes,8,6,0,2,18,9,9,18,portugal
Sporting Braga,8,4,2,2,18,9,9,14,portugal
Farense,8,4,2,2,14,6,8,14,portugal
Gil Vicente,8,3,4,1,16,12,4,13,portugal
Moreirense,8,3,2,3,12,12,0,11,portugal
Famalicao,8,3,2,3,10,12,-2,11,portugal
Portimonense,8,3,2,3,9,12,-3,11,portugal
Estoril,8,3,1,4,17,10,7,10,portugal
Estrela Amadora,8,3,1,4,10,13,-3,10,portugal
Rio Ave,8,2,3,3,11,13,-2,9,portugal
Boavista,8,1,4,3,10,15,-5,7,portugal
Chaves,8,2,1,5,12,19,-7,7,portugal
Arouca,8,1,2,5,6,11,-5,5,portugal
Casa Pia,8,1,2,5,4,11,-7,5,portugal
Vizela,8,0,2,6,7,19,-12,2,portugal
Nacional,8,6,2,0,20,4,16,20,portugal2
Santa Clara,8,5,2,1,11,5,6,17,portugal2
Pacos Ferreira,8,5,1,2,16,8,8,16,portugal2
Penafiel,8,5,1,2,11,9,2,16,portugal2
Torreense,8,4,3,1,13,6,7,15,portugal2
Academico Viseu,8,4,3,1,10,5,5,15,portugal2
Tondela,8,5,0,3,15,11,4,15,portugal2
AVS,8,4,1,3,7,5,2,13,portugal2
Feirense,8,4,1,3,9,8,1,13,portugal2
Mafra,8,3,2,3,8,7,1,11,portugal2
Benfica B,8,3,2,3,9,10,-1,11,portugal2
Uniao de Leiria,8,2,4,2,10,10,0,10,portugal2
FC Porto B,8,3,1,4,13,14,-1,10,portugal2
Maritimo,8,2,3,3,11,8,3,9,portugal2
Vilaverdense,8,3,0,5,7,16,-9,9,portugal2
Oliveirense,8,1,4,3,10,15,-5,7,portugal2
Os Belenense,8,2,1,5,5,13,-8,7,portugal2
Leixoes,8,1,3,4,4,9,-5,6,portugal2
Al Sadd,8,6,1,1,26,2,24,19,qatar
Al Gharafa,7,5,2,0,19,11,8,17,qatar
Al Wakrah,6,5,1,0,14,7,7,16,qatar
Al Rayyan,4,3,0,1,11,4,7,9,qatar
Al Arabi,6,2,3,1,10,9,1,9,qatar
Qatar SC,5,2,1,2,12,11,1,7,qatar
Al Duhail,6,2,1,3,13,13,0,7,qatar
Al Muaidar,7,1,3,3,12,15,-3,6,qatar
Umm Salal,6,1,2,3,8,11,-3,5,qatar
Al Ahli Doha,6,1,0,5,9,18,-9,3,qatar
Al Markhiya,6,1,0,5,3,13,-10,3,qatar
Al Shamal,4,0,1,3,5,9,-4,1,qatar
CFR Cluj,8,5,3,0,14,2,12,18,romania
Rapid Bucharest,8,6,0,2,22,12,10,18,romania
Sepsi OSK,8,5,2,1,18,9,9,17,romania
Univ. Craiova,8,5,2,1,16,8,8,17,romania
Hermannstadt,8,4,4,0,14,6,8,16,romania
FCSB,8,4,2,2,13,8,5,14,romania
Petrolul,8,3,5,0,11,8,3,14,romania
U Craiova 1948,8,4,1,3,16,12,4,13,romania
Farul Constanta,8,2,5,1,10,8,2,11,romania
U. Cluj,8,3,2,3,7,8,-1,11,romania
UTA Arad,8,2,4,2,10,10,0,10,romania
P. Iasi,8,2,4,2,10,11,-1,10,romania
Din. Bucharest,8,1,3,4,3,7,-4,6,romania
Otelul,8,1,3,4,7,12,-5,6,romania
Voluntari,8,1,2,5,8,14,-6,5,romania
Botosani,8,0,5,3,7,13,-6,5,romania
Nizhny Novgorod,8,7,1,0,12,2,10,22,russia
FC Krasnodar,8,7,1,0,14,5,9,22,russia
Krylya Sovetov,8,6,2,0,23,8,15,20,russia
Zenit,8,6,1,1,17,5,12,19,russia
CSKA Moscow,8,5,2,1,15,9,6,17,russia
Spartak Moscow,8,5,2,1,12,6,6,17,russia
Lokomotiv M.,8,5,2,1,12,7,5,17,russia
Dinamo Moscow,8,5,2,1,11,6,5,17,russia
Rostov,8,4,3,1,15,8,7,15,russia
Fakel Voronezh,8,3,4,1,8,3,5,13,russia
Rubin Kazan,8,3,2,3,7,12,-5,11,russia
Akhmat Grozny,8,2,3,3,11,9,2,9,russia
Orenburg,8,2,3,3,10,10,0,9,russia
Ural,8,2,3,3,9,11,-2,9,russia
Baltika,8,2,2,4,6,10,-4,8,russia
PFC Sochi,8,1,2,5,9,13,-4,5,russia
Arsenal Tula,8,6,1,1,14,4,10,19,russia2
Makhachkala,8,6,0,2,12,4,8,18,russia2
Yenisey,8,5,1,2,20,12,8,16,russia2
Tyumen,8,4,3,1,13,4,9,15,russia2
SKA Khabarovsk,8,4,3,1,10,6,4,15,russia2
A. Vladikavkaz,8,4,3,1,11,9,2,15,russia2
Khimki,8,3,5,0,9,6,3,14,russia2
Kamaz,8,3,4,1,10,5,5,13,russia2
Rodina Moskva,8,4,1,3,11,8,3,13,russia2
Shinnik,8,3,4,1,12,10,2,13,russia2
Torpedo Moscow,8,4,1,3,9,9,0,13,russia2
Akron,8,3,2,3,8,7,1,11,russia2
Urozhay,8,2,4,2,7,7,0,10,russia2
Neftekhimik,8,2,4,2,6,8,-2,10,russia2
V. Astrakhan,8,2,3,3,8,12,-4,9,russia2
Chernomorets,8,2,2,4,9,11,-2,8,russia2
Sokol Saratov,8,1,3,4,5,11,-6,6,russia2
Leningradets,8,1,2,5,4,8,-4,5,russia2
Al Hilal,8,8,0,0,26,2,24,24,saudiarabia
Al Nassr,8,7,1,0,24,8,16,22,saudiarabia
Damak,8,5,3,0,21,9,12,18,saudiarabia
Al Ahli Jeddah,8,5,3,0,12,3,9,18,saudiarabia
Al Wahda,8,5,1,2,20,11,9,16,saudiarabia
Al Shabab,8,4,2,2,11,7,4,14,saudiarabia
Al Tai,8,4,1,3,14,15,-1,13,saudiarabia
Abha,8,4,1,3,10,15,-5,13,saudiarabia
Al Khaleej,8,3,3,2,12,9,3,12,saudiarabia
Al Raed,8,4,0,4,14,12,2,12,saudiarabia
Al Akhdoud,8,4,0,4,6,8,-2,12,saudiarabia
Al Fateh,8,3,2,3,15,8,7,11,saudiarabia
Al Taawon,8,3,2,3,13,12,1,11,saudiarabia
Al Ittifaq,8,2,4,2,11,11,0,10,saudiarabia
Al Ittihad,8,3,1,4,18,20,-2,10,saudiarabia
Al Riyadh,8,2,3,3,6,8,-2,9,saudiarabia
Al Hazm,8,2,1,5,10,27,-17,7,saudiarabia
Al Feiha,8,0,3,5,3,14,-11,3,saudiarabia
Al Jabalain,8,7,1,0,18,6,12,22,saudiarabia2
Al Quadisiya,8,5,3,0,15,8,7,18,saudiarabia2
Al-Jndal,8,5,2,1,11,6,5,17,saudiarabia2
Al Orubah,8,5,1,2,15,10,5,16,saudiarabia2
Al Arabi,8,5,0,3,20,9,11,15,saudiarabia2
Al Faisaly,8,5,0,3,13,8,5,15,saudiarabia2
Al Kholood,8,4,3,1,11,8,3,15,saudiarabia2
Al Adalh,8,4,2,2,12,9,3,14,saudiarabia2
Al Bukayriyah,8,3,5,0,10,7,3,14,saudiarabia2
Al-Ain,8,3,3,2,14,11,3,12,saudiarabia2
Al Batin,8,3,3,2,10,12,-2,12,saudiarabia2
Hajer,8,2,4,2,5,7,-2,10,saudiarabia2
Ohod,8,2,3,3,9,7,2,9,saudiarabia2
Al Taraji,8,2,3,3,8,10,-2,9,saudiarabia2
Al Safa,8,2,1,5,12,16,-4,7,saudiarabia2
Jeddah,7,2,1,4,4,8,-4,7,saudiarabia2
Al Qaisoma,8,2,1,5,12,18,-6,7,saudiarabia2
Al Najma,8,2,0,6,9,15,-6,6,saudiarabia2
Rangers,8,7,0,1,18,6,12,21,scotland
Celtic,8,6,1,1,20,7,13,19,scotland
Kilmarnock,8,5,2,1,13,7,6,17,scotland
Hearts,8,4,2,2,11,9,2,14,scotland
St. Johnstone,8,4,2,2,9,9,0,14,scotland
Hibernian,8,3,4,1,9,5,4,13,scotland
Aberdeen,8,3,2,3,9,9,0,11,scotland
St. Mirren,8,3,2,3,9,9,0,11,scotland
Dundee FC,8,3,2,3,9,12,-3,11,scotland
Ross County,8,2,2,4,5,9,-4,8,scotland
Motherwell,8,1,3,4,14,18,-4,6,scotland
Livingston,8,1,2,5,3,10,-7,5,scotland
Partick Thistle,8,5,2,1,17,12,5,17,scotland2
Dundee Utd,8,4,2,2,18,7,11,14,scotland2
Raith Rovers,8,3,4,1,15,13,2,13,scotland2
Airdrieonians,8,3,2,3,8,7,1,11,scotland2
Greenock Morton,8,3,1,4,10,11,-1,10,scotland2
Inverness,8,2,2,4,6,7,-1,8,scotland2
Dunfermline,8,2,1,5,10,10,0,7,scotland2
Queen`s Park,8,1,3,4,10,17,-7,6,scotland2
Arbroath,8,1,2,5,10,14,-4,5,scotland2
Ayr Utd,8,1,2,5,7,17,-10,5,scotland2
Falkirk,8,7,1,0,20,4,16,22,scotland3
Hamilton,8,5,2,1,22,6,16,17,scotland3
Cove Rangers,8,5,2,1,20,11,9,17,scotland3
Alloa Athletic,8,4,3,1,12,9,3,15,scotland3
Kelty Hearts,8,3,2,3,9,11,-2,11,scotland3
Stirling Albion,8,2,4,2,9,10,-1,10,scotland3
Montrose,8,2,3,3,6,11,-5,9,scotland3
Queen of South,8,2,2,4,9,11,-2,8,scotland3
Edinburgh City,8,2,2,4,15,23,-8,8,scotland3
Annan Athletic,8,1,3,4,10,14,-4,6,scotland3
Stenhousemuir,8,7,1,0,15,6,9,22,scotland4
Peterhead,8,6,0,2,19,8,11,18,scotland4
Elgin City,8,5,2,1,11,8,3,17,scotland4
Stranraer,8,5,0,3,14,12,2,15,scotland4
Dumbarton,8,4,1,3,14,9,5,13,scotland4
East Fife,8,3,3,2,14,8,6,12,scotland4
Bonnyrigg Rose,8,3,3,2,15,11,4,12,scotland4
Spartans,8,3,2,3,11,9,2,11,scotland4
Clyde,8,2,2,4,9,17,-8,8,scotland4
Forfar Athletic,8,1,4,3,10,15,-5,7,scotland4
Red Star,8,7,1,0,20,6,14,22,serbia
Vozdovac,8,6,2,0,21,8,13,20,serbia
Vojvodina,8,6,1,1,17,9,8,19,serbia
Partizan,8,6,1,1,18,12,6,19,serbia
Novi Pazar,8,6,0,2,11,5,6,18,serbia
Backa Topola,8,4,2,2,14,9,5,14,serbia
Mladost Lucani,8,4,2,2,11,8,3,14,serbia
Javor Ivanjica,8,4,1,3,11,9,2,13,serbia
Radnicki 1923,8,4,1,3,13,13,0,13,serbia
Cukaricki,8,3,3,2,12,8,4,12,serbia
IMT N. Beograd,8,3,1,4,9,8,1,10,serbia
Z. Pancevo,8,3,1,4,11,12,-1,10,serbia
Radnicki Nis,8,2,3,3,6,8,-2,9,serbia
S. Subotica,8,3,0,5,7,16,-9,9,serbia
Napredak,8,2,1,5,4,12,-8,7,serbia
R. Surdulica,8,0,4,4,3,7,-4,4,serbia
OFK Beograd,8,8,0,0,16,2,14,24,serbia2
Dubocica,8,6,2,0,11,5,6,20,serbia2
Tekstilac Odzac,8,6,0,2,14,3,11,18,serbia2
Macva Sabac,8,5,2,1,8,3,5,17,serbia2
Jedinstvo Ub,8,4,4,0,12,7,5,16,serbia2
S. Mitrovica,8,4,3,1,9,4,5,15,serbia2
Smederevo,8,4,3,1,7,4,3,15,serbia2
OFK Vrac,8,4,2,2,6,3,3,14,serbia2
Graficar,8,4,1,3,15,14,1,13,serbia2
Indija,8,4,1,3,8,7,1,13,serbia2
Kolubara,8,3,2,3,13,10,3,11,serbia2
Novi Sad,8,3,2,3,7,7,0,11,serbia2
Metalac GM,8,2,4,2,6,6,0,10,serbia2
Radnicki B.,8,2,3,3,11,11,0,9,serbia2
Sloboda Uzice,8,2,3,3,7,8,-1,9,serbia2
Mladost Novi S.,8,1,4,3,7,9,-2,7,serbia2
A. Niigata (S),8,8,0,0,34,6,28,24,singapore
Lion City,8,6,1,1,23,12,11,19,singapore
Tampines Rovers,8,4,2,2,15,12,3,14,singapore
Hougang,8,3,1,4,13,22,-9,10,singapore
Khalsa,8,3,0,5,20,26,-6,9,singapore
Geylang,8,2,1,5,12,20,-8,7,singapore
DPMM FC,8,1,2,5,15,15,0,5,singapore
Tanjong Pagar,8,1,2,5,14,25,-11,5,singapore
Young Lions,8,0,1,7,10,26,-16,1,singapore
S. Bratislava,8,7,1,0,21,6,15,22,slovakia
Zilina,8,7,0,1,23,13,10,21,slovakia
Spartak Trnava,8,5,1,2,12,6,6,16,slovakia
Trencin,8,4,2,2,13,7,6,14,slovakia
DAC Streda,8,4,2,2,13,8,5,14,slovakia
Podbrezova,8,4,2,2,17,15,2,14,slovakia
Ruzomberok,8,4,2,2,8,6,2,14,slovakia
Skalica,8,4,1,3,8,7,1,13,slovakia
Banska Bystrica,8,3,3,2,12,11,1,12,slovakia
FC Kosice,8,2,1,5,7,18,-11,7,slovakia
Z. Michalovce,8,0,3,5,6,18,-12,3,slovakia
Zlate Moravce,8,0,2,6,5,15,-10,2,slovakia
Komarno,8,6,2,0,17,5,12,20,slovakia2
Tatran Presov,8,5,3,0,11,3,8,18,slovakia2
Spartak Myjava,8,6,0,2,15,12,3,18,slovakia2
P. Bystrica,8,5,2,1,20,9,11,17,slovakia2
Futura Humenne,8,5,1,2,15,6,9,16,slovakia2
Petrzalka,8,5,1,2,16,8,8,16,slovakia2
Slavoj Trebisov,8,4,2,2,11,8,3,14,slovakia2
OFK Malzenice,8,3,3,2,11,6,5,12,slovakia2
Zilina B,8,4,0,4,19,15,4,12,slovakia2
Pohronie,8,3,2,3,12,15,-3,11,slovakia2
Puchov,8,3,1,4,11,13,-2,10,slovakia2
Dolny Kubin,8,2,2,4,10,18,-8,8,slovakia2
Samorin,8,2,2,4,17,27,-10,8,slovakia2
S. Bratislava B,8,1,2,5,8,20,-12,5,slovakia2
L. Mikulas,2,1,0,1,4,4,0,3,slovakia2
Spisska Nova V.,8,0,1,7,4,13,-9,1,slovakia2
NK Celje,8,6,0,2,13,6,7,18,slovenia
Bravo,8,6,0,2,16,11,5,18,slovenia
Maribor,8,5,1,2,14,8,6,16,slovenia
NK Olimpija,8,3,4,1,10,9,1,13,slovenia
Mura,8,3,3,2,9,9,0,12,slovenia
Koper,8,2,3,3,15,14,1,9,slovenia
Domzale,8,3,0,5,11,11,0,9,slovenia
Aluminij,8,2,1,5,7,16,-9,7,slovenia
Radomlje,8,1,3,4,9,16,-7,6,slovenia
Rogaska,8,1,1,6,4,13,-9,4,slovenia
TS Galaxy,8,5,2,1,12,4,8,17,southafrica
Orlando Pirates,8,5,1,2,13,7,6,16,southafrica
SuperSport Utd,7,5,0,2,10,7,3,15,southafrica
AmaZulu,8,4,2,2,9,5,4,14,southafrica
Kaizer Chiefs,8,4,2,2,9,5,4,14,southafrica
Mamelodi S.,5,4,1,0,12,2,10,13,southafrica
Cape Town City,6,4,1,1,8,3,5,13,southafrica
Stellenbosch,7,4,0,3,8,7,1,12,southafrica
Polokwane,8,3,3,2,6,5,1,12,southafrica
Royal AM,7,3,2,2,6,6,0,11,southafrica
Moroka Swallows,8,3,1,4,7,7,0,10,southafrica
Chippa Utd,8,2,3,3,8,9,-1,9,southafrica
Sekhukhune,7,2,2,3,7,7,0,8,southafrica
Richards Bay,8,2,2,4,7,9,-2,8,southafrica
Golden Arrows,8,2,2,4,8,12,-4,8,southafrica
Cape Town Spurs,8,1,0,7,5,15,-10,3,southafrica
Upington City,8,6,1,1,15,7,8,19,southafrica2
Black Leopards,8,6,1,1,12,6,6,19,southafrica2
Pretoria U.,8,5,2,1,10,4,6,17,southafrica2
Casric Stars,8,4,3,1,17,8,9,15,southafrica2
Baroka,8,4,3,1,16,7,9,15,southafrica2
JDR Stars,8,4,3,1,11,7,4,15,southafrica2
Milford,8,4,2,2,12,8,4,14,southafrica2
Tshakhuma,8,3,5,0,11,7,4,14,southafrica2
Orbit College,8,4,2,2,10,7,3,14,southafrica2
Hungry Lions,8,3,4,1,8,6,2,13,southafrica2
Magesi,8,3,3,2,11,9,2,12,southafrica2
Platinum City,8,3,3,2,7,5,2,12,southafrica2
NB La Masia,8,3,2,3,9,9,0,11,southafrica2
Pretoria C.,8,2,4,2,5,5,0,10,southafrica2
Venda FC,8,3,1,4,6,7,-1,10,southafrica2
Maritzburg Utd,8,3,0,5,14,12,2,9,southafrica2
Pohang Steelers,8,5,3,0,15,8,7,18,southkorea
Incheon Utd,8,5,2,1,15,8,7,17,southkorea
Ulsan,8,5,2,1,10,6,4,17,southkorea
Gwangju,8,4,2,2,10,4,6,14,southkorea
Daejeon Citizen,8,4,2,2,12,9,3,14,southkorea
Daegu,8,3,4,1,8,6,2,13,southkorea
Jeonbuk Motors,8,3,3,2,10,9,1,12,southkorea
Suwon Bluewings,8,3,2,3,7,7,0,11,southkorea
Gangwon,8,2,4,2,10,8,2,10,southkorea
Jeju Utd,8,2,3,3,8,8,0,9,southkorea
Seoul,8,1,3,4,8,12,-4,6,southkorea
Suwon City,8,0,3,5,12,17,-5,3,southkorea
Gimcheon Sangmu,8,7,1,0,22,2,20,22,southkorea2
Busan IPark,8,6,2,0,12,2,10,20,southkorea2
Jeonnam Dragons,8,6,1,1,18,8,10,19,southkorea2
Bucheon FC,8,5,3,0,10,2,8,18,southkorea2
Cheongju,8,5,2,1,9,5,4,17,southkorea2
Anyang,8,4,3,1,13,6,7,15,southkorea2
Gimpo,8,5,0,3,11,7,4,15,southkorea2
Chungnam Asan,8,5,0,3,12,9,3,15,southkorea2
Cheonan City,8,3,3,2,9,9,0,12,southkorea2
Seongnam,8,3,2,3,10,11,-1,11,southkorea2
Seoul E-Land,8,2,1,5,8,15,-7,7,southkorea2
Gyeongnam,8,1,3,4,8,12,-4,6,southkorea2
Ansan Greeners,8,1,1,6,9,18,-9,4,southkorea2
Real Madrid,8,7,1,0,20,3,17,22,spain
Atletico Madrid,8,7,1,0,17,9,8,22,spain
Athletic Bilbao,8,6,2,0,20,8,12,20,spain
Girona,8,6,1,1,21,13,8,19,spain
Real Betis,8,5,3,0,12,4,8,18,spain
FC Barcelona,8,6,0,2,14,11,3,18,spain
Valencia,8,5,2,1,11,3,8,17,spain
Real Sociedad,8,5,2,1,16,9,7,17,spain
Getafe,8,5,2,1,9,6,3,17,spain
Las Palmas,8,5,1,2,12,6,6,16,spain
Mallorca,8,2,6,0,9,7,2,12,spain
Osasuna,8,3,3,2,8,8,0,12,spain
Celta Vigo,8,2,4,2,8,10,-2,10,spain
Alaves,8,3,1,4,6,8,-2,10,spain
Villarreal,8,2,2,4,12,15,-3,8,spain
Sevilla FC,8,1,4,3,12,14,-2,7,spain
Granada,8,1,4,3,11,15,-4,7,spain
Cadiz,8,1,4,3,7,12,-5,7,spain
Almeria,8,0,5,3,9,13,-4,5,spain
Rayo Vallecano,8,0,5,3,7,11,-4,5,spain
Real Oviedo,8,6,2,0,15,5,10,20,spain2
Valladolid,8,6,1,1,14,5,9,19,spain2
Burgos,8,5,3,0,14,5,9,18,spain2
Elche,8,5,2,1,10,4,6,17,spain2
Levante,8,5,2,1,15,11,4,17,spain2
Eibar,8,4,4,0,18,7,11,16,spain2
Leganes,8,4,4,0,15,6,9,16,spain2
Racing,8,5,1,2,17,11,6,16,spain2
Espanyol,8,4,3,1,14,8,6,15,spain2
Sporting Gijon,8,3,5,0,10,4,6,14,spain2
Racing Ferrol,8,3,4,1,13,11,2,13,spain2
Villarreal B,8,3,3,2,8,10,-2,12,spain2
FC Andorra,8,3,2,3,9,8,1,11,spain2
Tenerife,8,3,2,3,7,6,1,11,spain2
Albacete,8,3,2,3,9,9,0,11,spain2
Mirandes,8,3,2,3,10,11,-1,11,spain2
Eldense,8,2,4,2,11,11,0,10,spain2
Alcorcon,8,2,3,3,6,8,-2,9,spain2
Huesca,8,2,2,4,5,5,0,8,spain2
Real Zaragoza,8,2,2,4,7,10,-3,8,spain2
Cartagena,8,2,1,5,9,15,-6,7,spain2
Amorebieta,8,1,2,5,5,9,-4,5,spain2
Hacken,8,8,0,0,25,10,15,24,sweden
AIK,8,5,3,0,14,4,10,18,sweden
Malmo FF,8,5,2,1,17,6,11,17,sweden
Elfsborg,8,5,2,1,14,9,5,17,sweden
Sirius,8,5,0,3,21,11,10,15,sweden
Norrkoping,8,5,0,3,12,9,3,15,sweden
IFK Goteborg,8,4,2,2,11,7,4,14,sweden
Varnamo,8,4,2,2,7,4,3,14,sweden
Kalmar,8,4,2,2,7,7,0,14,sweden
Hammarby,8,3,4,1,15,13,2,13,sweden
Djurgarden,8,4,1,3,12,11,1,13,sweden
Brommapojkarna,8,3,1,4,11,14,-3,10,sweden
Halmstad,8,2,3,3,9,13,-4,9,sweden
Mjallby,8,2,0,6,7,13,-6,6,sweden
Degerfors,8,2,0,6,7,14,-7,6,sweden
Varberg BoIS,8,1,1,6,7,16,-9,4,sweden
Vasteras,8,6,1,1,14,6,8,19,sweden2
Skovde AIK,8,6,0,2,18,8,10,18,sweden2
Oster,8,5,2,1,18,5,13,17,sweden2
Brage,8,5,1,2,18,10,8,16,sweden2
GAIS,8,5,1,2,16,9,7,16,sweden2
Orebro,8,4,3,1,18,6,12,15,sweden2
Utsikten,8,3,4,1,15,7,8,13,sweden2
Helsingborg,8,4,1,3,14,11,3,13,sweden2
Ostersunds,8,3,4,1,14,11,3,13,sweden2
GIF Sundsvall,8,3,4,1,12,10,2,13,sweden2
Gefle,8,3,3,2,11,14,-3,12,sweden2
AFC Eskilstuna,8,3,2,3,13,10,3,11,sweden2
Jonkopings,8,2,3,3,9,12,-3,9,sweden2
Trelleborg,8,2,3,3,9,17,-8,9,sweden2
Landskrona,8,2,2,4,11,11,0,8,sweden2
Orgryte,8,1,3,4,8,16,-8,6,sweden2
St. Gallen,8,8,0,0,22,6,16,24,switzerland
BSC Young Boys,8,6,2,0,19,3,16,20,switzerland
Luzern,8,5,1,2,14,10,4,16,switzerland
Winterthur,8,5,1,2,14,12,2,16,switzerland
Servette,8,4,3,1,17,10,7,15,switzerland
FC Zurich,8,4,3,1,14,9,5,15,switzerland
Grasshopper,8,4,2,2,17,8,9,14,switzerland
Lausanne Sport,8,4,2,2,13,9,4,14,switzerland
Yverdon,8,4,2,2,13,15,-2,14,switzerland
Lugano,8,4,1,3,13,11,2,13,switzerland
FC Basel,8,2,2,4,8,11,-3,8,switzerland
Lausanne Ouchy,8,1,4,3,10,17,-7,7,switzerland
Jabala,7,5,2,0,12,2,10,17,syria
Teshrin,6,5,1,0,12,5,7,16,syria
Foutoua,5,4,1,0,7,1,6,13,syria
Hottin,5,4,0,1,9,3,6,12,syria
Taliya,5,3,1,1,4,3,1,10,syria
Al Ittihad,5,2,3,0,9,4,5,9,syria
Karama,5,2,2,1,5,4,1,8,syria
Wathbah,6,2,2,2,5,5,0,8,syria
Al Jaish,5,2,1,2,6,5,1,7,syria
Al Wahda,6,1,3,2,5,7,-2,6,syria
Al Sahel,5,1,1,3,4,7,-3,4,syria
Horriya,6,1,1,4,5,9,-4,4,syria
Young Africans,6,6,0,0,20,3,17,18,tanzania
Azam,7,6,0,1,22,6,16,18,tanzania
KMC,7,4,2,1,11,8,3,14,tanzania
Simba,6,4,1,1,12,7,5,13,tanzania
Coastal Union,7,3,2,2,6,3,3,11,tanzania
Namungo,7,3,2,2,7,5,2,11,tanzania
Dodoma Jiji,6,3,2,1,6,4,2,11,tanzania
T. Prisons,7,3,2,2,7,7,0,11,tanzania
Ihefu,7,3,2,2,6,6,0,11,tanzania
Geita Gold,7,3,2,2,6,7,-1,11,tanzania
Tabora,5,3,1,1,7,4,3,10,tanzania
Kagera Sugar,6,2,3,1,5,7,-2,9,tanzania
Singida,7,1,5,1,7,7,0,8,tanzania
JKT Tanzania,6,2,2,2,4,4,0,8,tanzania
Mashujaa,7,2,2,3,6,9,-3,8,tanzania
Mtibwa Sugar,7,2,1,4,9,12,-3,7,tanzania
Port FC,8,6,0,2,24,11,13,18,thailand
Bangkok Utd,8,5,2,1,16,5,11,17,thailand
Lamphun Warrior,8,5,1,2,16,9,7,16,thailand
Buriram Utd,7,4,3,0,17,3,14,15,thailand
Pathum Utd,7,4,2,1,16,7,9,14,thailand
Chiangrai Utd,8,3,4,1,11,6,5,13,thailand
Ratchaburi,6,4,0,2,16,6,10,12,thailand
Nakhon Pathom,7,3,2,2,13,11,2,11,thailand
Trat,8,3,2,3,12,12,0,11,thailand
Sukhothai,8,3,1,4,11,11,0,10,thailand
Khon Kaen Utd,7,1,5,1,11,11,0,8,thailand
Police Tero,8,2,2,4,13,17,-4,8,thailand
Chonburi,7,2,2,3,4,8,-4,8,thailand
Uthai Thani,8,2,2,4,9,16,-7,8,thailand
Prachuap,7,2,1,4,9,11,-2,7,thailand
Muang Thong Utd,5,1,2,2,7,8,-1,5,thailand
N. Ratchasima,8,6,2,0,13,2,11,20,thailand2
Chiangmai FC,8,6,1,1,21,6,15,19,thailand2
N. Bua Pitchaya,8,6,1,1,19,10,9,19,thailand2
Nakhon Si Thamm,8,5,3,0,19,7,12,18,thailand2
Lampang,8,5,2,1,9,5,4,17,thailand2
Rayong,8,5,1,2,14,5,9,16,thailand2
Kanchanaburi,8,4,3,1,17,10,7,15,thailand2
Chiangmai Utd,8,4,2,2,14,8,6,14,thailand2
Ayutthaya Utd,8,3,4,1,13,8,5,13,thailand2
Suphanburi,7,4,1,2,10,7,3,13,thailand2
Samut Prakan,8,3,3,2,14,10,4,12,thailand2
Pattaya United,8,2,5,1,11,8,3,11,thailand2
Phrae Utd,8,3,2,3,13,11,2,11,thailand2
Chanthaburi,8,2,4,2,8,8,0,10,thailand2
Chainat,8,3,1,4,12,17,-5,10,thailand2
Kasetsart,8,1,2,5,6,13,-7,5,thailand2
Customs Utd,8,1,2,5,9,17,-8,5,thailand2
Krabi,8,0,3,5,1,8,-7,3,thailand2
Galatasaray,8,8,0,0,19,5,14,24,turkey
Fenerbahce,8,6,1,1,28,8,20,19,turkey
Rizespor,8,6,0,2,13,8,5,18,turkey
Basaksehir,8,5,2,1,17,9,8,17,turkey
Samsunspor,8,5,2,1,13,7,6,17,turkey
Trabzonspor,8,5,1,2,13,8,5,16,turkey
Adana Demirspor,8,4,3,1,15,7,8,15,turkey
Besiktas,8,5,0,3,13,10,3,15,turkey
F. Karagumruk,8,4,2,2,15,8,7,14,turkey
Kayserispor,8,4,2,2,13,9,4,14,turkey
Kasimpasa,8,4,1,3,17,15,2,13,turkey
Antalyaspor,8,3,4,1,7,6,1,13,turkey
Hatayspor,8,3,3,2,14,12,2,12,turkey
Ankaragucu,8,3,3,2,10,8,2,12,turkey
Gaziantep,8,3,2,3,10,9,1,11,turkey
Alanyaspor,8,3,2,3,11,12,-1,11,turkey
Konyaspor,8,3,1,4,9,8,1,10,turkey
Sivasspor,8,1,5,2,8,10,-2,8,turkey
Pendikspor,8,2,2,4,9,13,-4,8,turkey
Istanbulspor,8,2,1,5,9,16,-7,7,turkey
Eyupspor,8,7,0,1,20,3,17,21,turkey2
Bodrumspor,8,6,1,1,18,4,14,19,turkey2
Goztepe,8,5,1,2,16,5,11,16,turkey2
Corum,8,5,0,3,16,9,7,15,turkey2
Kocaelispor,8,4,3,1,13,10,3,15,turkey2
Sakaryaspor,8,4,2,2,14,9,5,14,turkey2
Erzurum BB,8,4,2,2,12,7,5,14,turkey2
Boluspor,8,4,1,3,9,11,-2,13,turkey2
Bandirmaspor,8,3,2,3,11,9,2,11,turkey2
Umraniyespor,8,3,2,3,10,11,-1,11,turkey2
Manisa BB,8,2,4,2,10,9,1,10,turkey2
Keciorengucu,8,3,1,4,9,11,-2,10,turkey2
Adanaspor,8,3,1,4,7,11,-4,10,turkey2
Genclerbirligi,8,2,3,3,7,10,-3,9,turkey2
Tuzlaspor,8,2,2,4,9,15,-6,8,turkey2
Altay,8,2,1,5,6,16,-10,7,turkey2
Sanliurfaspor,8,1,3,4,4,9,-5,6,turkey2
Giresunspor,8,1,2,5,2,10,-8,5,turkey2
Al Wasl,6,5,1,0,14,6,8,16,uae
Al Khaleej,7,4,1,2,16,13,3,13,uae
Bani Yas,7,4,1,2,11,10,1,13,uae
Al Ain,5,4,0,1,16,6,10,12,uae
Shabab Al Ahli,6,3,1,2,16,10,6,10,uae
Al Wahda,5,3,1,1,10,6,4,10,uae
Al Bataeh,7,2,3,2,10,11,-1,9,uae
Al Sharjah,6,2,2,2,14,9,5,8,uae
Al Jazira,7,2,2,3,12,15,-3,8,uae
Al Nasr,6,2,1,3,5,8,-3,7,uae
Ittihad Kalba,6,1,2,3,8,14,-6,5,uae
Emirates,5,0,1,4,9,16,-7,1,uae
Ajman,5,0,1,4,4,13,-9,1,uae
Hatta,6,0,1,5,1,15,-14,1,uae
Dibba Al Hisn,8,7,0,1,18,5,13,21,uae2
Al Urooba,8,6,2,0,15,7,8,20,uae2
Al Dhafra,8,5,3,0,15,8,7,18,uae2
D. Al Fujairah,8,4,4,0,12,0,12,16,uae2
Al Fujairah,8,5,1,2,14,8,6,16,uae2
Masafi,8,4,3,1,14,10,4,15,uae2
Al Jazira Al H.,8,3,4,1,13,11,2,13,uae2
Al Taawon,8,3,3,2,10,6,4,12,uae2
Gulf Heroes,8,3,3,2,9,10,-1,12,uae2
Dubai United,7,3,1,3,13,9,4,10,uae2
Al Arabi,8,2,4,2,9,7,2,10,uae2
Al Thaid,7,3,1,3,11,11,0,10,uae2
Masfut,8,3,1,4,12,16,-4,10,uae2
Al Hamriyah,8,3,0,5,11,12,-1,9,uae2
Al Ramms,8,2,0,6,17,26,-9,6,uae2
Dubai City,7,1,2,4,7,12,-5,5,uae2
Gulf United,8,1,2,5,8,16,-8,5,uae2
Dynamo Kyiv,8,6,0,2,18,7,11,18,ukraine
Shakhtar,8,5,1,2,12,6,6,16,ukraine
Chornomorets,8,5,1,2,13,8,5,16,ukraine
Polessya,8,4,3,1,12,8,4,15,ukraine
Dnipro-1,8,4,2,2,12,7,5,14,ukraine
Kryvbas KR,8,4,2,2,14,12,2,14,ukraine
Kolos Kovalivka,8,2,4,2,5,6,-1,10,ukraine
Metalist 1925,7,3,1,3,7,10,-3,10,ukraine
Oleksandria,7,3,1,3,5,10,-5,10,ukraine
Rukh Lviv,8,1,6,1,9,8,1,9,ukraine
Veres,8,2,3,3,13,16,-3,9,ukraine
Vorskla Poltava,8,2,3,3,9,14,-5,9,ukraine
LNZ Cherkasy,8,2,2,4,9,11,-2,8,ukraine
Obolon,7,1,3,3,5,9,-4,6,ukraine
FC Minaj,8,0,4,4,3,11,-8,4,ukraine
Zorya Luhansk,6,0,2,4,2,7,-5,2,ukraine
Penarol,8,6,2,0,13,4,9,20,uruguay
Nacional,7,6,1,0,18,3,15,19,uruguay
Liverpool M.,7,5,1,1,15,8,7,16,uruguay
River Plate,7,5,0,2,13,10,3,15,uruguay
Cerro Largo,8,4,3,1,8,7,1,15,uruguay
Danubio,7,3,3,1,12,4,8,12,uruguay
D. Maldonado,6,3,3,0,9,5,4,12,uruguay
Defensor S.,8,2,5,1,14,11,3,11,uruguay
Plaza Colonia,8,3,2,3,11,9,2,11,uruguay
Cerro,7,2,4,1,5,4,1,10,uruguay
La Luz,8,3,1,4,15,19,-4,10,uruguay
Fenix,7,1,3,3,3,6,-3,6,uruguay
Boston River,7,1,3,3,6,11,-5,6,uruguay
Wanderers,7,1,2,4,5,8,-3,5,uruguay
Racing CM,8,0,5,3,4,9,-5,5,uruguay
Montevideo City,8,0,3,5,4,15,-11,3,uruguay
Liverpool M.,4,3,1,0,11,6,5,10,uruguay2
Nacional,4,3,0,1,9,2,7,9,uruguay2
Defensor S.,3,3,0,0,7,1,6,9,uruguay2
Penarol,4,3,0,1,7,5,2,9,uruguay2
Racing CM,3,2,1,0,8,3,5,7,uruguay2
Danubio,3,2,1,0,2,0,2,7,uruguay2
Wanderers,4,1,3,0,6,2,4,6,uruguay2
Boston River,4,2,0,2,5,2,3,6,uruguay2
Cerro Largo,4,2,0,2,5,5,0,6,uruguay2
Cerro,4,1,2,1,3,3,0,5,uruguay2
Fenix,3,1,1,1,3,1,2,4,uruguay2
Montevideo City,3,1,1,1,4,3,1,4,uruguay2
La Luz,4,1,0,3,6,10,-4,3,uruguay2
D. Maldonado,3,0,2,1,2,3,-1,2,uruguay2
River Plate,3,0,2,1,1,2,-1,2,uruguay2
Plaza Colonia,3,0,2,1,5,7,-2,2,uruguay2
Orlando City,8,6,2,0,22,10,12,20,usa
Columbus Crew,8,6,2,0,16,4,12,20,usa
New England,8,6,1,1,16,8,8,19,usa
St. Louis City,8,5,1,2,18,10,8,16,usa
Philadelphia,8,4,4,0,16,8,8,16,usa
Sporting KC,8,5,1,2,15,9,6,16,usa
Portland,8,5,1,2,16,13,3,16,usa
Houston Dynamo,8,4,3,1,19,8,11,15,usa
New York City,8,4,3,1,10,4,6,15,usa
Atlanta Utd,8,4,2,2,20,10,10,14,usa
Cincinnati,8,4,2,2,17,8,9,14,usa
Charlotte,8,3,5,0,11,6,5,14,usa
Los Angeles FC,8,4,1,3,20,11,9,13,usa
Austin,8,4,1,3,18,12,6,13,usa
New York RB,8,4,1,3,12,7,5,13,usa
LA Galaxy,8,3,4,1,18,15,3,13,usa
Real Salt Lake,8,4,1,3,16,13,3,13,usa
Chicago Fire,8,4,1,3,12,9,3,13,usa
DC United,8,3,3,2,16,11,5,12,usa
Vancouver,8,3,3,2,15,11,4,12,usa
CF Montreal,8,3,3,2,11,8,3,12,usa
Colorado Rapids,8,3,3,2,8,7,1,12,usa
Inter Miami,8,2,5,1,13,9,4,11,usa
Dallas,8,2,5,1,9,7,2,11,usa
Nashville SC,8,3,2,3,9,8,1,11,usa
Seattle,8,2,5,1,6,6,0,11,usa
Minnesota Utd,8,2,4,2,13,9,4,10,usa
SJ Earthquakes,8,2,4,2,12,11,1,10,usa
Toronto,8,1,1,6,9,14,-5,4,usa
Pittsburgh,8,7,0,1,18,9,9,21,usa2
Orange County,8,6,1,1,11,3,8,19,usa2
Tampa Bay,8,6,0,2,17,9,8,18,usa2
Charleston,8,6,0,2,13,5,8,18,usa2
Rio Grande,8,5,1,2,15,9,6,16,usa2
Sacramento R.,8,4,3,1,10,4,6,15,usa2
Phoenix Rising,8,4,2,2,18,7,11,14,usa2
Indy Eleven,8,4,2,2,12,5,7,14,usa2
San Diego Loyal,8,4,2,2,17,11,6,14,usa2
Detroit City,8,4,2,2,8,6,2,14,usa2
San Antonio,8,3,4,1,17,10,7,13,usa2
Miami FC,8,4,1,3,14,10,4,13,usa2
New Mexico,8,4,1,3,15,13,2,13,usa2
Louisville City,8,3,3,2,12,10,2,12,usa2
Colorado S.,8,3,3,2,11,12,-1,12,usa2
Birmingham L.,8,3,2,3,10,9,1,11,usa2
Memphis,8,3,1,4,15,15,0,10,usa2
FC Tulsa,8,3,1,4,10,14,-4,10,usa2
Monterey Bay,8,2,1,5,8,13,-5,7,usa2
Oakland Roots,8,1,3,4,9,12,-3,6,usa2
El Paso,8,1,3,4,10,14,-4,6,usa2
Las Vegas L.,8,2,0,6,10,19,-9,6,usa2
Loudoun Utd,8,1,2,5,8,16,-8,5,usa2
Hartford A.,8,1,1,6,9,21,-12,4,usa2
Union Omaha,8,8,0,0,22,10,12,24,usa3
Charlotte,8,5,2,1,16,7,9,17,usa3
N. Colorado,8,5,1,2,16,11,5,16,usa3
North Carolina,8,4,2,2,14,11,3,14,usa3
Greenville,8,4,1,3,9,10,-1,13,usa3
Chattanooga RW,8,3,3,2,19,16,3,12,usa3
Lexington,8,3,3,2,15,13,2,12,usa3
Forward Madison,8,2,4,2,7,6,1,10,usa3
Tormenta,8,3,1,4,13,17,-4,10,usa3
One Knoxville,8,1,3,4,11,15,-4,6,usa3
Richmond K.,8,0,3,5,14,20,-6,3,usa3
Central Valley,8,0,3,5,9,17,-8,3,usa3
Andijan,8,5,2,1,8,4,4,17,uzbekistan
Nasaf Qarshi,8,4,3,1,7,1,6,15,uzbekistan
Neftchi,8,4,3,1,8,3,5,15,uzbekistan
Navbahor,8,4,2,2,13,5,8,14,uzbekistan
AMGK,8,4,2,2,16,14,2,14,uzbekistan
Metallurg,8,3,4,1,10,6,4,13,uzbekistan
Qizilqum,8,4,0,4,14,11,3,12,uzbekistan
Pakhtakor,8,3,3,2,11,8,3,12,uzbekistan
Termez Surkhon,8,4,0,4,8,8,0,12,uzbekistan
Bunyodkor,8,3,2,3,9,10,-1,11,uzbekistan
FK Olympic,8,2,4,2,10,11,-1,10,uzbekistan
Sogdiana,8,3,1,4,9,10,-1,10,uzbekistan
Turan,8,2,3,3,6,10,-4,9,uzbekistan
Buxoro,8,1,1,6,4,11,-7,4,uzbekistan
Angostura,0,0,0,0,0,0,0,0,venezuela
Carabobo,0,0,0,0,0,0,0,0,venezuela
Caracas,0,0,0,0,0,0,0,0,venezuela
D. La Guaira,0,0,0,0,0,0,0,0,venezuela
D. Tachira,0,0,0,0,0,0,0,0,venezuela
E. Merida,0,0,0,0,0,0,0,0,venezuela
H. Colmenares,0,0,0,0,0,0,0,0,venezuela
Metropolitanos,0,0,0,0,0,0,0,0,venezuela
Monagas,0,0,0,0,0,0,0,0,venezuela
Portuguesa,0,0,0,0,0,0,0,0,venezuela
Puerto Cabello,0,0,0,0,0,0,0,0,venezuela
Rayo Zuliano,0,0,0,0,0,0,0,0,venezuela
UCV,0,0,0,0,0,0,0,0,venezuela
Zamora,0,0,0,0,0,0,0,0,venezuela
Nam Dinh,5,4,1,0,12,4,8,13,vietnam
Ho Chi Minh,5,3,1,1,6,2,4,10,vietnam
Binh Duong,4,3,0,1,5,3,2,9,vietnam
Cong An Nhan,4,2,2,0,6,1,5,8,vietnam
Hai Phong,4,2,1,1,7,4,3,7,vietnam
Quang Nam,5,2,1,2,4,4,0,7,vietnam
Binh Dinh,4,2,0,2,9,7,2,6,vietnam
Thanh Hoa,3,1,2,0,6,4,2,5,vietnam
Song Lam Nghe,3,1,2,0,6,5,1,5,vietnam
Ha Noi,4,1,1,2,6,7,-1,4,vietnam
Viettel,3,1,1,1,2,3,-1,4,vietnam
Gia Lai,4,1,1,2,4,6,-2,4,vietnam
S. Khanh Hoa,5,1,0,4,4,9,-5,3,vietnam
Hong Linh Ha T.,3,0,1,2,3,9,-6,1,vietnam
Dong Nai,4,3,1,0,6,1,5,10,vietnam2
Hue,4,3,1,0,5,1,4,10,vietnam2
Ba Ria Vung Tau,4,3,0,1,8,3,5,9,vietnam2
PVF-CAND,4,2,2,0,3,1,2,8,vietnam2
Binh Phuoc,3,2,1,0,6,2,4,7,vietnam2
Phu Dong,4,2,1,1,5,4,1,7,vietnam2
Dong Thap,4,2,1,1,3,2,1,7,vietnam2
Long An,4,1,2,1,8,8,0,5,vietnam2
Da Nang,2,1,1,0,4,2,2,4,vietnam2
Hoa Binh,3,1,1,1,2,3,-1,4,vietnam2
Binh Thuan,0,0,0,0,0,0,0,0,vietnam2
Phu Tho,4,0,0,4,0,10,-10,0,vietnam2
The New Saints,8,8,0,0,33,4,29,24,wales
Connah`s Quay,8,5,1,2,24,12,12,16,wales
Newtown,8,5,1,2,16,8,8,16,wales
Cardiff MU,8,4,2,2,15,16,-1,14,wales
Haverfordwest,8,4,1,3,17,10,7,13,wales
Caernarfon Town,8,4,0,4,16,13,3,12,wales
Bala Town,8,3,3,2,7,5,2,12,wales
Barry Town,8,3,2,3,12,12,0,11,wales
Penybont,8,3,1,4,7,12,-5,10,wales
Colwyn Bay,8,2,1,5,15,18,-3,7,wales
Pontypridd Town,8,2,1,5,6,12,-6,7,wales
Aberystwyth,8,1,2,5,9,15,-6,5,wales
